风 月 - 扶 桑 - 杏 花 - 红 紫 - 风 月==少 将 风 月 怨 平 湖	见 尽 扶 桑 水 到 枯	相 约 杏 花 坛 上 去	画 栏 红 紫 斗 樗 蒲
渔 家 - 倚 钓 - 秋 风 - 调 羹 - 渔 家==荻 花 塘 外 老 渔 家	夜 夜 湖 边 倚 钓 槎	打 起 秋 风 鱼 数 尾	调 羹 尽 可 荐 胡 麻
白 头 - 一 钱 - 黄 鹂 - 绿 阴 - 白 头==白 头 老 子 愁 底 事	正 坐 送 春 无 一 钱	偶 被 黄 鹂 故 牵 引	却 向 绿 阴 窗 下 眠
狂 风 - 婵 娟 - 关 西 - 小 怜 - 狂 风==十 日 狂 风 不 偶 然	未 教 桃 李 斗 婵 娟	关 西 将 士 曾 如 此	直 入 齐 宫 斩 小 怜
芳 草 - 琉 璃 - 游 丝 - 春 风 - 盈 盈==芳 草 盈 盈 水 涨 陂	浅 篙 惊 动 碧 琉 璃	心 情 自 逐 游 丝 起	爱 入 春 风 夏 禹 祠
父 母 - 识 后 - 虚 空 - 虚 空 - 父 母==父 母 胞 胎 未 结 前	赵 州 识 后 笑 南 泉	豁 然 道 与 虚 空 似	不 道 虚 空 似 豁 然
绳 床 - 安 排 - 葛 藤 - 手 椎 - 绳 床==三 绕 绳 床 眼 未 开	起 模 画 样 为 安 排	葛 藤 椿 子 如 成 就	自 有 龙 天 出 手 椎
扁 舟 - 江 湖 - 茶 灶 - 有 神 - 扁 舟==我 亦 扁 舟 一 散 人	江 湖 为 洗 十 年 尘	笔 床 茶 灶 经 过 地	风 月 相 望 亦 有 神
潮 来 - 山 花 - 江 水 - 鲈 鱼 - 潮 来==潮 去 潮 来 洲 渚 春	山 花 如 绣 草 如 茵	严 陵 台 下 桐 江 水	解 钓 鲈 鱼 能 几 人
半 山 - 琴 书 - 笔 架 - 清 幽 - 风 响==夜 半 山 风 响 翠 梧	一 窗 皓 月 翠 琴 书	试 将 笔 架 山 头 屋	问 有 清 幽 似 此 罪
玉 辇 - 春 风 - 年 年 - 夕 照 - 玉 辇==玉 辇 宸 游 事 已 空	尚 余 奎 藻 绘 春 风	年 年 花 鸟 无 穷 恨	尽 在 苍 梧 夕 照 中
更 深 - 阴 阴 - 重 帘 - 花 枝 - 更 深==春 欲 分 时 寒 更 深	阑 风 伏 雨 昼 阴 阴	不 通 燕 子 重 帘 闭	憔 悴 花 枝 病 酒 心
夜 半 - 龙 膏 - 一 点 - 花 开 - 夜 半==夜 半 兰 房 春 守 宫	龙 膏 香 浥 紫 金 筒	封 绡 一 点 春 无 已	几 度 花 开 不 减 红
照 夜 - 倚 风 - 多 情 - 白 玉 - 照 夜==照 夜 直 为 明 月 侣	倚 风 先 作 艳 阳 煤	多 情 欲 著 红 妆 面	故 上 含 章 白 玉 台
暑 雨 - 冰 壶 - 月 上 - 水 墨 - 萧 萧==茅 舍 萧 萧 暑 雨 余	夜 凉 清 若 在 冰 壶	一 窗 月 上 杉 篁 影	便 是 人 间 水 墨 图
龙 门 - 玉 宇 - 异 书 - 光 彩 - 龙 门==升 龙 门 内 屋 千 楹	玉 宇 金 题 映 紫 庭	卷 帙 异 书 三 十 万	至 今 光 彩 动 奎 星
佳 声 - 无 尘 - 荔 枝 - 嚼 冰 - 佳 声==微 风 猎 树 有 佳 声	一 榻 无 尘 户 牖 明	已 擘 荔 枝 怜 玉 破	更 开 瓜 碧 嚼 冰 清
虹 桥 - 手 文 - 迷 路 - 寻 无 - 虹 桥==虹 桥 一 断 几 午 龄	亲 手 文 公 再 造 成	何 事 游 人 尚 迷 路	乱 寻 无 楫 渡 船 撑
玉 箫 - 月 中 - 豪 放 - 飞 空 - 声 闻==远 乐 数 声 闻 玉 箫	酒 酣 起 舞 月 中 宵	谪 仙 当 日 真 豪 放	明 镜 飞 空 许 见 邀
千 叶 - 花 心 - 草 木 - 君 臣 - 千 叶==万 枝 千 叶 递 相 貌	内 结 花 心 外 结 身	草 木 至 微 犹 有 合	悲 哉 你 子 与 君 臣
带 雨 - 连 天 - 乘 铁 - 三 岛 - 带 雨==群 山 带 雨 阴 云 重	沧 海 连 天 水 气 昏	遥 想 真 人 乘 铁 舸	往 来 三 岛 鬼 神 奔
轻 黄 - 诗 人 - 仙 衣 - 一 身 - 轻 黄==眉 间 蜜 酒 发 轻 黄	对 著 诗 人 不 惜 香	金 作 仙 衣 元 自 冷	月 中 仍 带 一 身 霜
冰 壶 - 此 时 - 山 出 - 夕 照 - 冰 壶==说 著 冰 壶 事 已 非	此 时 消 息 我 知 微	游 云 断 处 千 山 出	夕 照 明 边 一 鸟 归
清 露 - 柳 条 - 登 高 - 皇 州 - 雨 过==雨 过 风 清 露 气 匀	林 花 变 色 柳 条 新	为 君 作 意 登 高 处	试 望 皇 州 表 里 春
苍 龙 - 只 许 - 冰 霜 - 桃 李 - 苍 龙==东 皇 岁 岁 驾 苍 龙	只 许 仙 妃 万 玉 从	天 上 冰 霜 清 入 骨	人 间 桃 李 若 为 容
黄 尘 - 含 情 - 传 家 - 松 枝 - 落 日==落 日 黄 尘 五 国 城	中 原 回 首 几 含 情	已 无 过 雁 传 家 信	独 有 松 枝 喜 鹊 鸣
柳 暗 - 自 由 - 牛 背 - 一 轮 - 溪 头==垂 垂 杨 柳 暗 溪 头	不 问 东 西 却 自 由	几 度 醉 眠 牛 背 上	数 声 横 笛 一 轮 秋
露 气 - 感 愁 - 如 水 - 一 笛 - 碧 树==碧 树 微 凉 露 气 清	感 愁 怀 旧 独 含 情	西 楼 月 夜 明 如 水	只 欠 桓 伊 一 笛 声
崔 巍 - 一 线 - 木 枯 - 人 烟 - 崔 巍==崔 巍 隘 岭 路 连 天	履 险 命 如 一 线 悬	灌 木 枯 藤 群 象 宅	盘 蛇 跑 虎 乏 人 烟
传 宣 - 令 草 - 泥 金 - 莲 烛 - 传 宣==中 使 传 宣 学 士 家	君 王 令 草 侍 中 麻	紫 泥 金 印 才 封 了	莲 烛 然 残 一 寸 花
长 生 - 巍 巍 - 大 家 - 餐 且 - 长 生==指 出 长 生 地 不 迷	造 成 无 缝 塔 巍 巍	大 家 从 此 无 余 事	渴 饮 饥 餐 且 度 时
春 城 - 寒 御 - 布 被 - 相 撩 - 北 斗==春 城 北 斗 转 招 摇	寒 御 初 还 阵 尚 嚣	一 夜 雪 声 欺 布 被	定 知 贫 舍 故 相 撩
新 荷 - 瑟 瑟 - 天 姿 - 水 深 - 新 荷==踏 溪 分 藕 养 新 荷	钿 盖 斜 临 瑟 瑟 波	自 是 天 姿 不 汙 著	水 深 泥 浊 奈 君 何
枫 丹 - 约 住 - 沙 鸥 - 飞 去 - 枫 丹==万 松 不 掩 一 枫 丹	烟 怕 山 狂 约 住 山	却 被 沙 鸥 恼 人 损	作 行 飞 去 略 无 还
红 红 - 晴 光 - 昨 夜 - 锦 全 - 白 白==白 白 红 红 一 村 春	晴 光 炫 眼 看 难 真	无 端 昨 夜 萧 萧 雨	细 锦 全 机 卸 作 茵
兄 弟 - 笔 砚 - 荆 榛 - 复 有 - 能 文==陆 家 兄 弟 颇 能 文	入 洛 仍 将 笔 砚 焚	旧 宅 荆 榛 狐 兔 窟	机 云 无 复 有 昆 云
春 阴 - 浪 花 - 画 船 - 寂 寂 - 春 阴==九 日 春 阴 一 日 晴	不 堪 风 驾 浪 花 生	画 船 欲 解 还 归 卧	寂 寂 窗 扉 听 鸟 声
痛 饮 - 寻 芳 - 酒 困 - 野 僧 - 痛 饮==痛 饮 方 期 数 百 杯	寻 芳 何 事 又 空 回	花 愁 酒 困 春 无 着	却 访 野 僧 萧 寺 来
芝 田 - 深 林 - 记 晁 - 芝 田 - 芝 田==千 古 芝 田 人 不 到	深 林 继 日 拾 琼 瑰	从 今 为 记 晁 夫 子	曾 到 芝 田 百 亩 来
直 史 - 全 身 - 矫 矫 - 大 胜 - 史 称==直 史 称 诬 是 诳 君	事 同 罪 异 愧 全 身	谁 言 矫 矫 无 风 节	大 胜 声 嘶 股 栗 人
高 卧 - 归 来 - 功 名 - 黑 头 - 高 卧==陈 楼 高 卧 真 佳 士	陶 径 归 来 有 古 风	只 恐 功 名 不 相 放	驱 人 须 作 黑 头 公
北 斗 - 逐 月 - 一 声 - 万 里 - 低 垂==北 斗 低 垂 挂 戍 楼	黄 河 不 逐 月 西 流	一 声 长 笛 冲 沙 起	散 作 边 人 万 里 愁
六 朝 - 今 古 - 江 上 - 烟 树 - 六 朝==六 朝 文 物 草 连 空	今 古 无 端 入 望 中	江 上 晚 来 堪 画 处	参 差 烟 树 五 湖 东
乘 风 - 有 路 - 千 年 - 织 火 - 乘 风==飞 佩 乘 风 海 上 游	鹿 洲 有 路 透 炎 州	仙 人 养 就 千 年 鼠	时 采 长 毛 织 火 裘
分 明 - 钧 天 - 白 头 - 萧 疏 - 分 明==分 明 三 鸟 下 储 胥	一 觉 钧 天 梦 不 如	争 那 白 头 方 士 到	茂 陵 红 叶 已 萧 疏
尘 埃 - 老 柏 - 天 阶 - 住 庵 - 尘 埃==尘 埃 奔 走 尚 飘 蓬	想 听 庵 头 老 柏 风	会 向 天 阶 乞 衰 晚	住 庵 长 作 主 人 翁
佳 人 - 纨 扇 - 蝉 翼 - 凤 头 - 佳 人==佳 人 小 立 画 廊 西	纨 扇 迎 风 手 自 携	雪 瓣 恐 教 蝉 翼 重	缦 华 应 遣 凤 头 低
流 水 - 片 云 - 云 水 - 开 花 - 流 水==流 水 下 山 非 有 意	片 云 归 洞 本 无 心	人 生 若 得 如 云 水	铁 树 开 花 遍 界 春
九 日 - 秋 天 - 寒 雁 - 游 人 - 九 日==九 月 九 日 望 遥 空	秋 水 秋 天 生 夕 风	寒 雁 一 向 南 去 远	游 人 几 度 菊 花 丛
石 路 - 云 南 - 踟 蹰 - 不 当 - 崔 嵬==石 路 崔 嵬 云 上 头	北 云 南 雪 此 鸿 沟	谁 人 题 作 踟 蹰 岭	不 到 山 心 不 当 游
处 处 - 画 堂 - 花 开 - 风 送 - 处 处==芳 草 晴 烟 处 处 迷	画 堂 应 在 画 桥 西	花 开 记 得 寻 君 日	一 路 香 风 送 马 蹄
万 木 - 闭 门 - 绣 衣 - 死 生 - 万 木==病 树 难 随 万 木 荣	闭 门 终 日 自 愁 萦	绣 衣 使 者 知 何 取	肯 向 民 间 问 死 生
芙 蓉 - 水 亭 - 一 幅 - 采 莲 - 芙 蓉==芙 蓉 小 沼 近 东 偏	出 水 亭 亭 态 更 妍	一 幅 西 湖 新 画 稿	中 央 只 欠 采 莲 船
雨 湿 - 两 岸 - 短 棹 - 云 水 - 雨 湿==薄 阴 疏 雨 湿 春 容	两 岸 增 添 绿 与 红	短 棹 悠 悠 了 无 事	却 怜 云 水 旧 匆 匆
作 花 - 琼 瑶 - 琼 瑶 - 琉 璃 - 作 花==仙 人 翦 水 作 花 飞	忽 化 琼 瑶 巳 大 奇	复 把 琼 瑶 化 成 水	滴 来 平 地 纵 琉 璃
九 日 - 煮 茶 - 诗 成 - 吟 笔 - 流 霞==人 皆 九 日 醉 流 霞	君 汲 山 泉 自 煮 茶	可 是 诗 成 无 点 俗	只 应 吟 笔 灿 生 花
百 里 - 西 山 - 又 终 - 扁 舟 - 一 水==一 水 濡 须 百 里 间	举 头 遥 见 水 西 山	微 波 不 动 又 终 日	安 得 扁 舟 送 我 还
金 阙 - 中 谁 - 风 月 - 五 色 - 金 阙==金 阙 西 厢 玉 案 前	众 中 谁 是 掌 书 仙	欲 披 小 券 支 风 月	借 与 琅 函 五 色 笺
九 州 - 零 落 - 松 叶 - 上 冢 - 九 州==气 概 堂 堂 压 九 州	谁 知 零 落 此 荒 丘	却 烦 野 老 编 松 叶	怕 有 牛 羊 上 冢 头
东 山 - 东 山 - 何 处 - 白 云 - 东 山==江 东 东 畔 更 东 山	又 过 东 山 数 里 间	试 问 招 提 在 何 处	万 山 深 处 白 云 环
松 下 - 衔 杯 - 聒 耳 - 风 雨 - 松 下==松 下 欹 眠 客 不 来	乘 凉 起 坐 一 衔 杯	书 声 聒 耳 杂 松 籁	白 昼 满 天 风 雨 猜
茅 舍 - 姓 名 - 传 神 - 争 先 - 竹 篱==竹 篱 茅 舍 养 吾 清	正 恐 人 间 识 姓 名	毛 颍 传 神 偶 相 似	争 先 快 睹 辄 倾 城
缕 金 - 岁 时 - 胜 事 - 草 堂 - 缕 金==缕 金 剪 彩 我 何 知	祇 望 阴 晴 卜 岁 时	胜 事 浑 输 高 尚 客	草 堂 挥 麈 正 题 诗
莲 花 - 园 林 - 诗 书 - 风 流 - 莲 花==莲 花 峰 翠 湿 凝 秋	旧 业 园 林 在 下 头	好 束 诗 书 且 归 去	而 今 不 爱 事 风 流
芭 蕉 - 岸 纶 - 熏 风 - 陋 巷 - 蕉 雨==幽 人 睡 足 芭 蕉 雨	独 岸 纶 巾 几 案 凉	谁 和 熏 风 来 殿 阁	不 知 陋 巷 有 羲 皇
青 烟 - 松 楸 - 老 翁 - 前 村 - 青 烟==翠 树 青 烟 笑 语 稠	家 家 领 客 醉 松 楸	老 翁 哭 子 气 欲 绝	行 到 前 村 更 转 头
茅 斋 - 自 策 - 残 香 - 纷 纷 - 茅 斋==茅 斋 遥 夜 养 心 君	静 处 工 夫 自 策 勋	正 喜 残 香 伴 幽 独	鸦 鸣 窗 白 又 纷 纷
寂 寂 - 都 不 - 一 声 - 菊 花 - 寂 寂==寂 寂 经 旬 病 卧 家	起 来 都 不 记 年 华	一 声 檐 上 惊 秋 晚	墙 外 初 联 卖 菊 花
岁 月 - 迎 春 - 新 意 - 日 新 - 岁 月==岁 月 新 更 又 一 春	迎 春 还 是 旧 年 人	愿 除 旧 妄 生 新 意	端 与 新 年 日 日 新
青 山 - 云 外 - 相 试 - 无 心 - 青 山==云 在 青 山 自 往 还	鹤 穿 云 外 上 青 天	云 来 鹤 去 不 相 试	两 个 无 心 莫 结 缘
屐 齿 - 柴 门 - 篱 菊 - 木 落 - 屐 齿==屐 齿 休 令 破 紫 苔	柴 门 无 客 不 须 开	雨 余 篱 菊 埋 光 去	木 落 前 山 献 体 来
五 里 - 松 风 - 斜 阳 - 来 半 - 五 里==五 里 晴 行 信 一 筇	入 松 迎 面 旧 松 风	斜 阳 归 路 樵 渔 笑	翁 自 何 来 半 醉 中
抽 芽 - 清 明 - 五 日 - 桃 花 - 抽 芽==蕨 拳 欲 动 茗 抽 芽	节 近 清 明 路 近 家	五 日 缓 行 三 百 里	夹 溪 随 处 有 桃 花
玉 除 - 碧 油 - 他 日 - 当 年 - 玉 除==平 昔 勋 名 步 玉 除	碧 油 幢 下 见 悬 车	定 知 他 日 平 泉 记	不 数 当 年 种 树 书
亦 枯 - 路 遥 - 洒 道 - 破 块 - 吴 中==吴 中 见 说 亦 枯 焦	勺 水 如 金 汲 路 遥	但 有 清 尘 无 洒 道	不 能 破 块 止 鸣 条
九 日 - 底 事 - 今 朝 - 黄 花 - 九 日==九 日 重 逢 恼 肺 肠	世 情 底 事 便 炎 凉	今 朝 有 酒 还 堪 醉	不 信 黄 花 不 复 香
玉 阶 - 湘 裙 - 间 别 - 香 销 - 玉 阶==忽 离 琼 筵 下 玉 阶	湘 裙 低 覆 蹋 云 鞋	情 知 不 是 人 间 别	歌 散 香 销 十 二 钗
望 月 - 望 月 - 时 得 - 传 书 - 望 月==一 回 望 月 一 回 悲	望 月 月 移 人 不 移	何 时 得 见 汉 朝 使	为 妾 传 书 斩 画 师
聚 散 - 飞 鸣 - 何 劳 - 一 枕 - 聚 散==聚 散 人 生 集 渚 鸿	飞 鸣 邂 逅 一 宵 同	是 非 荣 辱 何 劳 问	共 在 邯 郸 一 枕 中
山 水 - 成 愁 - 猿 啼 - 猿 啼 - 山 水==长 忆 巴 陵 山 水 秋	老 来 看 画 欲 成 愁	个 中 无 听 猿 啼 处	若 听 猿 啼 更 注 流
谪 仙 - 千 树 - 游 人 - 雨 湿 - 谪 仙==见 说 谪 仙 曾 到 此	东 风 千 树 锁 雕 墙	游 人 偏 向 花 间 酹	雨 湿 春 泥 喷 酒 香
香 醪 - 桃 李 - 所 有 - 盈 车 - 香 醪==君 家 香 醪 蜜 不 如	试 投 桃 李 望 瑶 琚	敢 夸 所 无 易 所 有	潘 郎 一 出 果 盈 车
夜 深 - 孤 吟 - 不 眠 - 何 处 - 夜 深==拨 尽 寒 灰 雨 夜 深	半 窗 灯 影 伴 孤 吟	不 眠 只 有 琴 知 得	明 日 阳 关 何 处 心
农 夫 - 幅 巾 - 灞 陵 - 上 皱 - 农 夫==唤 做 农 夫 却 逢 掖	道 是 禅 和 又 幅 巾	灞 陵 雪 中 耸 肩 客	天 津 桥 上 皱 眉 人
看 书 - 松 声 - 倚 阑 - 归 来 - 看 书==风 泉 吹 满 看 书 台	洞 口 松 声 万 壑 哀	几 度 倚 阑 听 不 足	请 君 琴 里 写 归 来
天 寒 - 水 墨 - 还 判 - 重 门 - 天 寒==酒 浓 胜 得 晚 天 寒	云 气 侵 帷 水 墨 翻	兰 蕙 香 前 还 判 醉	不 须 投 辖 锁 重 门
娇 声 - 落 日 - 拂 柳 - 雨 过 - 娇 声==娇 声 啭 处 藏 鹦 小	美 睡 浓 时 落 日 斜	桥 拂 柳 溪 深 涨 水	眼 惊 春 雨 过 飞 花
风 雨 - 亭 台 - 生 物 - 绿 阴 - 风 雨==连 朝 风 雨 卷 残 红	四 望 亭 台 眼 界 空	多 少 东 君 生 物 意	不 知 俱 在 绿 阴 中
天 边 - 梅 开 - 倚 门 - 去 来 - 一 声==一 声 天 边 断 雁 哀	数 蕊 篱 外 蚤 梅 开	幽 人 耐 冷 倚 门 久	送 月 堕 湖 归 去 来
青 冢 - 埋 玉 - 延 寿 - 毫 端 - 青 冢==青 冢 今 成 土 一 堆	娇 容 埋 玉 恨 难 开	无 端 当 日 毛 延 寿	轻 把 毫 端 巧 作 媒
江 水 - 人 烟 - 杳 杳 - 一 川 - 水 边==峭 壁 崩 崖 江 水 边	深 山 日 暮 见 人 烟	沧 波 杳 杳 连 三 峡	寒 草 清 清 自 一 川
野 草 - 清 明 - 秋 千 - 沙 头 - 野 草==白 纸 黄 坟 野 草 生	柳 烟 桐 火 照 清 明	楚 娥 不 识 秋 千 戏	两 两 沙 头 接 臂 行
去 时 - 明 月 - 何 处 - 目 断 - 去 时==去 时 还 复 似 来 时	明 月 芦 华 夜 不 迷	转 棹 又 归 何 处 去	秋 光 目 断 水 天 低
闭 门 - 新 诗 - 梅 花 - 山 色 - 饭 牛==闭 门 觅 句 饭 牛 翁	囊 有 新 诗 不 怕 穷	十 里 梅 花 生 眼 底	九 峰 山 色 满 胸 中
梦 魂 - 淹 留 - 泛 酒 - 明 心 - 梦 魂==梦 魂 何 日 不 家 山	底 事 淹 留 数 月 问	忽 见 黄 华 羞 泛 酒	渊 明 心 事 若 相 关
隐 居 - 泥 污 - 五 更 - 时 有 - 云 林==满 地 云 林 称 隐 居	燕 泥 污 我 读 残 书	五 更 风 急 鸟 声 散	时 有 隔 花 来 卖 鱼
冉 冉 - 碧 天 - 峡 口 - 秋 光 - 雨 后==雨 后 飞 云 冉 冉 回	碧 天 都 似 镜 初 开	只 应 峡 口 多 山 处	不 见 秋 光 万 里 来
参 差 - 一 径 - 无 敌 - 不 语 - 参 差==参 差 台 榭 碧 云 中	柳 北 松 南 一 径 通	带 得 棋 枰 无 敌 手	与 僧 不 语 立 薰 风
寒 痴 - 客 情 - 细 雨 - 篮 舆 - 寒 痴==天 亦 寒 痴 日 易 曛	客 情 暗 暗 似 春 云	不 知 细 雨 止 还 作	自 倚 篮 舆 看 水 纹
江 南 - 千 顷 - 三 月 - 吴 蚕 - 江 南==济 南 那 得 似 江 南	千 顷 溪 山 百 顷 岚	三 月 绿 阴 桑 子 落	村 村 布 谷 老 吴 蚕
风 吹 - 箫 鼓 - 归 去 - 红 袖 - 风 吹==东 风 吹 动 看 梅 期	箫 鼓 联 船 发 恐 迟	斜 日 僧 房 怕 归 去	还 携 红 袖 绕 南 枝
悠 悠 - 梦 中 - 鸡 後 - 一 点 - 悠 悠==白 日 悠 悠 喜 意 平	梦 中 历 历 觉 魂 清	觉 时 不 落 晨 鸡 後	静 待 天 窗 一 点 明
萧 萧 - 风 流 - 半 生 - 玉 堂 - 萧 萧==白 发 萧 萧 礼 部 郎	风 流 不 减 贺 知 章	半 生 寒 饿 湖 山 里	八 十 重 来 坐 玉 堂
功 名 - 天 高 - 无 人 - 白 云 - 功 名==社 稷 功 名 出 隐 沦	天 高 听 远 亦 应 闻	庞 眉 一 去 无 人 间	七 里 商 山 但 白 云
流 光 - 南 山 - 秋 兴 - 成 行 - 水 流==沙 如 星 射 水 流 光	忆 著 南 山 步 石 梁	秋 兴 日 来 知 几 首	可 无 南 落 雁 成 行
草 堂 - 水 边 - 昨 夜 - 照 人 - 草 堂==长 思 石 色 草 堂 前	更 有 梅 花 曲 水 边	昨 夜 珊 瑚 枝 上 月	照 人 何 事 不 团 圆
不 染 - 点 缀 - 山 灵 - 谢 诗 - 不 染==绝 好 山 川 不 染 尘	得 诗 点 缀 耸 精 神	山 灵 应 共 川 灵 说	多 谢 诗 人 为 写 真
万 仞 - 带 月 - 通 天 - 自 安 - 万 仞==路 绕 崖 悬 万 仞 头	檐 泉 带 月 几 时 休	个 中 拨 转 通 天 窃	人 自 安 间 水 自 流
翠 蛾 - 绝 弦 - 银 烛 - 泪 痕 - 红 脸==翠 蛾 红 脸 不 胜 情	管 绝 弦 馀 发 一 声	银 烛 摇 摇 尘 暗 下	却 愁 红 粉 泪 痕 生
三 年 - 山 水 - 可 人 - 残 月 - 三 年==三 年 四 度 到 鹅 湖	山 水 娱 人 道 不 孤	最 是 可 人 快 心 目	晓 风 残 月 弄 菰 蒲
花 木 - 夹 路 - 步 障 - 春 风 - 玲 珑==四 时 花 木 巧 玲 珑	夹 路 纷 纷 紫 映 红	步 障 不 须 西 蜀 锦	相 公 行 处 裹 春 风
太 华 - 花 流 - 幽 人 - 春 山 - 太 华==太 华 西 南 第 几 峰	落 花 流 水 自 重 重	幽 人 只 采 黄 精 去	不 见 春 山 鹿 养 茸
淮 水 - 细 雨 - 夜 泊 - 人 烟 - 淮 水==暮 涛 凝 雪 长 淮 水	细 雨 飞 梅 五 月 天	行 子 不 须 愁 夜 泊	绿 杨 多 处 有 人 烟
春 到 - 梅 花 - 琵 琶 - 举 头 - 春 到==病 将 春 到 眼 慵 开	只 为 梅 花 猛 一 来	何 处 琵 琶 推 却 手	举 头 啄 木 起 林 隈
春 风 - 红 红 - 垂 杨 - 袅 袅 - 春 风==春 风 十 九 归 桃 李	白 白 红 红 得 最 多	未 抵 垂 杨 春 最 惜	娇 娇 袅 袅 奈 渠 何
渡 沙 - 风 前 - 滩 声 - 檐 声 - 渡 沙==大 渡 沙 头 一 扣 舷	久 晴 人 怕 立 风 前	临 流 正 爱 滩 声 美	又 得 檐 声 到 枕 边
花 信 - 狼 藉 - 小 怜 - 夜 深 - 天 涯==天 涯 花 信 误 心 期	狼 藉 红 残 只 信 时	怪 底 小 怜 浑 不 睡	夜 深 惆 怅 梦 周 师
茸 茸 - 花 明 - 四 方 - 空 山 - 茸 茸==匝 径 茸 茸 菜 甲 青	透 池 艳 艳 藕 花 明	四 方 衲 子 寻 幽 践	多 少 空 山 振 锡 声
声 响 - 上 苑 - 承 恩 - 北 海 - 声 响==冬 冬 声 响 报 花 知	上 苑 春 和 次 第 吹	第 一 承 恩 随 鼓 转	沈 香 亭 北 海 棠 枝
四 壁 - 三 更 - 禅 房 - 松 风 - 苦 吟==四 壁 寒 蛩 作 苦 吟	唤 回 旅 梦 约 三 更	不 知 身 在 禅 房 宿	误 听 松 风 做 雨 声
四 海 - 步 步 - 法 身 - 佳 声 - 四 海==尊 临 四 海 圣 明 君	步 步 毗 卢 顶 上 行	自 己 法 身 只 者 是	巍 然 千 古 振 佳 声
粼 粼 - 水 边 - 无 穷 - 清 明 - 粼 粼==城 脚 粼 粼 水 一 陂	水 边 杨 柳 映 旌 旗	青 郊 绿 野 无 穷 意	寒 食 清 明 三 月 时
鸣 榔 - 贴 水 - 锦 鳞 - 蛟 龙 - 鸣 榔==鸣 榔 声 里 过 吴 松	月 似 银 盘 贴 水 中	纲 得 锦 鳞 鱼 数 尾	岂 无 一 尾 是 蛟 龙
石 头 - 清 流 - 穷 幽 - 一 片 - 石 头==枯 箨 危 根 缴 石 头	千 竿 交 映 近 清 流	堪 珍 仲 宝 穷 幽 笔	留 得 荆 湘 一 片 秋
山 幽 - 雨 过 - 楚 骚 - 一 行 - 山 幽==桂 枝 风 动 小 山 幽	雨 过 陂 池 水 漫 流	拟 作 楚 骚 吟 未 了	一 行 新 雁 数 声 秋
云 外 - 飞 泉 - 往 二 - 如 冰 - 云 外==云 外 众 峰 檐 际 横	竹 间 飞 泉 窗 下 鸣	欲 往 二 乐 即 歇 此	胸 怀 已 自 如 冰 清
市 井 - 人 犹 - 斜 阳 - 漠 漠 - 萧 条==市 井 萧 条 景 物 井	居 人 犹 号 永 和 堤	春 山 十 里 斜 阳 树	漠 漠 残 红 杜 宇 啼
夜 凉 - 孤 云 - 山 月 - 清 风 - 夜 凉==夜 凉 扶 杖 出 山 斋	身 似 孤 云 倚 石 岸	吟 就 不 知 山 月 晓	清 风 满 面 落 松 钗
水 云 - 有 香 - 花 开 - 春 风 - 水 云==南 薰 独 擅 水 云 乡	不 许 人 间 别 有 香	是 草 是 花 开 一 遍	春 风 却 似 欠 商 量
村 居 - 春 来 - 儿 童 - 杨 柳 - 村 居==村 居 何 识 见 时 节	春 去 春 来 自 一 年	谁 与 儿 童 话 寒 食	也 将 杨 柳 插 门 前
阶 砌 - 萤 光 - 炎 蒸 - 篮 舆 - 阶 砌==巩 响 渐 依 阶 砌 下	萤 光 乱 出 草 莱 间	炎 蒸 散 尽 人 轻 健	从 此 篮 舆 数 往 还
第 一 - 小 春 - 年 年 - 穷 愁 - 第 一==菊 殿 百 花 梅 第 一	重 阳 节 遇 小 春 来	年 年 岁 岁 身 长 健	摆 去 穷 愁 醉 几 杯
沧 海 - 茫 茫 - 补 处 - 知 谁 - 沧 海==桑 田 万 顷 变 沧 海	四 海 茫 茫 不 见 津	天 漏 祗 今 无 补 处	不 知 谁 是 作 霖 人
白 雪 - 一 束 - 诗 句 - 舞 衣 - 白 雪==爱 尝 佳 人 白 雪 辞	云 绫 一 束 费 春 机	翻 然 度 上 呈 诗 句	羞 杂 歌 喉 与 舞 衣
怀 归 - 全 非 - 鸥 鸟 - 尘 埃 - 怀 归==日 日 怀 归 今 得 归	旧 时 风 物 未 全 非	江 边 鸥 鸟 应 相 笑	底 事 尘 埃 满 客 衣
烘 晴 - 云 气 - 来 雨 - 净 明 - 日 脚==日 脚 烘 晴 已 破 烟	山 头 云 气 尚 披 绵	却 须 多 谢 朝 来 雨	洗 净 明 湖 镜 裹 天
三 尺 - 菰 叶 - 浙 江 - 震 泽 - 三 尺==三 尺 清 池 窗 外 开	茨 菰 叶 底 戏 鱼 回	雨 声 转 入 浙 江 去	云 影 还 从 震 泽 来
野 意 - 一 笑 - 白 昼 - 无 人 - 野 意==野 意 凄 凉 远 俗 情	出 门 一 笑 乱 山 青	痴 儿 白 昼 犹 鼾 睡	查 是 无 人 会 唤 醒
百 花 - 花 下 - 百 里 - 月 过 - 花 开==吴 王 洲 上 百 花 开	花 下 人 人 劝 酒 杯	醉 卧 春 江 三 百 里	不 知 月 过 海 门 来
细 雨 - 相 映 - 春 色 - 梅 花 - 细 雨==红 楼 细 雨 燕 飞 斜	玉 面 珠 帘 相 映 遮	三 月 江 南 春 色 尽	却 行 江 北 见 梅 花
日 落 - 金 屋 - 空 庭 - 梨 花 - 黄 昏==纱 窗 日 落 渐 黄 昏	金 屋 无 人 见 泪 痕	寂 寞 空 庭 春 欲 晚	梨 花 满 地 不 开 门
彭 泽 - 清 夜 - 千 载 - 风 味 - 彭 泽==平 生 爱 菊 陶 彭 泽	清 夜 移 橙 杜 草 堂	千 载 时 魂 招 不 得	独 留 风 味 在 僧 房
何 处 - 雪 拥 - 数 回 - 西 风 - 何 处==未 知 何 处 是 真 梅	雪 拥 溪 桥 拨 不 开	莫 讶 行 人 数 回 首	西 风 十 里 送 香 来
文 章 - 芳 丛 - 远 近 - 如 膏 - 文 章==雅 颂 文 章 顺 化 风	馨 香 不 必 在 芳 丛	阳 和 远 近 随 田 亩	春 雨 如 膏 有 大 功
城 边 - 山 林 - 半 窗 - 宰 相 - 城 边==一 庵 自 隐 古 城 边	不 是 山 林 不 市 尘	落 月 半 窗 霜 满 屋	卧 听 宰 相 去 朝 天
朝 天 - 到 长 - 西 湖 - 亦 念 - 朝 天==樯 乌 猛 作 朝 天 去	君 到 长 安 著 脚 初	若 访 西 湖 问 西 子	朋 游 应 亦 念 其 余
策 杖 - 暮 烟 - 今 古 - 侍 郎 - 策 杖==鄱 阳 策 杖 抵 岩 巅	旧 有 丹 炉 锁 暮 烟	今 古 一 双 龙 虎 石	侍 郎 仙 去 是 何 年
归 田 - 炊 玉 - 短 笛 - 太 平 - 秋 来==秋 来 谁 不 负 归 田	炊 玉 尝 新 喜 欲 颠	乞 我 一 年 横 短 笛	太 平 有 象 是 丰 年
簌 簌 - 晓 风 - 题 舆 - 玉 京 - 簌 簌==簌 簌 遥 空 堕 碎 琼	一 街 寒 色 晓 风 清	题 舆 想 入 箫 台 下	似 驾 飚 轮 向 玉 京
一 片 - 缠 头 - 章 台 - 东 风 - 春 山==一 片 春 山 乍 学 描	缠 头 初 试 紫 霞 绡	章 台 无 数 青 青 柳	最 惹 东 风 是 嫩 条
层 峦 - 许 吴 - 山 色 - 游 人 - 千 尺==高 台 千 尺 对 层 峦	只 许 吴 王 醉 里 看	山 色 不 随 勾 践 去	游 人 还 得 倚 阑 干
落 星 - 露 气 - 隐 约 - 林 间 - 星 河==错 落 星 河 天 未 明	太 虚 涵 露 气 全 清	东 方 隐 约 生 光 耀	便 觉 林 间 宿 鸟 惊
沙 头 - 气 清 - 无 人 - 师 识 - 沙 头==过 了 沙 头 渐 有 村	地 平 江 阔 气 清 温	暗 潮 巴 到 无 人 会	只 有 篙 师 识 水 痕
五 陵 - 白 玉 - 以 楹 - 花 底 - 五 陵==五 陵 年 少 竞 春 晖	肥 马 银 鞍 白 玉 羁	何 以 楹 间 煮 新 茗	更 来 花 底 覆 残 棋
露 白 - 杨 柳 - 渔 舟 - 明 灭 - 萧 萧==萧 萧 露 白 蒹 葭 老	索 索 风 乾 杨 柳 疏	坐 见 渔 舟 归 浦 尽	小 篷 明 灭 上 灯 初
垂 象 - 丹 书 - 紫 文 - 题 诗 - 精 思==巍 然 垂 象 隐 精 思	著 述 丹 书 与 世 违	真 得 紫 文 无 上 道	业 成 遗 迹 是 题 诗
楼 伟 - 来 重 - 江 山 - 江 山 - 楼 伟==谯 楼 伟 观 接 城 西	天 遣 公 来 重 以 诗	岂 是 江 山 与 人 助	江 山 元 是 以 人 知
倚 阑 - 有 无 - 无 人 - 白 云 - 倚 阑==帘 卷 晴 空 独 倚 阑	冥 鸿 点 点 有 无 间	秋 风 注 目 无 人 会	时 与 白 云 相 对 间
书 空 - 衡 阳 - 月 冷 - 寒 沙 - 书 空==草 草 书 空 不 作 行	相 呼 相 唤 过 衡 阳	芦 花 月 冷 应 无 梦	啄 尽 寒 沙 一 夜 霜
黄 冠 - 春 风 - 清 绝 - 看 山 - 黄 冠==黄 冠 翠 帔 玉 为 姿	何 处 春 风 一 见 之	未 到 湘 江 清 绝 地	试 看 山 谷 老 人 诗
江 上 - 风 引 - 万 缕 - 三 条 - 江 上==锦 池 江 上 柳 垂 桥	风 引 蝉 声 送 寂 寥	不 必 如 丝 千 万 缕	只 禁 离 恨 两 三 条
柴 门 - 不 染 - 花 铺 - 夕 阳 - 林 泉==柴 门 寂 寂 傍 林 泉	古 木 阴 森 不 染 烟	阵 阵 落 花 铺 满 径	呼 童 漫 扫 夕 阳 边
霏 霏 - 清 润 - 却 缘 - 帘 栊 - 霏 霏==小 雨 霏 霏 旋 作 晴	北 窗 清 润 绿 阴 成	却 缘 政 拙 文 书 少	卧 听 帘 栊 燕 子 声
梢 头 - 阑 干 - 东 君 - 岁 寒 - 梢 头==为 觅 梢 头 一 点 酸	缥 枝 红 萼 谩 阑 干	东 君 已 误 当 时 约	犹 敛 幽 芳 待 岁 寒
世 征 - 沾 衣 - 著 浑 - 高 眠 - 半 世==半 世 征 行 怕 子 规	一 闻 一 叹 一 沾 衣	如 今 听 著 浑 如 梦	我 自 高 眠 汝 自 啼
荷 叶 - 菱 角 - 柳 絮 - 蝶 飞 - 荷 叶==荷 叶 团 团 团 似 镜	菱 角 尖 尖 尖 似 锥	风 吹 柳 絮 毛 扑 走	雨 打 梨 花 蛱 蝶 飞
宿 鹭 - 柳 外 - 秋 来 - 湖 东 - 宿 鹭==沙 头 宿 鹭 傍 船 栖	柳 外 惊 乌 隔 岸 啼	为 爱 秋 来 好 明 月	湖 东 不 住 住 湖 西
招 提 - 寂 寂 - 夜 深 - 看 来 - 招 提==钦 从 王 命 寄 招 提	寂 寂 荒 阶 绿 草 齐	明 月 夜 深 接 佛 阁	看 来 不 比 汴 梁 时
大 江 - 妾 似 - 一 心 - 随 风 - 大 江==侬 家 住 在 大 江 东	妾 似 船 桅 郎 似 逢	船 桅 一 心 在 篷 里	篷 无 定 向 只 随 风
蝶 梦 - 梦 回 - 松 阴 - 半 夜 - 一 室==蝶 梦 轻 扬 一 室 空	梦 回 谁 识 此 身 同	窗 前 月 冷 松 阴 碎	一 枕 溪 声 半 夜 风
无 伴 - 行 乐 - 今 朝 - 人 逢 - 春 来==春 来 无 伴 闲 游 少	行 乐 三 分 减 二 分	何 况 今 朝 杏 园 里	闲 人 逢 尽 不 逢 君
身 老 - 作 戏 - 无 人 - 高 眼 - 身 老==竿 木 随 身 老 作 家	逢 场 作 戏 更 难 加	谩 人 谩 我 无 人 会	水 长 船 高 眼 里 沙
色 鲜 - 堪 怜 - 风 流 - 禅 心 - 色 鲜==满 库 琼 芳 斗 色 鲜	就 中 一 朵 最 堪 怜	恁 伊 万 种 风 流 态	惟 有 禅 心 似 铁 坚
一 叶 - 祥 光 - 望 气 - 不 是 - 一 叶==苇 间 一 叶 且 延 缘	奎 壁 祥 光 上 烛 天	定 有 异 人 遥 望 气	个 船 不 是 米 家 船
悠 悠 - 无 穷 - 金 线 - 百 年 - 悠 悠==悠 悠 往 古 继 来 今	天 地 无 穷 照 孔 林	两 到 金 线 堂 下 拜	门 生 无 负 百 年 心
笑 日 - 带 雨 - 珍 重 - 红 脸 - 花 心==含 春 笑 日 花 心 艳	带 雨 牵 风 柳 态 妖	珍 重 两 般 堪 比 处	醉 时 红 脸 舞 时 腰
竹 边 - 森 然 - 一 株 - 风 来 - 竹 边==矮 窗 元 向 竹 边 开	竹 已 森 然 只 欠 梅	新 种 一 株 花 尚 少	暗 香 早 逐 细 风 来
江 边 - 极 目 - 甘 便 - 九 州 - 百 尺==上 尽 江 边 百 尺 楼	倚 栏 极 目 暮 江 秋	未 甘 便 作 衰 翁 在	两 脚 犹 堪 蹋 九 州
全 身 - 万 象 - 独 步 - 惊 人 - 腾 腾==腾 腾 师 子 露 全 身	吞 却 森 罗 万 象 形	头 尾 也 无 常 独 步	眼 光 不 眨 大 惊 人
东 君 - 日 长 - 琵 琶 - 绵 蛮 - 东 君==东 君 回 驭 已 春 残	红 日 长 时 人 意 闲	玉 鼻 琵 琶 声 正 急	更 怜 莺 语 亦 绵 蛮
南 山 - 风 迟 - 有 象 - 春 色 - 晓 云==南 山 迎 座 晓 云 开	阊 阖 风 迟 绝 点 埃	受 职 百 神 知 有 象	会 稽 春 色 过 江 来
转 庭 - 重 门 - 穿 云 - 落 花 - 日 转==日 转 庭 槐 影 渐 移	重 门 复 屋 传 呼 迟	不 如 拂 袖 穿 云 去	说 与 落 花 流 水 知
一 粒 - 付 何 - 向 掌 - 江 山 - 一 粒==大 地 犹 如 一 粒 粟	而 今 此 语 付 何 人	时 时 撮 向 掌 中 看	吴 蜀 江 山 一 样 新
雷 车 - 欲 睡 - 煮 茶 - 叩 门 - 雷 车==欲 雨 未 雨 雷 车 奔	欲 睡 不 睡 人 思 昏	蛮 童 正 报 煮 茶 熟	忽 有 野 僧 来 叩 门
岩 下 - 邯 郸 - 兽 教 - 上 山 - 岩 下==鼓 楼 岩 下 鼓 楼 开	举 世 邯 郸 梦 未 回	安 得 老 兽 教 唤 起	万 人 醒 眼 上 山 来
蝶 梦 - 春 风 - 游 人 - 半 月 - 芳 心==蝶 梦 芳 心 处 士 知	春 风 归 去 几 多 时	游 人 记 得 当 年 事	半 月 楼 前 一 酒 旗
琪 树 - 宫 莺 - 春 草 - 花 底 - 琪 树==琪 树 三 朝 种 已 成	绿 阴 回 合 啭 宫 莺	伤 心 辇 路 生 春 草	不 见 素 娥 花 底 行
花 开 - 茅 屋 - 归 路 - 武 陵 - 花 落==花 落 花 开 隔 水 津	栈 梯 茅 屋 总 堪 邻	扁 舟 若 不 寻 归 路	便 是 武 陵 深 处 人
春 来 - 石 桥 - 年 年 - 垂 杨 - 春 来==南 浦 春 来 绿 一 川	石 桥 朱 塔 两 依 然	年 年 送 客 横 塘 路	细 雨 垂 杨 系 画 船
传 宣 - 挥 毫 - 研 雪 - 独 酌 - 传 宣==沈 香 亭 上 示 传 宣	斗 酒 挥 毫 自 百 篇	研 雪 新 蒲 瓯 弄 碧	遥 知 独 酌 意 悠 然
疏 花 - 白 发 - 一 醉 - 重 阳 - 疏 花==疏 花 得 雨 数 枝 黄	白 发 缘 愁 百 尺 长	要 与 老 生 同 一 醉	故 留 秋 意 作 重 阳
成 丛 - 烟 雨 - 一 声 - 清 风 - 成 丛==亭 前 绿 密 玉 成 丛	凤 宿 枝 头 烟 雨 空	箫 管 一 声 人 未 寝	满 林 明 月 浸 清 风
十 年 - 花 开 - 三 春 - 逢 大 - 十 年==二 十 年 来 辨 是 非	榴 花 开 处 照 官 闱	三 春 争 及 初 春 景	虎 兔 相 逢 大 梦 归
白 玉 - 雪 色 - 横 枝 - 第 一 - 玉 堂==阿 母 亲 栽 白 玉 堂	分 明 雪 色 变 青 黄	不 须 徙 倚 横 枝 看	留 作 江 南 第 一 香
江 上 - 早 梅 - 幽 香 - 一 樽 - 江 上==新 春 江 上 使 星 回	不 为 离 人 寄 早 梅	爱 惜 幽 香 意 如 此	一 樽 岂 是 等 闲 来
烟 渚 - 采 兰 - 无 生 - 似 雪 - 烟 渚==烟 渚 春 融 岸 碧 绡	采 兰 人 竞 唱 离 骚	曲 终 翻 作 无 生 调	听 著 愁 魂 似 雪 消
步 步 - 琼 树 - 逃 名 - 安 一 - 金 莲==步 步 金 莲 何 可 得	朝 朝 琼 树 有 无 新	那 能 寇 录 逃 名 姓	早 醉 长 安 一 息 春
云 烟 - 珍 奇 - 风 帆 - 翻 作 - 云 烟==南 方 经 历 几 云 烟	收 得 珍 奇 货 满 船	弹 指 便 风 帆 到 岸	一 时 翻 作 大 光 钱
草 阁 - 云 山 - 过 客 - 柱 杖 - 吟 秋==草 阁 吟 秋 倚 晚 晴	云 山 满 目 夕 阳 明	诗 成 喜 有 相 过 客	识 取 渔 梁 柱 杖 声
叠 翠 - 一 篙 - 黄 鹂 - 杨 柳 - 叠 翠==舍 北 湖 山 千 叠 翠	街 面 溪 水 一 篙 深	黄 鹂 也 似 快 晴 日	杨 柳 阴 中 诉 好 音
闲 行 - 芊 芊 - 归 去 - 杜 鹃 - 闲 行==骢 骑 闲 行 不 用 鞭	绿 阴 原 上 草 芊 芊	是 谁 催 促 春 归 去	却 把 金 丸 打 杜 鹃
赫 日 - 红 尘 - 何 处 - 梦 魂 - 赫 日==云 笼 赫 日 藏 阳 焰	人 向 红 尘 困 暑 风	山 驿 醒 心 何 处 是	幅 巾 萧 散 梦 魂 中
兰 烬 - 丝 瑶 - 歌 舞 - 粲 齿 - 兰 烬==桂 膏 兰 烬 烧 春 云	锦 丝 瑶 管 空 中 闻	甲 兵 重 来 破 歌 舞	粲 齿 修 眉 散 如 雨
百 战 - 马 前 - 鹊 印 - 一 行 - 百 战==百 战 摧 胡 未 许 强	马 前 生 缚 左 贤 王	麟 符 鹊 印 须 臾 事	只 博 凌 烟 字 一 行
红 蕊 - 数 枝 - 春 意 - 凌 寒 - 红 蕊==红 蕊 曾 游 此 地 来	青 青 今 见 数 枝 梅	只 应 尚 有 娇 春 意	不 肯 凌 寒 取 次 开
折 简 - 知 人 - 弃 置 - 露 下 - 折 简==酒 尽 聊 凭 折 简 求	不 知 人 要 博 凉 州	墙 隅 弃 置 空 三 叹	露 下 萤 飞 奈 此 秋
如 流 - 江 头 - 平 沙 - 吹 箫 - 流 水==忆 君 心 事 如 流 水	流 向 江 头 作 暮 潮	想 得 潮 平 沙 有 雪	白 铿 铁 版 和 吹 箫
良 宵 - 葛 巾 - 林 泉 - 闲 窗 - 睡 思==高 馆 良 宵 睡 思 迟	葛 巾 重 著 半 醺 时	都 将 满 抱 林 泉 兴	付 与 闲 窗 墨 半 池
江 城 - 默 坐 - 山 月 - 若 为 - 江 城==江 城 月 暗 山 岑 郁	默 坐 但 听 巴 水 声	向 使 江 清 山 月 白	欲 教 迁 客 若 为 情
龙 骧 - 功 名 - 江 山 - 苔 矶 - 龙 骧==孙 家 兄 弟 晋 龙 骧	驰 骋 功 名 业 帝 王	至 竟 江 山 谁 是 主	苔 矶 空 属 钓 鱼 郎
白 云 - 处 处 - 无 心 - 忘 年 - 白 云==白 云 冉 冉 度 南 园	绿 柳 明 花 处 处 然	云 物 无 心 心 自 适	优 游 无 我 我 忘 年
安 排 - 有 秋 - 谈 笑 - 谁 得 - 鳌 头==安 排 灯 火 作 鳌 头	人 乐 公 来 再 有 秋	转 雨 作 晴 谈 笑 事	他 州 谁 得 似 吾 州
乌 纱 - 萧 萧 - 瘦 竹 - 秋 风 - 乌 纱==乌 纱 掷 去 不 为 官	囊 橐 萧 萧 两 袖 寒	写 取 一 枝 清 瘦 竹	秋 风 江 上 作 钓 竿
门 前 - 提 那 - 王 殿 - 夜 色 - 门 前==倒 却 门 前 中 刹 竿	全 提 那 中 涉 玄 端	翻 身 不 坐 空 王 殿	月 照 千 峰 夜 色 寒
姓 名 - 到 头 - 礼 乐 - 时 鲁 - 诗 书==亦 笑 诗 书 记 姓 名	到 头 为 崇 若 为 情	汉 家 礼 乐 今 尘 土	不 欠 当 时 鲁 两 生
雪 里 - 白 头 - 横 行 - 金 钱 - 雪 里==雪 里 山 茶 取 次 红	白 头 孀 妇 哭 青 风	自 从 貂 虎 横 行 后	十 室 金 钱 九 室 空
雪 中 - 江 城 - 甘 酸 - 稍 知 - 雪 中==十 年 梨 枣 雪 中 看	想 见 江 城 荔 子 丹	赠 我 甘 酸 三 百 颗	稍 知 身 作 近 南 官
郊 原 - 天 机 - 露 溪 - 绿 树 - 纵 目==纵 目 郊 原 乱 絮 飞	好 风 娇 叶 弄 天 机	白 滩 半 露 溪 新 瘦	绿 树 初 圆 山 正 肥
衡 山 - 阳 台 - 天 际 - 林 梢 - 衡 山==淡 似 衡 山 雾 已 开	浓 如 雨 意 黯 阳 台	黄 错 天 际 迷 归 鸟	错 认 林 梢 不 下 来
寒 烟 - 高 风 - 独 怜 - 八 尺 - 寒 烟==断 草 寒 烟 故 宅 荒	高 风 千 古 映 湖 光	独 怜 汉 帝 徵 车 重	不 及 陈 蕃 八 尺 床
第 一 - 白 塔 - 三 千 - 一 笑 - 微 茫==烟 里 微 茫 第 一 山	眼 明 白 塔 俯 沧 湾	尘 埃 满 面 三 千 里	一 笑 相 看 似 梦 间
百 川 - 中 天 - 东 西 - 今 来 - 百 川==鹿 耳 雄 关 障 百 川	晴 帆 连 贯 水 中 天	好 风 早 晚 东 西 便	送 尽 今 来 古 往 船
东 风 - 谁 家 - 江 南 - 江 南 - 东 风==暂 逐 东 风 别 海 涯	去 年 营 垒 是 谁 家	春 光 浪 信 江 南 好	到 得 江 南 又 落 花
十 年 - 读 书 - 林 中 - 外 时 - 十 年==身 名 不 问 十 年 馀	老 大 谁 能 更 读 书	林 中 独 酌 邻 家 酒	门 外 时 闻 长 者 车
物 华 - 风 寒 - 江 梅 - 春 光 - 晴 日==晴 日 西 郊 按 物 华	东 风 寒 峭 帽 檐 斜	江 梅 已 辨 调 羹 事	交 割 春 光 与 杏 花
双 痕 - 丝 只 - 春 风 - 啼 鸟 - 横 香==泪 横 香 粉 纻 双 痕	怨 管 悲 丝 只 为 恩	多 少 春 风 不 相 属	落 花 啼 鸟 自 黄 昏
团 圆 - 屐 齿 - 里 寻 - 清 泉 - 重 叠==浮 萍 重 叠 水 团 圆	客 绕 千 遭 屐 齿 痕	莫 惊 池 里 寻 常 满	一 井 清 泉 是 上 源
寂 寥 - 风 标 - 钧 天 - 玉 箫 - 寂 寥==元 统 才 人 总 寂 寥	奎 章 遗 墨 尚 风 标	钧 天 梦 落 江 南 远	肠 断 云 中 紫 玉 箫
飞 升 - 未 忘 - 循 吏 - 泉 疗 - 千 载==飞 升 千 载 许 旌 阳	一 念 吾 民 尚 未 忘	循 吏 傥 怜 民 疾 苦	开 泉 疗 疾 又 何 妨
桃 花 - 风 烟 - 朱 颜 - 霜 雪 - 花 颜==桃 花 颜 色 晓 犹 深	薄 暮 风 烟 已 不 禁	人 生 抵 死 朱 颜 恃	不 料 青 铜 霜 雪 侵
步 步 - 石 泉 - 和 暖 - 杖 藜 - 日 晒==日 晒 霜 融 步 步 泥	旬 余 不 到 石 泉 西	连 朝 和 暖 得 乾 路	唤 取 邻 翁 来 杖 藜
皎 皎 - 银 烛 - 桂 魄 - 石 屏 - 皎 皎==试 问 玉 蟾 寒 皎 皎	何 如 银 烛 乱 荧 荧	不 知 桂 魄 今 何 在	应 在 吾 家 紫 石 屏
晚 节 - 黄 冠 - 识 破 - 秋 风 - 晚 节==晚 节 敷 华 性 异 溃	黄 冠 白 羽 道 家 壮	料 应 识 破 荣 枯 事	独 对 秋 风 笑 一 场
鼓 吹 - 三 更 - 歌 声 - 云 楼 - 画 船==画 船 鼓 吹 载 凉 州	不 到 三 更 枉 出 游	忽 有 歌 声 出 霄 汉	谁 家 开 宴 五 云 楼
万 里 - 走 马 - 一 杯 - 佳 人 - 万 里==西 出 阳 关 万 里 行	弯 弓 走 马 自 忘 生	不 堪 未 别 一 杯 酒	长 听 佳 人 泣 渭 城
物 古 - 只 恐 - 处 处 - 不 妨 - 古 犹==南 朝 人 物 古 犹 今	只 恐 前 身 是 道 林	处 处 经 行 常 自 适	不 妨 谭 笑 不 妨 吟
把 酒 - 中 秋 - 中 秋 - 白 头 - 把 酒==把 酒 冰 壶 接 胜 游	今 年 喜 不 负 中 秋	故 人 心 似 中 秋 月	肯 为 狂 夫 照 白 头
江 南 - 炊 烟 - 板 桥 - 气 象 - 江 南==春 去 江 南 水 拍 天	经 旬 茅 屋 罕 炊 烟	石 墙 颓 毁 板 桥 断	始 觉 贫 家 气 象 全
胸 次 - 崔 巍 - 高 手 - 酒 杯 - 胸 次==胸 次 玲 珑 著 九 垓	政 须 时 复 兴 崔 巍	楼 高 手 可 扪 星 斗	移 掇 天 河 入 酒 杯
同 心 - 红 玉 - 年 年 - 鸳 鸯 - 同 心==同 心 难 结 绣 云 长	红 玉 沉 泥 草 亦 香	娇 魄 年 年 寒 食 节	定 应 湖 上 作 鸳 鸯
花 香 - 驻 马 - 谷 熟 - 风 流 - 花 香==雨 花 台 下 百 花 香	驻 马 坡 前 百 草 长	若 还 谷 熟 人 民 乐	依 旧 风 流 好 建 康
牡 丹 - 栽 培 - 多 情 - 黄 昏 - 牡 丹==牡 丹 花 品 最 为 尊	内 苑 栽 培 物 地 繁	宫 女 多 情 看 未 足	不 离 雕 槛 到 黄 昏
林 下 - 寂 寥 - 击 鼓 - 宾 朋 - 寂 寥==林 下 杯 盘 大 寂 寥	寂 寥 长 愿 似 今 朝	君 看 击 鼓 撞 锺 者	势 去 宾 朋 不 易 招
河 汉 - 清 风 - 朱 门 - 浓 阴 - 盈 盈==牛 女 盈 盈 河 汉 傍	清 风 肃 肃 吹 罗 裳	朱 门 达 旦 听 歌 曲	莫 遣 浓 阴 蔽 夜 凉
白 璧 - 续 貂 - 一 从 - 寄 诗 - 白 璧==白 璧 明 玑 每 堕 前	续 貂 辄 复 耸 双 肩	一 从 归 作 漳 滨 卧	不 寄 诗 筒 恰 五 年
夏 日 - 倒 影 - 水 晶 - 蔷 薇 - 日 长==绿 树 阴 浓 夏 日 长	楼 台 倒 影 入 池 塘	水 晶 帘 动 微 风 起	满 架 蔷 薇 一 院 香
落 日 - 掩 映 - 白 头 - 最 少 - 落 日==落 日 平 林 一 水 边	芜 城 掩 映 只 苍 然	白 头 追 想 当 时 事	幕 府 青 衫 最 少 年
春 雨 - 离 鸿 - 水 落 - 无 语 - 春 雨==伤 春 雨 泪 湿 鲛 绡	别 雁 离 鸿 去 影 遥	流 水 落 花 多 少 恨	日 斜 无 语 立 红 桥
风 前 - 玉 容 - 残 雪 - 异 香 - 风 前==风 前 笑 颊 轻 桃 艳	雨 带 啼 痕 白 玉 容	蝶 舞 只 疑 残 雪 压	月 明 惟 觉 异 香 浓
隆 冬 - 冰 姿 - 云 鬓 - 清 香 - 隆 冬==隆 冬 百 卉 若 为 留	独 对 冰 姿 不 解 愁	谁 插 一 枝 云 鬓 里	清 香 浑 胜 玉 搔 头
白 鸟 - 鸥 群 - 独 坐 - 槛 外 - 白 鸟==白 鸟 行 从 山 嘴 没	青 鸥 群 向 水 湄 分	松 斋 独 坐 谁 为 侣	数 片 斜 飞 槛 外 云
风 云 - 千 里 - 山 色 - 倚 槛 - 风 云==风 云 下 走 若 冯 虚	目 极 长 空 千 里 余	每 日 城 中 望 山 色	却 来 倚 槛 认 吾 庐
乐 事 - 东 风 - 看 花 - 愁 中 - 乐 事==准 拟 今 春 乐 事 浓	依 然 枉 却 一 东 风	年 年 不 带 看 花 眼	不 是 愁 中 即 病 中
挂 壁 - 堪 怜 - 残 萤 - 秋 风 - 挂 壁==挂 壁 青 缸 照 不 眠	相 看 到 此 亦 堪 怜	露 寒 霜 重 残 萤 尽	肠 断 秋 风 忆 往 年
看 花 - 秋 风 - 富 贵 - 读 书 - 看 花==春 风 跃 马 看 花 时	肯 作 秋 风 鬓 易 衰	富 贵 百 年 皆 长 物	老 来 方 悔 读 书 迟
把 酒 - 东 篱 - 西 风 - 寂 寞 - 把 酒==忙 里 何 曾 把 酒 卮	一 秋 心 事 付 东 篱	等 间 应 被 西 风 笑	寂 寞 黄 花 未 有 诗
金 粟 - 桃 李 - 江 南 - 绝 奇 - 金 粟==金 粟 如 来 涧 壑 姿	不 随 桃 李 赴 春 期	江 南 花 品 秋 居 最	何 况 秋 花 中 绝 奇
亭 前 - 送 酒 - 春 去 - 一 径 - 亭 前==濠 乐 亭 前 花 已 披	马 军 送 酒 故 来 迟	只 愁 风 雨 卷 春 去	红 染 芳 效 一 径 泥
东 郭 - 事 告 - 小 窗 - 落 花 - 东 郭==东 郭 老 人 双 鬓 皤	春 事 告 终 知 奈 何	坐 断 小 窗 风 正 恶	送 将 几 阵 落 花 过
秋 来 - 马 上 - 青 山 - 禄 亦 - 秋 来==鬓 毛 已 自 秋 来 变	髀 肉 仍 于 马 上 消	满 眼 青 山 不 归 去	强 颜 微 禄 亦 何 聊
月 斜 - 苍 苍 - 江 风 - 五 声 - 秋 月==秋 月 斜 明 虚 白 堂	寒 蛩 唧 唧 树 苍 苍	江 风 彻 晓 不 得 睡	二 十 五 声 秋 点 长
曲 径 - 归 去 - 草 木 - 始 厚 - 曲 径==几 簇 低 垂 曲 径 间	王 孙 归 去 不 思 还	无 情 草 木 羞 何 事	我 未 成 名 始 厚 颜
石 上 - 望 中 - 胜 游 - 蓬 鬓 - 石 上==盘 陀 石 上 少 从 容	秋 色 偏 宜 晚 望 中	欲 赋 胜 游 无 杰 句	独 搔 蓬 鬓 立 西 风
剪 彩 - 入 酒 - 醉 魂 - 无 香 - 剪 彩==姮 娥 剪 彩 压 群 芳	一 夜 秋 风 入 酒 囊	薰 彻 醉 魂 清 入 骨	敢 言 天 下 更 无 香
重 裘 - 寒 食 - 花 开 - 栽 花 - 重 裘==叠 帐 重 裘 更 怯 风	绝 怜 寒 食 到 匆 匆	一 春 不 见 花 开 落	但 说 栽 花 费 几 工
风 波 - 近 人 - 樽 前 - 山 水 - 微 风==猎 猎 微 风 波 面 开	近 人 鸥 鹭 不 相 猜	樽 前 忽 起 扁 舟 兴	新 管 江 南 山 水 来
三 年 - 一 日 - 南 北 - 归 去 - 三 年==三 年 耀 武 群 雄 服	一 日 回 銮 万 国 春	南 北 通 欢 永 无 事	谢 恩 归 去 老 陪 臣
离 离 - 风 清 - 闻 广 - 玉 树 - 一 帘==一 帘 竹 影 画 离 离	月 白 风 清 花 气 吹	梦 里 似 曾 闻 广 乐	醒 来 玉 树 弄 阶 墀
朦 胧 - 饶 舌 - 春 睡 - 骑 马 - 残 月==梦 和 残 月 两 朦 胧	饶 舌 幽 禽 苦 唤 侬	若 说 五 更 春 睡 好	绝 胜 骑 马 火 城 中
深 林 - 石 桥 - 图 画 - 吹 箫 - 深 林==深 林 茅 屋 隐 渔 樵	时 有 扁 舟 过 石 桥	谁 把 客 星 入 图 画	晓 风 残 月 伴 吹 箫
秋 风 - 人 只 - 暮 烟 - 芦 花 - 秋 风==一 舸 秋 风 梦 亦 寒	当 人 只 作 贾 胡 看	断 桥 袖 手 暮 烟 合	等 得 芦 花 雪 满 滩
夕 阳 - 他 乡 - 相 思 - 东 风 - 昨 夜==昨 夜 还 乡 已 夕 阳	夕 阳 今 日 已 他 乡	回 头 咄 咄 相 思 语	准 拟 东 风 好 送 将
白 云 - 懒 病 - 相 依 - 一 声 - 白 云==几 回 梦 到 白 云 颠	欲 住 难 禁 懒 病 牵	何 日 相 依 倾 倒 夜	月 寒 千 嶂 一 声 猿
蔷 薇 - 草 木 - 诗 句 - 虚 名 - 蔷 薇==不 知 建 业 蔷 薇 树	何 似 淮 淝 草 木 立	因 入 谪 仙 诗 句 里	等 闲 随 处 得 虚 名
泽 畔 - 羽 葆 - 草 木 - 兴 亡 - 泽 畔==阿 坚 泽 畔 菰 蒲 节	玄 德 墙 头 羽 葆 桑	不 会 世 间 闲 草 木	与 人 何 事 管 兴 亡
徙 倚 - 分 明 - 家 家 - 笙 歌 - 徙 倚==徙 倚 仙 居 绕 翠 楼	分 明 宫 漏 静 兼 秋	长 安 夜 夜 家 家 月	几 处 笙 歌 几 处 愁
山 河 - 不 搜 - 掇 得 - 玉 炉 - 山 河==气 盖 山 河 心 胆 粗	不 能 学 剑 不 搜 书	夜 来 掇 得 乾 坤 动	火 候 温 温 守 玉 炉
烟 波 - 临 流 - 啼 鹃 - 送 去 - 南 浦==澹 澹 烟 波 南 浦 春	临 流 挥 手 易 沾 巾	啼 鹃 不 解 留 归 客	岸 柳 偏 能 送 去 人
何 处 - 头 百 - 游 人 - 无 言 - 何 处==春 来 何 处 最 花 繁	湖 水 西 头 百 亩 园	无 限 游 人 折 红 蕊	可 怜 桃 李 自 无 言
成 林 - 富 贵 - 一 灯 - 夜 堂 - 成 林==海 棠 初 绽 锦 成 林	多 少 人 间 富 贵 心	隽 永 一 灯 论 语 课	萧 萧 风 雨 夜 堂 深
人 情 - 人 情 - 曲 折 - 知 人 - 人 情==大 都 礼 义 本 人 情	若 论 人 情 莫 若 亲	苟 使 於 亲 无 曲 折	不 知 人 视 作 何 人
江 南 - 风 雨 - 湘 江 - 画 竹 - 江 南==春 尽 江 南 归 已 迟	湘 南 风 雨 度 花 时	无 因 剪 取 湘 江 色	携 看 江 屏 画 竹 枝
明 珠 - 细 细 - 梨 花 - 小 怜 - 翠 羽==翠 羽 明 珠 欲 比 肩	香 生 细 细 月 娟 娟	销 魂 一 种 梨 花 梦	莫 为 横 陈 薄 小 怜
江 村 - 江 上 - 四 里 - 石 桥 - 江 村==江 村 女 儿 喜 行 舟	江 上 人 家 吉 贝 秋	缘 岸 荻 花 三 四 里	石 桥 南 去 见 城 头
花 开 - 迟 日 - 会 稽 - 流 霞 - 花 开==花 开 日 日 去 看 花	迟 日 犹 嫌 影 易 斜	莫 问 会 稽 山 外 事	但 将 歌 管 醉 流 霞
重 门 - 月 午 - 垂 手 - 秋 千 - 堂 前==两 重 门 里 玉 堂 前	寒 食 花 枝 月 午 天	想 得 那 人 垂 手 立	娇 羞 不 肯 上 秋 千
号 令 - 山 河 - 归 时 - 涧 底 - 号 令==藩 镇 各 传 新 号 令	山 河 那 复 旧 提 封	归 时 剩 语 骑 鲸 老	坚 卧 无 如 涧 底 松
疗 饥 - 人 胜 - 枝 上 - 不 愁 - 疗 饥==香 馥 清 晨 可 疗 饥	饱 人 胜 食 斋 房 芝	便 好 架 巢 枝 上 宿	不 愁 无 酒 呼 愁 诗
登 山 - 逢 僧 - 乘 兴 - 骑 马 - 登 山==昔 人 春 尽 强 登 山	只 肯 逢 僧 半 日 闲	何 似 一 尊 乘 兴 去	醉 中 骑 马 月 中 还
岁 寒 - 西 风 - 多 少 - 烟 雨 - 岁 寒==天 上 飞 花 报 岁 寒	西 风 相 挟 引 栏 干	平 湖 不 认 花 多 少	只 作 寻 常 烟 雨 看
柴 门 - 花 枝 - 游 人 - 啼 鸟 - 照 水==柴 门 照 水 见 青 苔	春 绕 花 枝 漫 漫 开	路 远 游 人 行 不 到	日 长 啼 鸟 去 还 来
落 木 - 如 画 - 载 书 - 旧 游 - 萧 萧==落 木 萧 萧 古 寺 秋	翠 屏 如 画 雨 实 收	堂 基 千 载 书 香 在	谁 为 机 云 记 旧 游
天 台 - 扰 扰 - 师 去 - 清 风 - 天 台==天 台 深 隐 许 谁 同	扰 扰 浮 世 万 事 空	终 约 携 瓶 访 师 去	水 边 松 下 啸 清 风
决 疑 - 婴 儿 - 若 教 - 鼓 口 - 决 疑==十 二 呆 郎 欲 决 疑	瞿 昙 嚼 饭 喂 婴 儿	若 教 知 有 衲 僧 事	终 不 人 前 鼓 口 皮
霜 日 - 萧 萧 - 残 梦 - 未 消 - 霜 日==风 柳 惊 霜 日 夜 飘	客 程 中 夜 马 萧 萧	据 鞍 仿 佛 如 残 梦	晓 月 一 钩 犹 未 消
遗 迹 - 草 树 - 故 国 - 多 情 - 山 川==六 朝 遗 迹 好 山 川	宫 阙 灰 寒 草 树 烟	江 令 白 头 归 故 国	多 情 合 赋 黍 离 篇
入 帘 - 东 风 - 谁 家 - 杏 花 - 入 帘==雨 又 入 帘 风 又 斜	东 风 吹 客 客 思 家	浣 纱 西 去 谁 家 子	青 绢 围 裙 插 杏 花
飞 云 - 浮 图 - 人 世 - 覆 盂 - 飞 云==詹 下 飞 云 若 可 呼	树 头 岩 影 暗 浮 图	不 知 人 世 路 多 少	只 见 前 山 似 覆 盂
东 风 - 酒 家 - 草 木 - 春 色 - 风 吹==东 风 吹 著 便 成 花	妆 点 园 林 卖 酒 家	田 野 可 栽 闲 草 木	十 分 春 色 在 桑 麻
一 声 - 江 楼 - 江 上 - 残 照 - 新 雁==一 声 新 雁 一 声 秋	独 向 江 楼 倚 莫 愁	江 上 片 云 将 雨 去	却 留 残 照 管 汀 洲
清 香 - 萧 萧 - 归 去 - 沽 酒 - 清 香==街 头 未 易 着 清 香	折 取 萧 萧 满 把 黄	归 去 气 钱 烦 里 社	买 糕 沽 酒 作 重 阳
倚 空 - 半 山 - 倚 栏 - 款 款 - 倚 空==苍 崖 万 仞 倚 空 寒	一 道 飞 泉 泻 半 山	到 此 倚 栏 聊 植 杖	少 时 款 款 入 松 关
无 人 - 众 贤 - 太 平 - 盛 时 - 无 人==何 代 无 人 振 德 辉	众 贤 今 日 会 西 畿	太 平 文 物 风 流 事	更 胜 元 和 全 盛 时
无 人 - 终 年 - 日 欣 - 秋 风 - 无 人==苦 无 人 事 扰 闲 居	赢 得 终 年 学 著 书	今 日 欣 然 出 门 去	秋 风 吹 意 满 芙 蕖
老 树 - 雪 花 - 悬 崖 - 漠 漠 - 老 树==老 树 槎 牙 冻 不 枯	雪 花 初 集 更 敷 腴	悬 崖 斗 峻 人 踪 绝	漠 漠 荒 祠 落 社 乌
胜 游 - 淹 留 - 看 山 - 举 头 - 胜 游==自 古 匡 庐 是 胜 游	话 臣 何 敢 计 淹 留	城 中 未 有 看 山 处	客 馆 僧 坊 谩 举 头
石 门 - 屐 齿 - 浊 酒 - 日 月 - 石 门==细 数 峰 峦 到 石 门	缓 移 屐 齿 步 云 根	一 樽 浊 酒 林 间 坐	古 木 苍 萝 日 月 昏
云 敛 - 万 木 - 亭 前 - 冷 泉 - 云 敛==晚 云 敛 尽 鹤 声 迟	万 木 号 空 夜 景 移	三 笑 亭 前 山 月 上	却 如 身 在 冷 泉 时
漫 有 - 却 不 - 上 方 - 猿 吟 - 来 漫==老 来 漫 有 爱 山 心	酒 少 茶 多 却 不 禁	一 夜 上 方 欹 客 枕	隔 窗 自 伴 冷 猿 吟
千 片 - 一 樽 - 寂 寞 - 道 士 - 千 片==煎 茶 水 里 花 千 片	候 客 亭 中 酒 一 樽	独 对 春 光 还 寂 寞	罗 浮 道 士 忽 敲 门
数 树 - 花 香 - 赤 日 - 天 台 - 数 树==一 掬 见 童 数 树 凉	两 三 桅 子 野 花 香	荒 山 赤 日 相 逢 处	便 是 天 台 见 石 梁
千 林 - 亭 前 - 红 紫 - 雪 中 - 千 林==千 林 一 夜 散 琼 瑰	莫 诮 亭 前 春 后 梅	未 入 纷 纷 红 紫 队	不 忍 国 是 雪 中 开
椒 花 - 仙 桃 - 玉 殿 - 霭 霭 - 椒 花==献 寿 椒 花 泛 渌 醪	迎 祥 朱 户 怙 仙 桃	影 庭 玉 殿 炉 烟 起	霭 霭 卿 云 瑞 日 高
紫 薇 - 牵 牛 - 金 石 - 班 翻 - 紫 薇==紫 薇 花 下 玉 丁 东	夜 午 牵 牛 亦 未 中	孔 壁 尚 余 金 石 奏	卷 班 翻 过 玉 成 宫
名 花 - 梅 竟 - 中 华 - 闻 香 - 名 花==名 花 齐 向 胆 瓶 张	桃 菊 荷 梅 竟 竞 芳	说 与 中 华 人 不 信	老 夫 亲 见 细 闻 香
霜 天 - 银 烛 - 吴 江 - 青 山 - 霜 天==霜 天 留 后 故 情 欢	银 烛 金 炉 夜 不 寒	欲 问 吴 江 别 来 意	青 山 明 月 梦 中 看
一 叶 - 垂 钩 - 浮 云 - 水 流 - 一 叶==春 水 江 门 一 叶 舟	几 人 来 此 看 垂 钩	浮 云 一 散 无 踪 迹	飞 尽 桃 花 江 水 流
水 国 - 对 酒 - 鸳 鸯 - 双 双 - 水 国==松 陵 水 国 面 松 江	学 弄 渔 竿 对 酒 缸	惊 起 鸳 鸯 是 旗 鼓	背 帆 飞 去 一 双 双
江 流 - 山 青 - 色 不 - 无 人 - 江 流==蜀 山 春 动 锦 江 流	水 绿 山 青 总 是 愁	愁 色 不 堪 山 上 望	无 人 解 与 月 宫 游
倚 楼 - 雨 过 - 登 临 - 黄 花 - 黄 庭==读 罢 黄 庭 倦 倚 楼	乱 云 挟 雨 过 湖 头	年 来 无 复 登 临 思	闲 捻 黄 花 送 暮 秋
寒 梅 - 已 偷 - 日 射 - 池 中 - 寒 梅==至 後 寒 梅 未 苦 繁	腊 前 暖 蝶 已 偷 还	隔 林 日 射 池 光 动	碎 却 池 中 倒 影 山
江 云 - 差 池 - 驿 使 - 一 枝 - 江 云==春 树 江 云 我 所 思	平 生 臭 味 不 差 池	如 何 驿 使 行 千 里	不 把 梅 花 寄 一 枝
疏 雨 - 舟 子 - 青 青 - 江 上 - 孤 蓬==萧 萧 疏 雨 点 孤 蓬	舟 子 招 呼 语 顺 风	小 麦 青 青 春 恰 半	一 犁 江 上 看 田 翁
钧 天 - 到 青 - 孤 生 - 知 音 - 钧 天==上 帝 钧 天 会 众 灵	昔 人 因 梦 到 青 冥	伶 伦 吹 裂 孤 生 竹	却 为 知 音 不 得 听
哀 多 - 揽 衣 - 细 字 - 解 愁 - 哀 多==行 断 哀 多 影 不 留	有 人 中 夜 揽 衣 裘	笔 头 细 字 真 堪 怨	眼 里 长 檠 不 解 愁
夹 道 - 奇 怪 - 枝 垂 - 翠 球 - 长 松==夹 道 长 松 去 去 幽	一 松 奇 怪 独 凌 秋	两 枝 垂 地 却 翻 上	活 走 双 龙 戏 翠 球
禅 心 - 何 处 - 石 桥 - 寒 林 - 禅 心==禅 心 无 住 复 无 依	何 处 飘 飘 只 履 归	想 是 石 桥 西 畔 去	寒 林 空 葬 旧 僧 衣
枕 流 - 风 波 - 烟 光 - 归 田 - 枕 流==湖 边 日 日 枕 流 眠	却 笑 风 波 百 丈 牵	无 限 烟 光 堪 我 老	不 须 投 表 乞 归 田
何 处 - 高 门 - 鸡 黍 - 断 魂 - 落 日==落 日 平 田 何 处 村	竹 墙 缭 绕 是 高 门	莫 言 鸡 黍 未 相 识	一 听 悲 歌 自 断 魂
鱼 虾 - 矶 头 - 洞 庭 - 生 涯 - 鱼 虾==潮 来 曲 渚 上 鱼 虾	早 趁 矶 头 理 钓 车	自 笑 洞 庭 渔 父 伴	为 谁 闲 却 旧 生 涯
年 老 - 臂 作 - 成 新 - 父 母 - 年 老==见 说 当 年 老 比 丘	茶 毗 一 臂 作 重 修	山 头 宝 叔 成 新 塔	泉 下 应 贻 父 母 忧
绿 波 - 弦 歌 - 曲 水 - 新 诗 - 绿 波==齐 酿 如 渑 涨 绿 波	公 诗 句 句 可 弦 歌	流 觞 曲 水 无 多 日	更 作 新 诗 继 永 和
孤 舟 - 江 山 - 红 尘 - 芦 花 - 孤 舟==一 蓑 一 笠 一 孤 舟	万 里 江 山 独 自 游	有 人 问 我 红 尘 事	笑 入 芦 花 不 点 头
园 中 - 灵 药 - 儿 童 - 豆 蔻 - 园 中==留 取 园 中 数 亩 赊	拟 栽 灵 药 谢 纷 华	儿 童 今 日 知 翁 喜	移 得 君 家 豆 蔻 花
寂 寥 - 日 驻 - 冥 冥 - 南 陌 - 寂 寥==堂 邑 山 林 久 寂 寥	属 车 前 日 驻 鸡 翘	冥 冥 独 凤 随 云 雾	南 陌 空 闻 引 葬 箫
渺 渺 - 霓 旌 - 经 年 - 野 鹤 - 笙 歌==渺 渺 笙 歌 散 石 筵	霓 旌 吹 断 纲 蛛 悬	经 年 不 锁 青 鸾 殿	野 鹤 飞 来 玉 几 前
漫 漫 - 蓑 笠 - 披 图 - 风 随 - 漫 漫==四 山 飞 雪 正 漫 漫	蓑 笠 何 人 把 钓 竿	六 月 披 图 方 执 热	风 随 玉 麈 不 胜 寒
数 枝 - 一 树 - 泪 眼 - 在 天 - 高 柳==数 枝 高 柳 带 鸣 鸦	一 树 山 榴 自 落 花	已 是 向 来 多 泪 眼	短 亭 回 首 在 天 涯
深 巷 - 花 香 - 小 窗 - 营 巢 - 深 巷==深 巷 无 人 静 掩 扉	桃 花 香 暖 午 风 微	小 窗 睡 起 支 颐 坐	闲 看 营 巢 燕 子 飞
石 岩 - 到 处 - 出 家 - 期 卜 - 石 岩==信 脚 来 游 喝 石 岩	老 来 到 处 少 同 参	出 家 本 是 丈 夫 事	岁 晚 终 期 卜 一 庵
御 龙 - 仙 仗 - 千 官 - 薄 暮 - 御 龙==燕 罢 芳 园 敕 御 龙	须 臾 仙 仗 簇 还 宫	千 官 过 尽 尘 如 雾	薄 暮 香 钿 满 路 中
繁 花 - 狂 风 - 梅 子 - 点 梅 - 繁 花==乱 插 繁 花 霁 影 中	忍 教 雪 片 扫 狂 风	从 今 准 拟 青 梅 子	雨 点 梅 尖 醉 颊 红
扶 桑 - 扶 桑 - 共 到 - 明 月 - 扶 桑==扶 桑 已 在 渺 茫 中	家 在 扶 桑 东 更 东	此 去 与 师 谁 共 到	一 船 明 月 一 帆 风
老 赵 - 风 流 - 今 朝 - 明 月 - 老 赵==安 贴 帮 乡 老 赵 州	时 辰 使 得 最 风 流	今 朝 有 酒 今 朝 醉	明 月 愁 来 明 日 愁
凤 鸣 - 家 家 - 花 结 - 五 里 - 凤 鸣==山 头 凤 鸣 求 其 凰	山 前 家 家 背 凤 筐	竹 花 结 产 未 忍 食	刀 耕 火 种 五 里 香
傍 山 - 令 威 - 多 少 - 诗 成 - 傍 山==竹 映 高 墙 似 傍 山	邹 阳 归 后 令 威 还	君 看 将 相 才 多 少	两 首 诗 成 七 步 间
梅 花 - 红 梅 - 江 梅 - 冰 姿 - 梅 花==自 昔 梅 花 雪 作 团	红 梅 晚 出 可 人 看	江 梅 不 解 追 时 好	只 守 冰 姿 度 岁 寒
区 域 - 飞 雨 - 同 轨 - 一 水 - 此 岭==区 域 瓯 闽 此 岭 存	朝 来 飞 雨 暮 行 云	方 今 天 下 车 同 轨	一 水 如 何 强 别 分
平 原 - 忠 义 - 千 秋 - 悬 车 - 平 原==堪 笑 平 原 血 溅 衣	但 知 忠 义 未 知 机	命 悬 鬼 貌 千 秋 事	年 及 悬 车 自 不 归
夜 阑 - 何 处 - 浮 云 - 一 树 - 夜 阑==独 听 钟 声 坐 夜 阑	袈 裟 何 处 问 丰 干	浮 云 忽 灭 心 灯 在	一 树 梅 花 月 影 寒
来 去 - 青 山 - 青 山 - 何 处 - 山 中==来 来 去 去 山 中 人	识 得 青 山 便 是 身	青 山 是 身 身 是 我	更 於 何 处 著 根 尘
江 亭 - 十 年 - 夕 阳 - 鸣 蝉 - 江 亭==江 亭 湖 寺 两 萧 然	画 里 题 名 二 十 年	几 树 夕 阳 流 水 外	断 风 残 雨 曳 鸣 蝉
西 风 - 凄 清 - 功 名 - 金 徽 - 原 上==原 上 西 风 马 力 生	折 胶 时 候 正 凄 清	功 名 未 立 头 空 白	却 忆 金 徽 万 里 行
牛 背 - 细 雨 - 江 南 - 不 因 - 牛 背==牛 背 稳 如 千 斛 舟	斜 烟 细 雨 任 遨 游	春 风 草 绿 江 南 岸	不 因 人 唤 始 回 头
祥 云 - 含 风 - 令 节 - 云 深 - 参 差==参 差 台 殿 照 祥 云	叠 雪 含 风 彩 缕 新	玉 带 轻 纱 迎 令 节	五 云 深 处 奉 严 宸
山 中 - 湖 上 - 麻 衣 - 何 处 - 山 中==五 月 山 中 长 对 雨	一 春 湖 上 懒 看 花	杜 鹃 莫 恼 麻 衣 客	何 处 野 泉 不 是 家
知 名 - 孤 鹤 - 人 世 - 祥 云 - 知 名==年 才 二 十 众 知 名	孤 鹤 仪 容 彻 骨 清	口 传 天 语 来 人 世	却 逐 祥 云 上 玉 京
月 上 - 笙 歌 - 未 阑 - 天 晓 - 月 上==凉 宵 爱 月 上 危 楼	几 处 笙 歌 几 处 愁	歌 管 未 阑 愁 未 歇	忽 然 天 晓 一 时 休
水 边 - 今 朝 - 岁 华 - 着 鞭 - 水 边==昨 日 春 冰 破 水 边	今 朝 腊 雪 坠 风 前	岁 华 过 目 疾 飞 鸟	壮 志 如 何 不 着 鞭
黄 云 - 垂 老 - 几 许 - 贩 山 - 黄 云==黄 云 百 亩 割 还 空	垂 老 禾 堂 泣 晚 舂	偿 却 公 私 能 几 许	贩 山 烧 炭 过 残 冬
东 风 - 霜 髯 - 山 中 - 万 点 - 东 风==浩 荡 东 风 晚 更 严	黄 埃 得 得 上 霜 髯	细 题 今 日 山 中 景	更 有 前 头 万 点 尖
平 沙 - 景 趣 - 今 生 - 渔 家 - 平 沙==朝 朝 两 两 下 平 沙	添 得 湖 中 景 趣 嘉	碧 卵 从 今 生 育 去	便 堪 装 点 作 渔 家
十 年 - 散 发 - 楼 上 - 潇 湘 - 十 年==浪 迹 人 间 数 十 年	年 年 散 发 醉 江 天	岳 阳 楼 上 留 三 日	聊 与 潇 湘 结 後 缘
脸 下 - 桃 叶 - 明 月 - 扬 州 - 脸 下==萧 娘 脸 下 难 胜 泪	桃 叶 眉 头 易 得 愁	天 下 三 分 明 月 夜	二 分 无 赖 是 扬 州
江 边 - 骑 驴 - 间 非 - 笑 渠 - 鲤 鱼==采 石 江 边 踏 鲤 鱼	华 山 县 里 自 骑 驴	世 间 非 醉 亦 非 睡	白 堕 黄 粱 莫 笑 渠
冥 冥 - 纸 帐 - 声 寒 - 冰 雪 - 冥 冥==茅 屋 寂 寂 烟 冥 冥	纸 帐 晓 眠 人 未 起	天 风 吹 动 笛 声 寒	春 满 江 南 冰 雪 里
花 梢 - 吹 嘘 - 城 边 - 杖 履 - 花 梢==春 到 花 梢 一 点 红	吹 嘘 应 谢 晓 来 风	南 国 缭 绕 城 边 路	无 限 诗 情 杖 履 中
森 森 - 维 摩 - 空 余 - 舞 筵 - 曙 天==野 气 森 森 欲 曙 天	维 摩 新 病 未 成 眠	空 余 无 限 罗 伽 女	乱 把 天 花 散 舞 筵
无 声 - 五 色 - 照 人 - 寒 更 - 无 声==竹 宫 幽 邃 寂 无 声	风 静 空 悬 五 色 旌	月 色 照 人 清 沁 骨	万 松 深 处 数 寒 更
三 台 - 画 鼓 - 列 炬 - 半 空 - 三 台==紫 坛 云 雾 切 三 台	玉 趾 将 临 画 鼓 催	列 炬 照 天 驰 道 远	佩 声 遥 自 半 空 来
黄 昏 - 光 涵 - 文 不 - 平 平 - 黄 昏==黄 昏 潮 落 南 沙 明	月 光 涵 沙 秋 雪 清	水 文 不 上 烟 不 荡	平 平 玉 田 冷 空 旷
水 清 - 洛 阳 - 归 去 - 凉 风 - 水 清==秋 在 水 清 山 暮 蝉	洛 阳 树 色 鸣 皋 烟	送 君 归 去 愁 不 尽	又 惜 空 度 凉 风 天
天 山 - 寂 寥 - 山 灵 - 天 晴 - 琼 瑶==天 山 万 笏 耸 琼 瑶	导 我 西 行 伴 寂 寥	我 与 山 灵 相 对 笑	满 天 晴 雪 共 难 消
报 秋 - 雨 过 - 风 韵 - 一 声 - 报 秋==樱 笋 方 夭 麦 报 秋	梅 黄 雨 过 水 平 畴	春 归 欲 带 春 风 韵	枝 上 一 声 黄 贾 留
清 新 - 古 意 - 向 声 - 风 吹 - 清 新==独 唱 清 新 拍 不 同	寥 寥 千 古 意 无 穷	拟 开 眼 向 声 前 听	早 被 风 吹 别 调 中
无 尘 - 玉 树 - 风 雨 - 梁 飞 - 月 白==罗 浮 月 白 海 无 尘	玉 树 琼 林 处 处 春	半 夜 禹 陵 风 雨 作	屋 梁 飞 动 欲 生 鳞
功 名 - 更 深 - 大 节 - 无 心 - 功 名==巧 逢 挟 忌 立 功 名	杀 父 犹 从 罪 更 深	已 托 沉 浮 轻 大 节	尚 言 富 贵 本 无 心
新 月 - 星 斗 - 在 天 - 雪 飞 - 新 月==新 月 何 曾 展 画 帏	便 教 星 斗 避 寒 辉	量 量 自 在 天 公 最	昨 日 峰 头 有 雪 飞
相 思 - 殷 勤 - 捷 径 - 口 截 - 相 思==相 思 目 断 鉴 湖 船	书 别 殷 勤 敢 赠 言	未 解 终 南 寻 捷 径	少 宽 谷 口 截 朱 辕
金 蕊 - 酒 赊 - 残 阳 - 灯 火 - 金 蕊==老 夫 爱 此 黄 金 蕊	儿 子 须 将 白 酒 赊	直 到 残 阳 下 天 去	更 添 灯 火 照 欹 斜
抱 琴 - 山 林 - 十 年 - 扰 扰 - 归 云==目 送 归 云 膝 抱 琴	山 林 犹 恐 不 高 深	应 怜 三 十 年 前 客	扰 扰 尘 心 损 道 心
霜 姿 - 风 生 - 明 月 - 参 差 - 霜 姿==夫 君 自 是 雪 霜 姿	落 笔 风 生 更 不 疑	留 向 财 前 弄 明 月	桂 枝 相 伴 影 参 差
隔 花 - 知 音 - 相 思 - 御 沟 - 花 翻==隔 花 翻 曲 月 临 墙	欲 觅 知 音 懒 斗 妆	拨 尽 相 思 不 成 调	御 沟 流 水 乱 人 肠
韫 椟 - 日 新 - 垂 柳 - 被 发 - 韫 椟==洛 京 韫 椟 起 儒 珍	地 讲 忠 规 德 日 新	禁 苑 金 丝 舞 垂 柳	万 方 已 被 发 生 仁
盈 盈 - 水 国 - 寒 梅 - 冰 霜 - 盈 盈==盈 盈 蝶 粉 衬 蜂 黄	水 国 仙 人 内 样 妆	同 在 寒 梅 应 愧 死	枯 枝 犹 说 傲 冰 霜
孤 城 - 居 人 - 蜂 游 - 夜 长 - 面 面==江 上 孤 城 面 面 山	居 人 也 自 不 曾 闲	蜂 游 蚁 聚 知 何 事	日 夜 长 桥 南 北 间
草 茸 - 清 溪 - 花 开 - 品 题 - 匝 岸==烟 草 茸 茸 匝 岸 齐	晴 天 凫 浴 喜 清 溪	一 春 造 化 花 开 尽	大 欠 渠 诗 共 品 题
远 水 - 尘 飞 - 一 枕 - 万 壑 - 远 水==远 水 环 沙 翠 作 湾	红 尘 飞 不 入 青 山	凉 风 一 枕 秋 宵 梦	梦 绕 千 岩 万 壑 间
秋 声 - 空 阶 - 天 涯 - 今 宵 - 晚 风==晚 风 庭 竹 已 秋 声	初 听 空 阶 蛩 夜 鸣	流 落 天 涯 聊 自 得	今 宵 为 尔 感 平 生
梦 中 - 帘 栊 - 金 猊 - 一 树 - 梦 中==曲 曲 屏 山 忆 梦 中	峭 寒 成 阵 入 帘 栊	宿 香 锁 尽 金 猊 冷	一 树 梅 花 却 晓 春
在 言 - 泥 牛 - 霜 威 - 天 晓 - 成 不==本 自 圆 成 不 在 言	泥 牛 耕 破 劫 初 田	夜 来 风 月 霜 威 重	天 晓 昆 仑 戴 雪 还
参 天 - 累 累 - 事 久 - 知 名 - 参 天==参 天 高 树 午 风 清	嘉 实 累 累 当 暑 成	好 事 久 传 番 尔 雅	南 方 草 木 未 知 名
弄 影 - 浪 翻 - 无 人 - 晓 风 - 弄 影==小 白 山 头 花 弄 影	潮 音 洞 口 浪 翻 空	圆 通 门 启 无 人 入	闲 把 轮 珠 立 晓 风
桃 李 - 灯 火 - 甘 棠 - 木 清 - 桃 李==桃 李 公 门 尽 向 荣	芸 窗 灯 火 读 书 声	翘 材 便 算 甘 棠 树	底 用 千 章 夏 木 清
七 宝 - 四 壁 - 九 日 - 百 年 - 七 宝==五 言 诗 作 七 宝 塔	四 壁 惟 馀 八 尺 床	一 月 二 十 九 日 醉	百 年 三 万 六 千 场
青 山 - 即 收 - 凌 波 - 疾 风 - 青 山==青 山 定 厌 俗 人 游	萝 帐 云 屏 到 即 收	更 欲 凌 波 访 幽 杀	疾 风 已 戒 早 回 舟
垂 钩 - 张 网 - 何 处 - 天 明 - 垂 钩==垂 钩 不 似 迷 津 客	张 网 诚 非 待 兔 人	半 夜 乌 鸡 何 处 去	天 明 吞 却 玉 麒 麟
碧 瓦 - 声 高 - 肠 断 - 残 月 - 碧 瓦==檐 欹 碧 瓦 拂 倾 梧	玉 井 声 高 转 辘 轳	肠 断 西 楼 惊 稳 梦	半 留 残 月 照 啼 乌
无 价 - 平 池 - 客 帆 - 花 村 - 无 价==雨 开 繁 菊 金 无 价	风 皱 平 池 鉴 有 痕	日 暮 客 帆 何 处 落	柿 林 西 畔 荻 花 村
玉 洁 - 山 花 - 归 来 - 未 见 - 玉 洁==玉 洁 冰 寒 自 一 家	地 偏 惊 此 对 山 花	归 来 不 负 西 游 眼	曾 识 人 间 未 见 花
花 间 - 盘 荐 - 儿 童 - 呼 朋 - 花 间==花 间 预 想 到 家 时	笋 蕨 堆 盘 荐 酒 卮	点 检 儿 童 参 小 学	招 呼 朋 友 说 新 诗
石 门 - 苍 苔 - 悬 崖 - 出 云 - 石 门==石 门 空 虚 谁 凿 辟	薜 荔 挂 影 苍 苔 积	悬 崖 偃 树 鹘 栖 巢	古 洞 出 云 龙 启 蛰
白 华 - 天 涯 - 断 肠 - 日 落 - 白 华==浴 苑 中 间 杨 白 华	随 风 飘 泊 向 天 涯	悲 歌 未 断 肠 先 断	日 落 长 秋 起 暮 鸦
楚 俗 - 流 荇 - 彤 管 - 归 心 - 楚 俗==日 记 采 兰 追 楚 俗	化 孚 流 荇 诵 周 诗	肃 恭 懿 德 垂 彤 管	九 御 归 心 百 福 宜
娉 婷 - 琵 琶 - 一 声 - 云 飞 - 娉 婷==娉 婷 少 妇 未 关 愁	清 夜 琵 琶 上 小 楼	裂 帛 一 声 江 月 白	碧 云 飞 起 四 山 秋
日 月 - 夕 阳 - 太 平 - 一 望 - 日 月==日 月 争 流 泪 亦 流	几 年 不 见 夕 阳 楼	太 平 时 节 古 来 少	却 上 迷 楼 一 望 休
拂 地 - 浅 浅 - 花 吹 - 春 风 - 拂 地==一 把 轻 丝 拂 地 垂	柔 梢 浅 浅 抹 燕 脂	絮 花 吹 尽 枝 方 长	却 恨 春 风 未 得 知
窗 寒 - 两 岸 - 吟 诗 - 绿 阴 - 光 摇==水 光 摇 入 碧 窗 寒	两 岸 斜 阳 照 乱 山	才 一 吟 诗 便 多 事	只 消 静 对 绿 阴 闲
风 吹 - 日 照 - 三 月 - 鹧 鸪 - 山 色==风 吹 山 色 不 生 云	日 照 澄 江 散 绮 文	空 忆 巴 陵 三 月 酒	鹧 鸪 啼 处 一 逢 君
春 日 - 汗 简 - 好 花 - 御 炉 - 春 日==青 春 日 月 鸟 飞 过	汗 简 文 书 山 叠 重	乞 取 好 花 天 上 看	宫 衣 黄 带 御 炉 烘
弹 冠 - 午 夜 - 木 德 - 江 湖 - 弹 冠==腐 儒 休 致 懒 弹 冠	楼 倚 新 秋 午 夜 阑	木 德 临 参 照 南 斗	江 湖 一 稔 百 忧 宽
野 亭 - 碧 苔 - 梨 花 - 舞 衣 - 野 亭==春 红 尽 向 野 亭 开	万 绿 轻 阴 锁 碧 苔	独 有 梨 花 能 似 雪	尊 前 半 拂 舞 衣 回
莺 声 - 一 家 - 归 去 - 夜 深 - 莺 声==莺 声 日 沸 笙 歌 奏	富 贵 春 光 别 一 家	惟 有 不 如 归 去 好	夜 深 和 月 在 梨 花
沧 溟 - 鱼 龙 - 一 笑 - 东 湖 - 沧 溟==倒 拈 折 箸 搅 沧 溟	无 限 鱼 龙 暗 里 惊	一 笑 机 关 轻 捩 转	东 湖 午 夜 月 华 明
卷 帘 - 欹 枕 - 桃 李 - 避 雪 - 阴 薄==卷 帘 阴 薄 漏 山 色	欹 枕 韵 疑 寒 雨 声	春 晚 不 知 桃 李 谢	岁 寒 非 避 雪 霜 深
无 始 - 动 地 - 静 坐 - 独 步 - 伎 俩==伎 俩 全 无 始 解 空	雨 花 动 地 泄 机 锋	欲 求 静 坐 无 方 所	独 步 寥 寥 宇 宙 中
一 叶 - 人 愁 - 独 怜 - 黄 花 - 霜 树==霜 树 今 无 一 叶 留	日 边 云 暗 使 人 愁	独 怜 扬 子 湾 头 岸	犹 有 黄 花 恋 晚 秋
碧 桃 - 绰 约 - 春 去 - 蓝 桥 - 小 寒==碧 桃 花 底 小 寒 轻	绰 约 仙 姿 格 外 清	锦 绣 卷 还 春 去 了	蓝 桥 风 露 放 云 英
童 黄 - 太 白 - 振 鹭 - 伯 鸾 - 足 名==童 黄 安 足 名 天 下	太 白 常 疑 在 世 间	生 纵 不 陪 振 鹭 列	死 犹 可 葬 伯 鸾 山
相 怜 - 骑 驴 - 明 月 - 堂 前 - 相 怜==阿 家 新 妇 最 相 怜	新 妇 骑 驴 家 便 牵	几 度 醉 归 明 月 夜	笙 歌 引 入 画 堂 前
分 明 - 气 清 - 婵 娟 - 倚 楼 - 分 明==大 江 东 去 月 分 明	乌 鹊 南 飞 露 气 清	如 此 婵 娟 人 不 爱	倚 楼 独 立 过 三 更
何 厌 - 更 可 - 松 菊 - 胶 鬲 - 来 驱==饥 来 驱 我 几 何 厌	尘 务 萦 心 更 可 嫌	不 似 陶 潜 恋 松 菊	未 闻 胶 鬲 举 鱼 盐
高 寒 - 无 尘 - 光 芒 - 十 年 - 高 寒==一 醉 高 寒 清 到 骨	四 无 尘 滓 月 当 空	光 芒 万 里 今 犹 昔	牢 落 十 年 西 复 东
千 花 - 摧 残 - 秋 雨 - 东 风 - 千 花==千 花 未 分 出 梅 余	遣 雪 摧 残 计 已 疏	卧 闻 点 滴 如 秋 雨	知 是 东 风 为 扫 除
梅 花 - 春 回 - 儿 童 - 归 去 - 梅 花==门 外 梅 花 扰 复 栽	回 时 春 去 去 春 回	儿 童 拍 手 应 相 笑	归 去 贾 生 今 又 来
铅 华 - 清 香 - 白 玉 - 野 人 - 铅 华==天 公 久 不 试 铅 华	尽 把 清 香 付 此 花	白 玉 堂 中 春 未 动	等 闲 攀 折 野 人 家
胜 事 - 千 里 - 思 归 - 为 驻 - 胜 事==江 华 胜 事 接 湘 滨	千 里 湖 山 入 兴 新	才 子 思 归 催 去 棹	汀 花 且 为 驻 残 春
衡 门 - 归 时 - 寒 食 - 霏 霏 - 衡 门==衡 门 一 别 梦 难 稀	人 欲 归 时 不 得 归	长 忆 去 年 寒 食 夜	杏 花 零 落 雨 霏 霏
风 花 - 杨 柳 - 学 宫 - 不 老 - 春 至==春 至 风 花 各 自 荣	就 中 杨 柳 最 多 情	自 从 初 学 宫 腰 舞	直 至 飘 绵 不 老 成
辇 路 - 黄 榜 - 风 流 - 西 湖 - 辇 路==曾 见 宜 秋 辇 路 门	大 书 黄 榜 许 游 行	汉 家 宽 大 风 流 在	老 去 西 湖 乐 太 平
结 绮 - 主 荒 - 轻 艳 - 更 深 - 结 绮==结 绮 临 春 无 处 寻	人 皆 归 罪 主 荒 淫	谁 知 文 体 伤 轻 艳	狎 客 迎 逢 罪 更 深
歌 舞 - 洛 阳 - 龙 骧 - 谁 家 - 歌 舞==歌 舞 从 来 最 得 名	如 今 老 寄 洛 阳 城	当 时 醉 送 龙 骧 曲	留 与 谁 家 唱 月 明
白 云 - 危 栏 - 似 雪 - 何 处 - 白 云==白 云 亭 上 白 云 闲	云 满 危 栏 雪 满 山	雪 似 白 云 云 似 雪	不 知 何 处 是 人 间
江 上 - 水 村 - 一 声 - 龙 归 - 江 上==江 上 群 峰 泼 黛 浓	水 村 烟 渚 夕 阳 红	一 声 啼 鸟 催 耕 去	何 处 龙 归 急 雨 中
飞 絮 - 东 风 - 武 陵 - 西 流 - 飞 絮==落 花 飞 絮 共 悠 悠	怕 入 东 风 燕 子 楼	为 看 武 陵 源 里 水	断 肠 东 去 不 西 流
第 一 - 来 身 - 东 风 - 一 架 - 第 一==曾 是 衣 裳 第 一 人	曲 终 认 得 本 来 身	多 年 不 作 东 风 梦	闲 却 蔷 薇 一 架 春
万 重 - 惭 愧 - 如 云 - 聊 复 - 万 重==百 家 小 邑 万 重 山	惭 愧 斯 民 爱 长 官	粳 稻 如 云 梨 枣 熟	暂 留 聊 复 为 加 餐
阑 干 - 衰 草 - 江 心 - 击 楫 - 阑 干==秋 满 阑 干 晚 共 凭	残 烟 衰 草 最 关 情	西 风 吹 起 江 心 浪	犹 作 当 时 击 楫 声
红 叶 - 忆 得 - 万 恨 - 分 明 - 红 叶==石 楠 红 叶 透 帘 春	忆 得 妆 成 下 锦 茵	试 折 一 枝 含 万 恨	分 明 说 向 梦 中 人
韶 光 - 何 处 - 尺 非 - 天 边 - 九 旬==倏 忽 韶 光 第 九 旬	无 花 何 处 觅 残 春	长 绳 万 尺 非 难 具	谁 与 天 边 绊 日 轮
蒙 蒙 - 树 影 - 深 处 - 薰 风 - 立 夏==落 絮 蒙 蒙 立 夏 天	楼 前 槐 树 影 初 圆	傅 闻 紫 殿 深 深 处	别 有 薰 风 入 舜 弦
瘦 骨 - 驰 驱 - 松 楸 - 读 书 - 瘦 骨==瘦 骨 岩 岩 祸 患 馀	追 随 人 事 愈 驰 驱	何 时 酒 扫 松 楸 畔	小 盖 茅 庵 只 读 书
梦 中 - 新 荷 - 晓 色 - 旱 时 - 梦 中==梦 中 檐 溜 作 滩 声	幼 竹 新 荷 总 解 鸣	晓 色 满 城 浑 是 喜	更 无 一 寸 旱 时 情
隐 隐 - 树 中 - 龟 鹤 - 高 风 - 隐 隐==隐 隐 数 间 清 献 宅	只 在 城 东 竹 树 中	龟 鹤 不 知 何 去 处	谁 将 白 鹿 继 高 风
扫 尘 - 石 上 - 声 动 - 养 幻 - 蒲 团==草 席 蒲 团 不 扫 尘	松 闲 石 上 似 无 人	群 阴 欲 午 钟 声 动	自 煮 溪 蔬 养 幻 身
万 卷 - 公 也 - 倚 天 - 龙 头 - 万 卷==万 卷 无 书 道 用 归	闲 文 公 也 未 须 知	倚 天 长 剑 如 重 战	更 有 龙 头 复 是 谁
芳 菲 - 诗 思 - 羡 君 - 坐 中 - 芳 菲==花 飞 忽 忽 减 芳 菲	欺 我 新 来 诗 思 迟	笔 底 羡 君 能 捷 敏	好 词 频 许 坐 中 披
万 花 - 珠 光 - 似 雾 - 春 寒 - 红 点==粉 痕 红 点 万 花 攒	玉 气 珠 光 宝 月 团	帘 箔 通 明 香 似 雾	东 君 无 处 著 春 寒
幽 人 - 悠 悠 - 青 鸟 - 消 息 - 幽 人==幽 人 往 往 怀 麻 姑	浮 世 悠 悠 仙 景 殊	自 从 青 鸟 不 堪 使	更 得 蓬 莱 消 息 无
清 都 - 沧 海 - 归 路 - 对 酒 - 清 都==绛 阙 清 都 何 时 到	沧 海 桑 田 谁 与 怜	三 十 六 天 归 路 稳	撚 花 对 酒 一 凝 然
杲 杲 - 今 朝 - 古 今 - 张 弓 - 杲 杲==红 轮 杲 杲 正 当 空	昨 日 今 朝 事 不 同	尽 谓 古 今 都 坐 断	谁 知 贼 过 后 张 弓
天 台 - 青 山 - 茅 屋 - 千 古 - 天 台==白 云 和 我 到 天 台	眼 入 青 山 意 豁 开	到 彼 山 中 结 茅 屋	空 余 千 古 夜 猿 哀
十 年 - 生 涯 - 桃 花 - 黑 风 - 十 年==三 十 年 来 在 梦 中	生 涯 丧 尽 绝 行 踪	自 惭 一 见 桃 花 后	依 旧 漫 天 鼓 黑 风
夜 深 - 鼓 声 - 戍 楼 - 吏 火 - 江 行==夜 深 犹 自 绕 江 行	震 地 江 声 似 鼓 声	渐 见 戍 楼 疑 近 驿	百 牢 关 吏 火 前 迎
江 干 - 深 根 - 谋 楚 - 临 危 - 江 干==邓 侯 城 垒 汉 江 干	自 谓 深 根 百 世 安	不 用 三 甥 谋 楚 计	临 危 方 觉 噬 脐 难
五 湖 - 故 国 - 昨 夜 - 钧 天 - 五 湖==鸱 夷 仙 去 五 湖 船	故 国 何 人 忆 计 然	昨 夜 洞 庭 秋 水 长	梦 闻 广 乐 下 钧 天
孤 云 - 地 炉 - 防 秋 - 山 窗 - 孤 云==偶 伴 孤 云 宿 岭 东	四 山 欲 雪 地 炉 红	何 人 一 纸 防 秋 疏	却 与 山 窗 障 北 风
山 河 - 无 言 - 枝 头 - 不 悟 - 山 河==咫 尺 山 河 不 易 知	无 言 莫 谓 即 无 思	人 间 只 见 枝 头 茧	不 悟 春 蚕 暗 理 丝
画 桥 - 精 神 - 无 语 - 春 风 - 画 桥==相 逢 记 得 画 桥 头	花 似 精 神 柳 似 柔	莫 谓 无 情 即 无 语	春 风 传 意 水 传 愁
坐 引 - 深 红 - 东 君 - 花 外 - 芳 围==群 芳 围 坐 引 杯 长	满 目 深 红 间 浅 黄	寄 语 东 君 好 怜 客	水 西 花 外 慢 颓 阳
千 官 - 渐 残 - 笑 张 - 对 床 - 千 官==九 重 严 召 动 千 官	五 岭 流 人 鬓 渐 残	可 笑 张 兄 与 邢 弟	对 床 时 把 剑 书 看
春 水 - 花 影 - 春 风 - 南 陌 - 春 水==一 陂 春 水 绕 花 身	花 影 妖 饶 各 占 春	纵 被 春 风 吹 作 雪	绝 胜 南 陌 碾 成 尘
炙 手 - 趋 炎 - 燃 脐 - 诗 书 - 炙 手==三 生 炙 手 权 门 者	此 日 趋 炎 态 未 除	汝 自 燃 脐 何 所 恨	可 怜 遗 臭 入 诗 书
楼 阁 - 绝 顶 - 白 云 - 七 星 - 楼 阁==称 安 楼 阁 贯 空 嵌	绝 顶 磨 霄 凝 翠 岚	若 到 白 云 犹 未 半	凭 君 更 上 七 星 岩
绿 阴 - 迟 日 - 百 花 - 石 榴 - 绿 阴==浓 绿 阴 中 黄 栗 留	醉 乡 迟 日 厌 鸣 鸠	青 春 去 後 百 花 歇	赖 有 枝 头 安 石 榴
钱 塘 - 云 水 - 金 线 - 笼 烟 - 塘 门==钱 塘 门 外 买 湖 船	雾 气 冲 云 水 接 天	只 有 苏 堤 金 线 柳	半 笼 早 日 半 笼 烟
漏 声 - 卷 舒 - 睿 思 - 团 扇 - 珠 箔==日 长 珠 箔 漏 声 疏	案 上 苏 文 恣 卷 舒	时 有 佳 篇 符 睿 思	便 将 团 扇 作 行 书
江 头 - 水 平 - 濯 缨 - 一 曲 - 江 头==风 浪 江 头 正 激 湍	小 亭 溪 上 水 平 宽	濯 缨 不 做 弹 冠 想	一 曲 沧 浪 钓 雪 寒
新 秋 - 彩 楼 - 穿 针 - 纤 纤 - 星 河==星 河 耿 耿 正 新 秋	丝 竹 千 家 列 彩 楼	可 惜 穿 针 方 有 兴	纤 纤 初 月 苦 难 留
染 青 - 一 枝 - 故 园 - 龙 孙 - 青 云==叶 染 青 云 节 抱 霜	一 枝 聊 寄 墨 君 堂	故 园 根 拨 依 然 在	会 见 龙 孙 脱 箨 香
含 情 - 风 流 - 霓 旌 - 清 词 - 含 情==含 情 遥 夜 几 人 知	闲 咏 风 流 小 谢 诗	还 似 霓 旌 下 烟 露	月 边 吹 落 上 清 词
花 残 - 秋 香 - 伤 心 - 北 岸 - 残 岁==桂 老 花 残 岁 月 催	秋 香 无 复 旧 亭 台	伤 心 乌 鹊 桥 头 水	犹 望 阊 门 北 岸 来
林 峦 - 凭 槛 - 诗 人 - 夕 阳 - 林 峦==一 带 林 峦 秀 复 奇	每 来 凭 槛 即 开 眉	好 山 深 会 诗 人 意	留 得 夕 阳 无 限 时
走 毂 - 沧 浪 - 烟 波 - 朝 宗 - 走 毂==走 毂 飞 蹄 过 此 傍	几 人 留 意 问 沧 浪	烟 波 莫 笑 趋 名 客	为 爱 朝 宗 日 夜 忙
芭 蕉 - 随 日 - 无 生 - 今 朝 - 芭 蕉==芭 蕉 无 耳 闻 雷 开	葵 华 无 眼 随 日 转	释 迦 老 子 亦 无 生	每 岁 今 朝 浴 一 遍
青 丝 - 画 戟 - 乐 府 - 太 守 - 九 曲==柳 堤 九 曲 暗 青 丝	画 戟 丛 中 昼 影 迟	传 说 姑 苏 新 乐 府	只 缘 太 守 例 能 诗
岁 华 - 芦 荻 - 风 高 - 声 寒 - 岁 华==客 窗 偏 惜 岁 华 残	芦 荻 萧 萧 雪 满 山	塞 外 风 高 鹰 翮 健	阵 前 云 起 角 声 寒
团 圆 - 古 道 - 浓 阴 - 轻 烟 - 团 圆==众 山 围 绕 渌 团 圆	官 木 参 差 古 道 边	行 飞 浓 阴 全 不 了	一 湖 飞 雨 带 轻 烟
金 屋 - 到 西 - 丁 宁 - 短 长 - 金 屋==金 屋 秋 深 露 气 凉	宫 监 久 不 到 西 厢	丁 宁 莫 窃 宁 歌 笛	鹦 姆 无 情 说 短 长
披 风 - 重 重 - 荷 花 - 鸥 鹭 - 披 风==晓 岸 披 风 驾 短 篷	平 芜 烟 浪 几 重 重	鸣 榔 莫 近 荷 花 浦	鸥 鹭 早 凉 眠 正 浓
悠 悠 - 江 南 - 壮 怀 - 千 古 - 悠 悠==夭 堑 悠 悠 尔 奈 何	大 江 南 北 自 沧 波	壮 怀 莫 遣 神 龙 笑	千 古 斜 阳 钓 艇 多
醉 月 - 银 烛 - 今 宵 - 可 得 - 醉 月==回 首 评 花 醉 月 时	频 将 银 烛 剪 催 诗	今 宵 吟 尽 思 君 句	可 得 魂 归 可 得 知
古 镜 - 清 光 - 故 人 - 尘 埃 - 古 镜==欲 炼 此 心 成 古 镜	清 光 直 透 太 虚 明	朝 来 一 洒 故 人 泪	依 旧 尘 埃 满 匣 生
一 线 - 拂 云 - 万 里 - 藤 萝 - 一 线==双 峡 凌 虚 一 线 通	高 巅 树 果 拂 云 红	青 天 万 里 知 何 限	也 伴 藤 萝 锁 峡 中
山 云 - 下 界 - 行 道 - 纷 纷 - 山 云==南 山 云 起 北 山 云	上 界 钟 声 下 界 闻	遥 望 众 僧 行 道 处	天 香 桂 子 落 纷 纷
有 香 - 总 因 - 悲 风 - 无 人 - 有 香==妓 有 香 分 客 有 鱼	主 君 头 白 总 因 渠	枯 杨 此 日 悲 风 起	寂 寞 无 人 哭 墓 庐
一 簇 - 寻 芳 - 多 情 - 菜 花 - 一 簇==绛 桃 一 簇 映 斜 晖	白 首 寻 芳 几 醉 归	更 有 多 情 双 蛱 蝶	春 来 还 傍 菜 花 飞
奇 峰 - 奇 峰 - 山 道 - 万 重 - 入 眼==一 只 奇 峰 入 眼 中	看 来 只 只 是 奇 峰	好 山 道 是 无 重 数	少 说 青 苍 十 万 重
一 雨 - 纶 巾 - 清 梦 - 数 声 - 一 雨==舟 中 一 雨 扫 飞 蝇	半 脱 纶 巾 卧 翠 藤	清 梦 初 回 窗 日 晚	数 声 柔 橹 下 巴 陵
成 绮 - 回 文 - 墨 池 - 环 绕 - 设 色==晚 来 设 色 霞 成 绮	秋 至 回 文 雁 作 行	借 问 墨 池 何 处 是	一 江 环 绕 漱 琳 琅
波 澜 - 肉 团 - 瞒 得 - 杨 柳 - 波 澜==无 端 平 地 鼓 波 澜	揭 露 娘 生 赤 肉 团	瞒 得 娇 拟 儿 女 子	溪 头 杨 柳 树 难 瞒
酌 酒 - 西 风 - 别 恨 - 两 行 - 酌 酒==僧 房 酌 酒 送 君 行	把 臂 西 风 无 限 情	此 际 若 为 销 别 恨	两 行 红 粉 啭 春 莺
绳 系 - 芳 时 - 星 斗 - 花 枝 - 绳 系==难 把 长 绳 系 日 乌	芳 时 偷 取 醉 功 夫	任 堆 金 璧 磨 星 斗	买 得 花 枝 不 老 无
青 鸟 - 瑶 台 - 一 枝 - 风 前 - 落 梅==青 鸟 东 飞 正 落 梅	衔 花 满 口 下 瑶 台	一 枝 为 授 殷 勤 意	把 向 风 前 旋 旋 开
乱 绳 - 万 丈 - 杨 柳 - 藕 花 - 千 结==乱 绳 千 结 绊 人 深	越 萝 万 丈 表 长 寿	杨 柳 在 身 垂 意 绪	藕 花 落 尽 见 莲 心
水 间 - 春 畦 - 当 路 - 却 复 - 水 间==步 绕 青 秧 绿 水 间	春 畦 交 错 路 回 环	老 翁 牵 得 牛 当 路	恐 碍 人 行 却 复 还
承 恩 - 宫 中 - 上 林 - 紫 云 - 承 恩==十 五 承 恩 侍 衮 旒	宫 中 初 拜 大 长 秋	见 说 上 林 陪 羽 猎	君 王 同 着 紫 云 裘
红 尘 - 白 首 - 君 子 - 嵌 岩 - 红 尘==红 尘 半 世 仅 绯 衫	白 首 官 曹 两 换 衔	羞 见 淮 乡 隐 君 子	紫 芝 黄 独 老 嵌 岩
雪 里 - 鹅 黄 - 蔷 薇 - 雨 洗 - 雪 里==雪 里 何 人 作 道 装	冰 绡 重 叠 色 鹅 黄	染 时 定 著 蔷 薇 露	雨 洗 风 吹 故 自 香
荒 城 - 月 色 - 夜 长 - 五 声 - 荒 城==山 绕 荒 城 水 自 流	霜 空 月 色 满 溪 楼	夜 长 欹 枕 浑 无 寐	二 十 五 声 都 是 愁
膏 泽 - 去 程 - 夜 雨 - 人 情 - 春 耕==农 忻 膏 泽 了 春 耕	客 免 深 泥 阻 去 程	日 里 放 晴 终 夜 雨	天 公 两 下 做 人 情
金 轮 - 月 未 - 当 头 - 敢 依 - 金 轮==不 动 金 轮 万 德 全	宸 苔 含 月 未 排 班	当 头 讳 字 寰 中 禁	谁 敢 依 稀 犯 圣 颜
白 马 - 红 袖 - 春 风 - 夕 阳 - 白 马==白 马 金 鞍 游 冶 郎	醉 携 红 袖 上 梅 冈	银 钿 金 雁 春 风 里	指 点 江 山 坐 夕 阳
江 东 - 别 离 - 乡 书 - 开 缄 - 江 东==江 东 烽 火 已 难 知	乱 后 那 堪 更 别 离	纵 有 乡 书 传 驿 使	开 缄 不 省 是 何 时
翠 竹 - 醉 醒 - 纷 纷 - 毫 端 - 翠 竹==来 自 青 松 翠 竹 关	秋 风 吹 帽 醉 醒 间	纷 纷 遮 眼 尘 如 海	拈 起 毫 端 又 说 山
清 都 - 气 炼 - 片 云 - 风 寒 - 清 都==是 个 清 都 一 散 郎	凝 神 聚 气 炼 丹 阳	片 云 孤 鹤 无 踪 迹	半 夜 风 寒 万 里 霜
半 圭 - 云 雨 - 龙 蛇 - 云 收 - 半 圭==范 郎 紫 玉 馀 半 圭	翻 手 作 云 雨 雹 随	龙 蛇 起 陆 孔 翟 飞	云 收 雨 霁 千 首 诗
五 夜 - 孤 枕 - 乐 事 - 无 人 - 五 夜==惯 听 山 头 五 夜 钟	忽 惊 孤 枕 景 阳 风	明 朝 乐 事 知 何 限	定 自 无 人 拜 德 公
知 名 - 逢 意 - 夜 宿 - 烛 影 - 知 名==扶 风 豪 士 不 知 名	樽 酒 相 逢 意 便 倾	争 似 何 庄 今 夜 宿	梅 花 烛 影 照 三 更
芳 丛 - 夜 飞 - 万 子 - 重 重 - 结 实==庭 榴 结 实 垫 芳 丛	一 夜 飞 霜 染 茜 容	万 子 风 胞 无 异 质	金 房 玉 隔 谩 重 重
黄 鹂 - 挟 弹 - 寂 寂 - 一 枝 - 花 深==万 花 深 处 语 黄 鹂	花 底 能 无 挟 弹 儿	自 在 两 鸠 春 寂 寂	一 枝 晴 雪 立 多 时
残 花 - 纤 纤 - 春 酒 - 短 褐 - 簌 簌==轻 挨 残 花 香 簌 簌	旋 剥 新 笋 白 纤 纤	伤 春 煮 笋 买 春 酒	短 褐 破 碎 人 家 嫌
天 寒 - 草 木 - 江 南 - 半 窗 - 寒 江==天 寒 江 国 霜 如 雪	草 木 无 情 尽 摧 折	不 知 春 意 到 江 南	疏 影 横 斜 半 窗 月
风 流 - 梅 花 - 疏 影 - 人 世 - 风 流==咸 平 处 士 风 流 远	招 得 梅 花 枝 上 魂	疏 影 暗 得 如 昨 日	不 知 人 世 几 黄 昏
月 明 - 三 更 - 阑 干 - 静 听 - 弄 月==漱 罢 寒 泉 弄 月 明	浩 然 风 露 欲 三 更	曲 阑 干 畔 踟 躇 久	静 听 空 廊 络 纬 声
凭 栏 - 茫 茫 - 流 水 - 丹 青 - 凭 栏==紫 芝 峰 上 一 凭 栏	烟 草 茫 茫 天 地 宽	眼 界 已 随 流 水 去	丹 青 无 复 旧 时 看
留 连 - 夕 阳 - 今 夜 - 江 南 - 留 连==尽 日 留 连 兴 未 阑	寒 鸦 背 负 夕 阳 还	遥 知 今 夜 空 窗 梦	只 在 江 南 水 石 间
不 二 - 吞 炭 - 委 质 - 心 贼 - 不 二==义 士 忠 臣 不 二 君	漆 身 吞 炭 欲 成 仁	若 谋 委 质 求 亲 幸	又 抱 奸 心 贼 大 伦
足 蹑 - 云 间 - 四 顾 - 日 月 - 洞 天==足 蹑 平 都 古 洞 天	此 身 不 觉 到 云 间	抬 眸 四 顾 乾 坤 阔	日 月 星 辰 任 我 攀
鲜 明 - 黄 叶 - 离 别 - 多 愁 - 色 鲜==颜 色 鲜 明 能 几 时	未 辞 黄 叶 已 辞 枝	都 缘 爱 管 闲 离 别	多 恨 多 愁 故 早 衰
青 山 - 青 山 - 说 蜃 - 晴 色 - 青 山==结 楼 多 与 青 山 对	却 是 青 山 不 对 渠	见 说 蜃 岩 排 闼 入	一 窗 晴 色 共 残 书
力 微 - 濠 梁 - 过 庄 - 两 是 - 力 微==湛 湛 清 渠 风 力 微	濠 梁 行 客 布 帆 归	到 官 应 过 庄 生 庙	试 问 鹪 鹏 两 是 非
花 红 - 馨 香 - 公 子 - 春 风 - 庭 前==庭 前 新 吐 一 花 红	袭 袭 馨 香 醉 蜜 蜂	公 子 见 来 情 兴 动	倒 吹 玉 笛 弄 春 风
寻 溪 - 一 泓 - 高 下 - 潺 潺 - 寻 溪==穿 竹 寻 溪 到 穷 处	一 泓 寒 碧 澹 无 情	谁 令 岩 窦 有 高 下	泻 作 潺 潺 鸣 玉 声
花 重 - 欲 仙 - 百 年 - 无 人 - 花 重==梅 花 重 压 帽 檐 偏	曳 杖 行 歌 意 欲 仙	後 五 百 年 君 记 取	断 无 人 似 放 翁 颠
色 鲜 - 小 桥 - 池 塘 - 窗 梦 - 水 色==天 气 妍 和 水 色 鲜	闲 吟 独 步 小 桥 边	池 塘 草 绿 无 佳 句	虚 卧 春 窗 梦 阿 怜
风 竹 - 相 思 - 一 声 - 故 乡 - 梧 叶==风 竹 萧 萧 梧 叶 黄	相 思 寸 寸 断 人 肠	一 声 塞 管 来 何 处	雁 带 秋 声 入 故 乡
篱 边 - 猛 虎 - 北 斗 - 地 轴 - 篱 边==俊 鹞 不 打 篱 边 兔	猛 虎 终 不 食 伏 肉	毛 头 星 现 北 斗 前	把 断 天 关 并 地 轴
山 巅 - 冰 雪 - 书 窗 - 婵 娟 - 山 巅==浅 清 溪 浒 瘦 山 巅	净 洗 肌 肤 冰 雪 天	偏 向 书 窗 伴 幽 独	不 教 尘 俗 滓 婵 娟
夜 静 - 隐 映 - 银 塘 - 俯 仰 - 乘 凉==夜 静 乘 凉 坐 水 亭	草 头 隐 映 见 孤 萤	瞥 然 飞 过 银 塘 面	俯 仰 浮 光 几 点 星
花 开 - 来 往 - 游 人 - 神 仙 - 花 开==葛 岭 花 开 二 月 天	游 人 来 往 说 神 仙	老 夫 心 与 游 人 异	不 羡 神 仙 羡 少 年
团 栾 - 佳 名 - 清 风 - 试 将 - 潇 洒==此 君 潇 洒 翠 团 栾	轩 扁 佳 名 墨 已 乾	欲 识 清 风 千 古 在	试 将 石 刻 句 吟 看
木 落 - 萧 然 - 道 人 - 何 处 - 木 落==木 落 同 高 八 月 天	山 荒 屋 老 意 萧 然	道 人 香 火 但 灰 冷	何 处 如 今 更 有 仙
州 博 - 乘 槎 - 玉 骨 - 马 乳 - 州 博==凉 州 博 酒 不 胜 痴	银 汉 乘 槎 领 得 归	玉 骨 瘦 来 无 一 把	向 来 马 乳 太 轻 肥
春 水 - 泛 舟 - 江 上 - 团 圆 - 春 水==春 水 新 添 几 尺 波	泛 舟 小 妇 解 吴 歌	笑 指 侬 如 江 上 月	团 圆 时 少 缺 时 多
楚 云 - 迢 递 - 得 共 - 濯 锦 - 闾 隔==南 望 乡 闾 隔 楚 云	归 心 迢 递 更 纷 纭	何 因 得 共 飞 帆 上	细 看 长 江 濯 锦 文
青 山 - 大 河 - 熙 春 - 望 宋 - 一 片==落 日 青 山 一 片 愁	大 河 东 注 不 还 流	若 为 长 得 熙 春 在	时 上 高 层 望 宋 州
江 南 - 芰 荷 - 春 色 - 花 更 - 春 色==江 南 春 色 莺 花 老	又 汲 新 泉 浸 芰 荷	春 色 后 先 君 莫 讶	后 头 花 更 得 春 多
看 山 - 风 帆 - 江 畔 - 垂 纶 - 看 云==横 看 山 色 仰 看 云	十 幅 风 帆 不 藉 人	记 取 合 江 江 畔 树	他 年 此 处 好 垂 纶
无 双 - 精 神 - 筑 坛 - 溪 边 - 无 双==国 士 无 双 未 肯 臣	汉 皇 眼 力 欠 精 神	筑 坛 直 待 追 亡 后	不 及 溪 边 一 妇 人
台 榭 - 流 水 - 济 济 - 澄 清 - 巍 峨==巍 峨 台 榭 筑 边 城	碧 海 波 流 水 有 声	济 济 登 临 供 啸 傲	沧 浪 喜 见 一 澄 清
清 香 - 对 白 - 胡 床 - 物 华 - 清 香==一 种 清 香 属 当 家	将 黄 对 白 本 非 羞	胡 床 十 日 花 前 坐	看 得 楼 成 管 物 华
凄 凉 - 霜 叶 - 一 杯 - 行 客 - 江 天==江 天 惨 澹 日 凄 凉	木 未 经 霜 叶 未 黄	今 日 楼 头 一 杯 酒	明 朝 行 客 在 谁 乡
闲 眠 - 独 坐 - 名 宇 - 林 间 - 闲 眠==花 前 静 榻 闲 眠 处	竹 下 明 窗 独 坐 时	着 甚 语 言 名 宇 泰	林 间 自 有 翠 禽 知
杜 鹃 - 佳 人 - 总 爱 - 无 人 - 杜 鹃==望 帝 春 心 托 杜 鹃	佳 人 锦 色 怨 华 年	诗 家 总 爱 西 昆 好	独 恨 无 人 作 郑 笺
策 马 - 柴 门 - 清 香 - 往 来 - 策 马==扰 扰 长 途 策 马 回	柴 门 寂 寞 画 慵 开	清 香 一 炷 茶 一 啜	赖 有 高 人 数 往 来
三 更 - 天 门 - 曹 溪 - 广 寒 - 昨 夜==昨 夜 三 更 雷 撼 山	九 天 门 户 不 曾 关	曹 溪 路 上 分 明 见	有 个 金 乌 入 广 寒
水 中 - 参 差 - 露 花 - 丝 桐 - 水 中==浸 碧 虚 亭 烟 水 中	参 差 荷 渚 小 桥 东	露 花 相 对 立 清 晓	闲 里 丝 桐 歌 舜 风
十 年 - 歌 声 - 惜 花 - 金 缕 - 广 寒==十 年 一 住 广 寒 宫	云 恋 歌 声 惯 绕 空	长 受 惜 花 花 下 唱	袖 和 金 缕 怕 春 风
羽 葆 - 不 厌 - 良 辰 - 满 头 - 羽 葆==羽 葆 层 层 间 彩 金	醉 来 不 厌 绕 丛 吟	满 头 且 应 良 辰 插	不 插 满 头 辜 此 心
绿 阴 - 案 书 - 拆 缄 - 高 情 - 绿 阴==绿 阴 侵 坐 午 窗 明	几 案 书 繁 倦 思 生	喜 拆 缄 题 新 卷 帙	故 人 惠 我 见 高 情
梅 花 - 楼 阁 - 骚 人 - 蜂 更 - 梅 花==淡 淡 梅 花 不 要 装	真 珠 楼 阁 水 精 乡	骚 人 词 客 犹 愁 冷	紫 蝶 黄 蜂 更 敢 忙
风 骚 - 谁 登 - 寂 寂 - 月 下 - 风 骚==李 杜 风 骚 少 得 朋	将 坛 高 筑 竟 谁 登	林 萝 寂 寂 湖 山 好	月 下 敲 门 只 有 僧
帝 宫 - 香 熏 - 定 知 - 玉 尘 - 帝 宫==青 帝 宫 中 第 一 妃	宝 香 熏 彻 素 绡 衣	定 知 谪 堕 不 容 久	万 斛 玉 尘 来 聘 归
风 流 - 玉 龙 - 多 英 - 一 再 - 风 流==西 府 风 流 载 世 长	玉 龙 鳞 甲 更 储 祥	庆 源 衮 衮 多 英 杰	可 但 韦 平 一 再 芳
去 时 - 归 路 - 上 下 - 浪 花 - 风 雨==去 时 风 雨 客 匆 匆	归 路 霜 晴 水 树 红	一 抹 淡 山 天 上 下	马 蹄 新 出 浪 花 中
南 游 - 丹 唇 - 孤 峰 - 丹 唇 - 昔 南==我 昔 南 游 三 眼 国	逢 人 一 笑 启 丹 唇	只 今 重 到 孤 峰 顶	依 旧 丹 唇 一 笑 新
谈 天 - 晴 窗 - 忘 言 - 花 枝 - 谈 天==谈 天 客 子 昼 敲 门	相 对 晴 窗 话 一 樽	到 底 忘 言 方 是 妙	梅 花 枝 上 看 乾 坤
青 山 - 清 泉 - 问 我 - 一 卷 - 屋 下==屋 上 青 山 屋 下 云	清 泉 为 镜 石 为 屏	客 来 问 我 谋 生 计	一 卷 家 传 相 鹤 经
梅 花 - 笑 歌 - 飘 零 - 夕 阳 - 梅 花==与 君 有 约 看 梅 花	准 拟 尊 前 共 笑 歌	花 已 飘 零 君 不 至	夕 阳 芳 草 奈 愁 何
玛 瑙 - 廊 斜 - 大 家 - 小 车 - 玛 瑙==玛 瑙 阶 边 蛱 蝶 花	玉 阑 低 转 画 廊 斜	大 家 近 日 新 经 史	不 向 宫 门 候 小 车
南 来 - 猿 鹤 - 佳 景 - 壶 中 - 两 年==失 脚 南 来 又 两 年	故 山 猿 鹤 只 凄 然	潇 湘 不 是 无 佳 景	终 觉 壶 中 别 有 天
萧 萧 - 阡 陌 - 今 朝 - 泛 酒 - 萧 萧==五 马 萧 萧 不 醉 归	祗 人 阡 陌 卷 旌 旗	今 朝 故 为 劝 农 出	未 与 诸 君 泛 酒 池
参 差 - 春 深 - 城 郭 - 京 师 - 临 风==临 风 玉 管 吹 参 差	山 坞 春 深 日 又 迟	李 白 桃 红 满 城 郭	马 融 闲 卧 望 京 师
散 兵 - 疏 帘 - 归 去 - 江 山 - 文 案==吏 散 兵 休 文 案 静	数 竿 修 竹 隔 疏 帘	嗟 予 老 矣 欲 归 去	肯 对 江 山 叹 滞 淹
翩 翩 - 蟾 宫 - 韶 光 - 鹿 鸣 - 翩 翩==弱 龄 文 采 自 翩 翩	品 擅 蟾 宫 第 一 仙	转 瞬 韶 光 周 甲 子	是 君 重 宴 鹿 鸣 年
同 气 - 齐 名 - 寒 水 - 一 茎 - 同 气==蕙 兰 同 气 犹 争 长	姚 魏 齐 名 各 一 家	不 似 优 昙 照 寒 水	一 茎 能 现 四 边 花
千 岩 - 丹 脸 - 今 夜 - 飞 仙 - 万 壑==有 客 千 岩 万 壑 中	绿 毛 丹 脸 紫 方 瞳	不 知 今 夜 西 楼 月	几 处 飞 仙 下 碧 空
西 山 - 竹 篱 - 梅 尚 - 昨 夜 - 西 山==眺 望 西 山 在 目 中	更 须 宽 展 竹 篱 通	残 梅 尚 守 清 帘 节	不 嫁 东 君 昨 夜 风
黄 云 - 一 望 - 沙 场 - 玉 门 - 紫 塞==紫 塞 黄 云 万 里 间	征 夫 一 望 总 潸 潸	今 古 沙 场 惟 白 骨	几 人 生 入 玉 门 关
雨 湿 - 道 士 - 搜 诗 - 此 时 - 雨 湿==霏 霏 小 雨 湿 松 株	疑 是 初 成 道 士 图	我 亦 搜 诗 要 穷 底	此 时 幽 思 不 枝 梧
云 山 - 尘 埃 - 十 年 - 地 角 - 云 山==每 忆 云 山 养 短 才	悔 缘 名 利 入 尘 埃	十 年 马 足 行 多 少	两 度 天 涯 地 角 来
空 山 - 风 雨 - 江 湖 - 波 涛 - 清 夜==空 山 清 夜 寒 无 寐	松 桧 摇 声 风 雨 高	行 尽 江 湖 忘 岩 壑	犹 疑 绕 屋 尽 波 涛
春 深 - 漠 漠 - 轻 薄 - 细 雨 - 春 深==春 深 犹 未 试 春 衣	漠 漠 轻 寒 酒 力 微	堪 笑 杨 花 太 轻 薄	淡 烟 细 雨 不 教 肥
花 落 - 秋 明 - 西 风 - 美 人 - 花 落==花 落 楼 空 委 翠 尘	千 秋 明 月 恨 长 新	西 风 原 上 群 芳 歇	独 有 芙 蓉 似 美 人
中 竹 - 归 来 - 重 还 - 蔷 薇 - 别 庭==昔 别 庭 中 竹 未 栽	归 来 笋 已 破 苍 苔	安 知 此 去 重 还 日	屋 后 蔷 薇 几 度 开
无 力 - 睡 思 - 如 结 - 苍 苔 - 东 风==小 桃 无 力 困 东 风	似 整 残 妆 睡 思 浓	老 子 愁 肠 正 如 结	苍 苔 满 地 点 殷 红
青 云 - 黄 叶 - 诗 人 - 登 台 - 青 云==青 云 台 殿 泉 声 隔	黄 叶 关 河 雁 影 来	别 有 诗 人 好 怀 抱	西 风 双 鬓 一 登 台
凋 残 - 晓 色 - 墨 竹 - 画 图 - 凋 残==嫩 黄 初 破 未 凋 残	风 露 相 禁 晓 色 寒	欲 并 墨 梅 兼 墨 竹	何 人 为 作 画 图 看
虚 空 - 海 月 - 四 海 - 松 下 - 虚 空==须 弥 椎 打 虚 空 鼓	撼 得 毗 卢 海 月 昏	四 海 无 波 安 乐 住	陈 家 松 下 小 柴 门
向 日 - 徘 徊 - 春 雨 - 去 来 - 向 日==岭 上 英 英 向 日 开	帝 乡 情 态 自 徘 徊	如 何 一 施 阳 春 雨	依 旧 无 心 归 去 来
三 尺 - 秋 风 - 有 恨 - 人 更 - 三 尺==京 索 先 生 三 尺 坟	秋 风 漠 漠 吐 寒 云	从 来 有 恨 君 多 哭	今 日 何 人 更 哭 君
天 姿 - 风 流 - 见 识 - 人 情 - 袅 娜==天 姿 袅 娜 十 分 娇	可 惜 风 流 半 节 腰	却 恨 画 工 无 见 识	动 人 情 处 不 曾 描
风 飘 - 残 月 - 回 文 - 断 肠 - 桑 叶==寒 信 风 飘 桑 叶 黄	冷 灯 残 月 照 空 状	看 君 寄 忆 回 文 锦	字 字 萦 愁 写 断 肠
松 柏 - 上 生 - 古 木 - 牛 羊 - 松 柏==越 井 岗 头 松 柏 老	越 王 台 上 生 秋 草	古 木 多 年 无 子 孙	牛 羊 践 踏 成 官 道
淅 沥 - 万 里 - 寂 寞 - 闭 门 - 淅 沥==扇 风 淅 沥 簟 流 离	万 里 南 风 滞 所 思	守 到 清 秋 还 寂 寞	叶 丹 苔 碧 闭 门 时
三 山 - 虎 踞 - 若 跨 - 拔 条 - 三 山==三 山 昂 首 状 魁 嵬	虎 踞 龙 蟠 萃 一 台	若 跨 地 灵 规 贡 手	英 才 衮 衮 拔 条 枚
邻 鸡 - 树 头 - 人 归 - 客 愁 - 邻 鸡==邻 鸡 三 唱 趣 行 舟	霜 结 银 花 满 树 头	好 景 留 人 归 未 得	客 愁 一 半 是 吟 愁
东 郭 - 高 卧 - 屠 龙 - 千 金 - 东 郭==连 墙 东 郭 倦 追 寻	高 卧 毗 耶 老 病 侵	自 愧 屠 龙 真 拙 技	漫 令 吾 子 费 千 金
不 训 - 西 祖 - 枝 叶 - 法 身 - 不 训==不 训 威 音 劫 外 春	错 将 西 祖 意 瞒 人	纷 纷 多 是 寻 枝 叶	谁 向 枯 椿 透 法 身
重 阳 - 无 人 - 脉 脉 - 小 春 - 重 阳==节 过 重 阳 又 一 旬	白 衣 送 酒 更 无 人	含 情 脉 脉 如 将 吐	笑 口 留 开 报 小 春
江 南 - 诗 人 - 沧 浪 - 白 苹 - 草 木==吟 尽 江 南 草 木 春	只 今 台 阁 有 诗 人	汉 廷 安 用 沧 浪 句	容 我 持 竿 咏 白 苹
风 光 - 箫 鼓 - 花 灯 - 寒 江 - 雅 淡==雅 淡 风 光 近 上 元	迎 神 箫 鼓 自 年 年	客 行 不 趁 花 灯 市	月 满 寒 江 水 拍 天
朵 朵 - 看 霓 - 风 情 - 太 常 - 桃 花==仙 苑 桃 花 朵 朵 香	曾 于 天 上 看 霓 裳	刘 郎 老 去 风 情 减	闲 把 音 容 问 太 常
烟 霏 - 朝 日 - 神 仙 - 何 处 - 银 宫==银 宫 翠 岛 烟 霏 霏	珠 树 玲 珑 朝 日 晖	神 仙 望 见 不 得 到	却 逐 回 风 何 处 归
盐 梅 - 一 一 - 安 排 - 丹 青 - 盐 梅==春 工 调 物 似 盐 梅	一 一 根 中 生 意 回	风 日 安 排 催 岁 换	丹 青 次 第 与 花 开
无 尘 - 问 津 - 向 苍 - 三 三 - 无 尘==山 头 有 路 接 无 尘	欲 觅 王 孙 试 问 津	瞥 向 苍 崖 高 处 见	三 三 两 两 看 游 人
空 蒙 - 高 下 - 春 光 - 花 柳 - 空 蒙==一 春 烟 雨 歇 空 蒙	高 下 川 原 杳 霭 中	毕 竟 春 光 遮 不 得	满 村 花 柳 自 青 红
白 白 - 焚 香 - 清 明 - 江 南 - 白 白==梨 花 白 白 柳 条 青	闭 阁 焚 香 奈 雨 声	闻 道 清 明 明 日 是	江 南 风 土 只 宜 晴
雪 底 - 婴 儿 - 白 头 - 江 鱼 - 雪 底==竹 底 春 从 雪 底 归	烦 君 抱 送 玉 婴 儿	白 头 无 复 迎 船 喜	只 供 江 鱼 作 许 悲
九 秋 - 吼 抱 - 三 日 - 闲 云 - 苍 烟==白 雾 苍 烟 暗 九 秋	殷 床 金 吼 抱 山 楼	为 霖 未 必 浑 三 日	似 有 闲 云 伴 我 留
饮 而 - 四 海 - 高 士 - 鱼 龙 - 生 不==先 生 不 饮 而 常 醉	醉 倒 四 海 支 狂 流	不 烦 高 士 倾 佳 酿	要 使 鱼 龙 同 我 愁
烟 凝 - 日 落 - 焦 桐 - 柳 吴 - 烟 凝==吹 台 山 上 彩 烟 凝	日 落 云 收 叠 翠 屏	应 谓 焦 桐 堪 采 斫	不 知 谁 是 柳 吴 兴
斜 阳 - 归 巢 - 黄 昏 - 诗 人 - 斜 阳==天 外 斜 阳 犹 在 树	林 间 宿 鸟 已 归 巢	黄 昏 莫 把 柴 门 掩	恐 有 诗 人 带 月 敲
峥 嵘 - 前 溪 - 窗 不 - 枝 上 - 云 脚==云 脚 峥 嵘 日 欲 西	钓 舟 个 个 泊 前 溪	客 窗 不 寐 君 知 否	枝 上 饥 乌 夜 正 啼
芳 草 - 春 色 - 花 落 - 蝶 来 - 芳 草==绿 池 芳 草 满 晴 波	春 色 都 从 雨 里 过	知 是 邻 家 花 落 尽	菜 畦 今 日 蝶 来 多
芙 蓉 - 灯 深 - 吹 笙 - 丹 凤 - 芙 蓉==芙 蓉 寒 艳 镂 冰 姿	天 朗 灯 深 拔 豸 时	好 见 吹 笙 伊 洛 上	紫 烟 丹 凤 亦 相 随
片 云 - 翠 霭 - 寒 泉 - 长 吟 - 片 云==片 云 轻 度 半 岩 阴	巾 屦 俄 惊 翠 霭 深	涧 底 寒 泉 知 客 懒	石 根 虢 虢 自 长 吟
几 上 - 而 今 - 花 开 - 西 风 - 几 上==四 卷 楞 伽 几 上 安	而 今 老 去 懒 能 看	庭 前 桂 树 花 开 未	分 别 西 风 信 鼻 端
苍 苍 - 回 翔 - 家 饲 - 今 朝 - 苍 苍==苍 苍 终 日 锁 春 愁	欲 去 回 翔 更 少 留	傅 说 王 家 饲 燕 女	今 朝 珠 报 始 知 由
凤 凰 - 入 青 - 玉 箫 - 遗 声 - 凤 凰==秦 娥 一 别 凤 凰 台	东 入 青 冥 更 不 回	空 有 玉 箫 千 载 后	遗 声 时 到 世 间 来
风 愁 - 推 敲 - 辛 勤 - 得 一 - 风 愁==风 愁 月 恨 属 诗 翁	终 日 推 敲 句 未 工	何 苦 辛 勤 学 郊 岛	呕 心 博 得 一 生 穷
楼 台 - 银 花 - 多 情 - 游 人 - 楼 台==华 灯 下 上 照 楼 台	无 数 银 花 一 夕 开	月 色 多 情 能 助 兴	游 人 去 了 却 重 回
佳 节 - 浴 兰 - 此 时 - 长 生 - 佳 节==山 来 佳 节 载 南 荆	一 浴 兰 汤 万 虑 清	仙 苑 此 时 收 百 药	炼 丹 飞 石 保 长 生
泼 泼 - 青 青 - 春 雨 - 月 过 - 泼 泼==鱼 虾 泼 泼 初 出 网	梅 杏 青 青 已 著 枝	满 树 嫩 晴 春 雨 歇	行 人 四 月 过 淮 时
元 巳 - 贵 家 - 风 光 - 纷 纷 - 元 巳==帝 京 元 巳 足 繁 华	细 管 清 弦 七 贵 家	此 日 风 光 谁 不 共	纷 纷 皆 是 掖 垣 花
门 三 - 是 非 - 无 端 - 担 片 - 戳 瞎==戳 瞎 顶 门 三 只 眼	是 非 佛 法 一 齐 划	竹 篦 头 上 放 无 端	正 是 徐 六 担 片 板
南 华 - 两 川 - 低 声 - 作 人 - 华 谁==颂 罢 南 华 谁 得 闻	两 川 寒 玉 一 禅 身	松 边 弹 舌 低 声 念	莫 引 龙 来 变 作 人
瘦 坐 - 衲 衣 - 春 光 - 断 猿 - 涧 边==瘦 坐 清 行 合 涧 边	衲 衣 楚 楚 湿 苍 烟	春 光 尽 逐 杖 黎 去	留 得 暮 山 啼 断 猿
色 浓 - 黄 昏 - 连 云 - 垂 丝 - 色 浓==画 手 三 川 著 色 浓	黄 昏 更 在 独 围 中	佳 期 落 日 连 云 合	艳 采 垂 丝 带 缕 红
宫 殿 - 舞 衫 - 归 去 - 寒 花 - 宫 殿==旧 日 骊 山 宫 殿 中	玉 妃 无 数 舞 衫 红	只 因 归 去 蓬 莱 后	梦 作 寒 花 笑 北 风
塞 上 - 春 草 - 万 里 - 日 日 - 塞 上==五 原 塞 上 款 呼 韩	春 草 新 迷 拜 将 坛	从 此 车 书 三 万 里	边 臣 日 日 奏 平 安
家 声 - 挥 毫 - 得 意 - 醉 如 - 家 声==家 声 籍 籍 大 江 西	临 老 挥 毫 捧 御 题	得 意 何 殊 少 年 乐	还 家 不 惜 醉 如 泥
烧 灯 - 西 风 - 别 意 - 桃 红 - 烧 灯==鞭 春 已 罢 烧 灯 近	十 日 西 风 未 转 东	料 得 化 工 无 别 意	只 因 不 放 不 桃 红
消 日 - 憔 悴 - 归 去 - 自 由 - 烟 消==烟 消 日 出 见 秋 真	政 恐 却 成 憔 悴 人	赖 是 倦 游 归 去 日	扁 舟 载 著 自 由 自
泣 鬼 - 红 尘 - 结 庐 - 夜 半 - 泣 鬼==丹 篆 才 书 泣 鬼 神	年 逾 九 十 脱 红 尘	至 今 岩 上 结 庐 处	夜 半 凤 凰 栖 绿 筠
暮 云 - 村 落 - 黄 叶 - 春 色 - 暮 云==楚 天 寂 历 暮 云 平	何 处 江 村 落 雁 声	正 是 西 风 扫 黄 叶	不 知 春 色 在 朱 荣
西 风 - 离 愁 - 此 时 - 雨 过 - 萧 瑟==西 风 萧 瑟 入 船 窗	送 客 离 愁 酒 满 缸	要 记 此 时 分 袂 处	暮 烟 细 雨 过 松 江
幽 岩 - 松 枝 - 新 诗 - 一 声 - 幽 岩==夜 上 幽 岩 踏 灵 草	松 枝 已 疏 桂 枝 老	新 诗 几 度 惜 不 吟	此 处 一 声 风 月 好
春 风 - 暮 钟 - 窗 间 - 花 开 - 春 风==定 庵 回 首 几 春 风	坏 砌 颓 檐 咽 暮 钟	惟 有 窗 间 双 月 桂	花 开 还 似 旧 时 红
天 涯 - 精 神 - 照 水 - 鸟 声 - 天 涯==流 落 天 涯 一 病 身	簿 书 丛 里 费 精 神	殷 勤 照 水 窥 华 发	黄 鸟 声 中 又 一 春
如 茵 - 江 南 - 飞 絮 - 落 花 - 如 茵==原 头 芳 草 绿 如 茵	寒 食 江 南 已 过 春	飞 絮 漫 天 兼 绕 路	落 花 如 海 倍 愁 人
东 郊 - 融 和 - 游 人 - 不 暖 - 苍 苍==东 郊 无 地 不 苍 苍	日 气 融 和 自 有 香	最 是 游 人 行 乐 处	不 寒 不 暖 昼 偏 长
尘 埃 - 曝 背 - 山 鸟 - 日 上 - 得 一==尘 埃 收 得 一 身 闲	饮 尽 春 瓶 曝 背 眠	醉 耳 犹 嫌 山 鸟 聒	梦 魂 终 日 上 高 天
灵 根 - 白 发 - 汉 庭 - 颇 疑 - 灵 根==商 山 深 处 养 灵 根	白 发 昂 藏 满 面 春	一 出 汉 庭 安 汉 嗣	颇 疑 倾 得 戚 夫 人
蕙 草 - 翰 苑 - 君 门 - 马 上 - 蕙 草==降 士 林 沾 蕙 草 寒	弦 惊 翰 苑 失 鸳 鸾	秋 中 回 首 君 门 阻	马 上 应 歌 行 路 难
落 日 - 山 蹊 - 通 宵 - 岭 啼 - 落 日==落 日 官 军 举 号 齐	雕 戈 画 盾 障 山 蹊	不 嫌 铜 斗 通 宵 击	却 厌 斑 鸡 半 岭 啼
生 涯 - 处 何 - 桥 下 - 新 茶 - 生 涯==江 湖 便 是 老 生 涯	佳 处 何 妨 且 泊 家	自 汲 松 江 桥 下 水	垂 虹 亭 上 试 新 茶
鸥 鹭 - 沧 洲 - 醉 帽 - 风 马 - 鸥 鹭==鸥 鹭 逢 人 问 归 信	三 年 作 客 负 沧 洲	诗 袍 醉 帽 黄 埃 底	羞 见 扶 风 马 少 游
水 云 - 画 舫 - 玉 楼 - 水 晶 - 水 云==吴 兴 城 阙 水 云 中	画 舫 青 帘 处 处 通	溪 上 玉 楼 楼 上 月	清 光 合 作 水 晶 宫
北 风 - 且 可 - 投 局 - 吟 诗 - 风 吹==北 风 吹 人 不 可 出	清 坐 且 可 与 君 棋	明 朝 投 局 日 未 晚	从 此 亦 复 不 吟 诗
妙 龄 - 风 云 - 捷 径 - 徐 行 - 妙 龄==妙 龄 徒 手 掇 科 名	发 轫 风 云 九 万 程	捷 径 何 妨 聊 决 起	通 途 自 分 且 徐 行
映 日 - 袅 袅 - 伤 心 - 归 路 - 映 日==映 日 初 花 隔 槛 明	春 风 袅 袅 透 寒 轻	伤 心 怕 听 枝 头 鸟	莫 向 王 孙 归 路 鸣
晓 风 - 层 层 - 江 南 - 鹤 顶 - 十 月==十 月 幽 园 开 晓 风	层 层 绛 蕊 艳 芳 业	江 南 只 惯 收 鹰 爪	谁 顾 山 前 鹤 顶 红
金 蕊 - 多 情 - 归 田 - 东 篱 - 金 蕊==金 蕊 繁 开 晓 更 清	薄 霜 浓 露 倍 多 情	归 田 谁 是 渊 明 兴	独 绕 东 篱 万 事 轻
腊 残 - 白 昼 - 瑶 草 - 琪 树 - 归 家==腊 残 滕 六 不 归 家	白 昼 乘 风 撒 玉 沙	旋 种 琼 田 茁 瑶 草	更 栽 琪 树 著 银 花
镂 玉 - 今 夜 - 黄 昏 - 见 道 - 镂 玉==浴 金 熏 炉 镂 玉 奁	兰 香 今 夜 为 君 添	乌 栖 黄 昏 乌 起 曙	才 见 道 来 还 道 去
巧 匠 - 亭 亭 - 一 团 - 金 波 - 巧 匠==桥 前 巧 匠 剪 春 罗	桥 上 亭 亭 景 物 和	明 夜 元 宵 一 团 玉	连 波 还 解 似 金 波
穿 岩 - 处 处 - 人 事 - 宫 商 - 穿 岩==路 穿 岩 窦 折 羊 肠	处 处 亭 台 御 墨 香	流 水 不 随 人 事 去	尚 余 丝 竹 旧 宫 商
出 山 - 真 味 - 松 根 - 余 甘 - 出 山==拣 芽 芳 字 出 山 南	真 味 那 容 取 次 参	曾 向 松 根 烹 瀑 雪	至 今 齿 颊 尚 余 甘
东 风 - 余 寒 - 满 地 - 分 明 - 东 风==东 风 吹 雨 作 丝 轻	驾 勒 余 寒 放 晚 晴	满 地 湿 云 收 未 尽	一 帘 花 影 不 分 明
草 短 - 烟 飞 - 春 来 - 东 风 - 草 短==嫩 水 浴 凫 芳 草 短	淡 烟 飞 燕 落 花 天	绿 杨 也 识 春 来 暖	一 夜 东 风 脱 却 绵
风 吹 - 篮 舆 - 春 早 - 欲 飞 - 吹 雨==东 风 吹 雨 水 平 沙	下 却 篮 舆 访 洒 家	行 役 不 知 春 早 暮	墙 头 红 杏 欲 飞 花
水 中 - 烟 波 - 将 断 - 云 间 - 水 中==孤 悬 一 岛 水 中 央	极 目 烟 波 万 顷 长	沙 外 数 条 将 断 线	云 间 几 幅 未 归 航
梅 开 - 道 人 - 官 舍 - 茅 檐 - 梅 开==屋 角 梅 开 才 一 枝	道 人 眼 净 得 先 窥	寒 听 政 尔 犹 官 舍	不 似 茅 檐 见 汝 时
灰 心 - 孤 城 - 举 头 - 水 声 - 知 命==知 命 灰 心 况 宠 名	故 求 穷 僻 守 孤 城	举 头 但 对 青 山 色	近 听 唯 闻 绿 水 声
清 秋 - 渔 翁 - 箬 笠 - 貂 蝉 - 清 秋==石 帆 山 下 醉 清 秋	常 伴 渔 翁 弄 小 舟	箬 笠 照 溪 吾 自 喜	貂 蝉 谁 管 出 兜 鍪
幽 鸟 - 层 层 - 临 池 - 鹅 儿 - 幽 鸟==幽 鸟 呼 人 出 睡 乡	层 层 露 叶 漏 朝 阳	临 池 只 欲 消 残 醉	无 奈 鹅 儿 似 酒 黄
草 堂 - 清 香 - 云 深 - 头 回 - 草 堂==草 堂 未 可 便 移 文	自 煮 清 香 碧 润 芹	更 向 白 云 深 处 宿	山 头 回 首 谢 诸 君
深 山 - 烟 浓 - 看 花 - 松 门 - 深 山==深 山 别 是 一 乾 坤	春 谷 烟 浓 树 树 昏	正 好 看 花 立 溪 口	雨 来 催 我 进 松 门
菊 老 - 舞 风 - 阆 苑 - 小 春 - 菊 老==荷 衰 菊 老 柳 微 黄	蝶 舞 风 林 叶 共 狂	阆 苑 无 花 留 不 住	飞 来 学 做 小 春 忙
雕 盘 - 团 扇 - 百 福 - 喜 气 - 楚 粽==一 一 雕 盘 分 楚 粽	重 重 团 扇 画 秦 娥	宫 闱 百 福 逢 嘉 序	万 户 千 门 喜 气 多
一 丝 - 江 上 - 不 归 - 洛 阳 - 一 丝==人 间 万 事 一 丝 轻	江 上 数 峰 双 眼 明	老 我 不 归 空 看 画	秋 风 又 到 洛 阳 城
文 章 - 屠 龙 - 冠 盖 - 雄 强 - 文 章==漫 学 文 章 弊 性 灵	屠 龙 艺 就 误 平 生	翩 翩 仕 路 新 冠 盖	何 用 扬 雄 强 作 经
佳 人 - 团 圆 - 秋 风 - 一 片 - 佳 人==佳 人 失 手 镜 初 分	何 日 团 圆 再 会 君	今 朝 万 里 秋 风 起	山 北 山 南 一 片 云
风 光 - 黄 金 - 作 花 - 花 枝 - 风 光==老 去 风 光 不 属 身	黄 金 莫 惜 买 青 春	白 头 纵 作 花 园 主	醉 折 花 枝 是 别 人
古 今 - 相 呈 - 不 曾 - 迟 迟 - 古 今==动 弦 别 贡 古 今 稀	觌 面 相 呈 第 二 机	祖 你 不 曾 离 正 位	一 帘 化 日 自 迟 迟
残 云 - 风 吹 - 千 里 - 斜 日 - 残 云==衰 草 残 云 古 战 场	腥 风 吹 血 溅 衣 裳	尘 沙 一 望 三 千 里	惟 见 马 头 斜 日 黄
一 杯 - 美 人 - 秋 色 - 桃 花 - 一 杯==清 酒 一 杯 甜 似 蜜	美 人 双 鬓 黑 如 鸦	莫 夸 春 色 欺 秋 色	未 信 桃 花 胜 菊 花
老 树 - 无 声 - 花 开 - 春 风 - 老 树==老 树 枯 苔 雪 乍 晴	饥 乌 飞 集 噤 无 声	蒺 藜 沙 上 花 开 早	且 让 春 风 与 燕 莺
花 草 - 嫩 绿 - 野 色 - 解 鞍 - 花 草==满 城 花 草 斗 欣 荣	嫩 绿 夭 红 照 眼 明	会 有 禅 房 通 野 色	解 鞍 聊 复 憩 予 行
竹 林 - 一 张 - 黄 昏 - 三 弄 - 倚 竹==屋 瞰 梅 间 倚 竹 林	一 炉 香 篆 一 张 琴	有 时 月 上 黄 昏 后	三 弄 寒 梅 夜 正 深
老 去 - 风 清 - 儿 童 - 山 家 - 将 携==老 去 将 携 只 要 轻	况 临 炎 暑 绕 风 清	儿 童 爱 把 承 帘 溜	未 识 山 家 质 素 情
腊 雪 - 梅 花 - 道 人 - 万 点 - 腊 雪==去 年 腊 雪 一 尺 围	著 处 梅 花 如 许 肥	道 人 定 复 有 幻 法	莫 遣 都 梁 万 点 飞
雪 消 - 风 送 - 烂 熳 - 看 花 - 雪 消==雪 消 山 水 见 精 神	满 眼 东 风 送 早 春	明 日 杏 园 应 烂 熳	但 须 期 约 看 花 人
读 书 - 多 情 - 千 古 - 齐 眉 - 读 书==惟 读 书 人 能 好 色	是 真 名 士 许 多 情	画 眉 千 古 传 佳 话	何 似 齐 眉 不 唤 卿
几 家 - 泥 沙 - 风 送 - 得 一 - 榔 遍==烟 草 槟 榔 遍 几 家	金 钱 不 惜 掷 泥 沙	夕 阳 门 巷 香 风 送	拣 得 一 篮 鹰 爪 花
纤 手 - 高 楼 - 知 音 - 花 阴 - 清 闲==纤 手 清 闲 理 瑟 工	高 楼 半 在 碧 云 中	行 人 岂 是 知 音 者	小 立 花 阴 待 曲 终
漠 漠 - 桑 麻 - 池 塘 - 春 深 - 漠 漠==漠 漠 余 香 着 草 花	森 森 柔 绿 长 桑 麻	池 塘 水 满 蛙 成 市	门 巷 春 深 燕 作 家
万 户 - 短 篷 - 何 处 - 千 金 - 万 户==谁 能 投 笔 规 万 户	但 可 短 篷 称 散 人	逼 侧 世 途 何 处 避	千 金 难 买 是 间 身
千 山 - 飞 空 - 芬 芳 - 朱 栏 - 翠 色==雨 过 千 山 翠 色 重	群 花 欲 尽 絮 飞 空	牡 丹 寂 寞 芬 芳 晚	日 暮 朱 栏 独 倚 风
香 烟 - 静 听 - 春 意 - 梨 花 - 香 烟==一 穗 香 烟 到 日 斜	静 听 蜂 报 二 时 衙	老 僧 不 解 伤 春 意	多 采 梨 花 作 供 花
玉 井 - 天 寒 - 须 重 - 云 锦 - 玉 井==玉 井 峰 头 十 丈 莲	天 寒 日 暮 更 清 妍	不 须 重 咏 洛 神 赋	便 可 同 赓 云 锦 篇
城 头 - 暖 气 - 成 行 - 打 洛 - 城 头==城 头 欲 上 苦 新 泥	暖 气 薰 人 软 欲 痴	睡 又 不 成 行 不 是	强 来 看 打 洛 神 碑
春 风 - 鸿 雁 - 百 里 - 烟 啼 - 花 香==春 风 陌 上 野 花 香	目 送 北 归 鸿 雁 行	百 里 青 山 行 不 尽	隔 烟 啼 鸟 又 斜 阳
春 发 - 秋 深 - 菊 残 - 洛 阳 - 春 发==香 包 已 向 青 春 发	又 见 秋 深 特 地 开	应 笑 菊 残 无 意 思	不 能 邀 赋 洛 阳 才
纷 纷 - 钓 丝 - 礼 乐 - 太 史 - 纷 纷==战 国 纷 纷 似 乱 麻	钓 丝 谁 记 旧 稼 华	召 南 礼 乐 栖 何 许	故 莒 城 中 太 史 家
清 高 - 空 山 - 云 桥 - 精 神 - 嚣 尘==清 高 品 格 谢 嚣 尘	流 水 空 山 太 古 春	寒 士 云 桥 来 过 访	怜 君 耐 冷 共 精 神
千 古 - 穿 云 - 落 日 - 落 雁 - 千 古==千 古 南 谯 炳 地 灵	穿 云 雁 塔 自 层 层	残 烟 落 日 荒 墟 上	父 老 相 传 落 雁 亭
神 仙 - 云 车 - 三 尺 - 开 旧 - 洞 府==洞 府 神 仙 此 是 家	麻 姑 曾 驻 五 云 车	峰 前 三 尺 寒 泉 水	犹 有 白 莲 开 旧 花
扶 桑 - 五 色 - 海 面 - 散 紫 - 扶 桑==列 坐 扶 桑 大 帝 前	六 铢 五 色 照 琼 田	直 凌 海 面 行 空 去	飒 飒 天 风 散 紫 烟
人 情 - 波 浪 - 山 川 - 泉 无 - 可 畏==可 畏 人 情 与 世 途	险 如 波 浪 起 江 湖	岂 知 荆 楚 山 川 地	坎 井 泓 泉 无 处 无
春 风 - 楼 台 - 一 声 - 玉 栏 - 春 风==九 天 宫 阕 春 风 满	陆 地 楼 台 夜 月 寒	铁 笛 一 声 吹 雁 落	片 云 不 到 玉 栏 干
仙 仗 - 洛 水 - 望 幸 - 离 宫 - 仙 仗==汉 家 仙 仗 在 咸 阳	洛 水 东 流 出 建 章	野 老 至 今 犹 望 幸	离 宫 秋 树 独 苍 苍
洛 阳 - 梅 花 - 浮 云 - 江 水 - 柳 絮==柳 絮 飞 时 别 洛 阳	梅 花 发 后 到 三 湘	世 情 已 逐 浮 云 散	离 恨 空 随 江 水 长
如 云 - 流 水 - 盘 石 - 松 花 - 如 云==二 天 封 部 稼 如 云	流 水 清 寒 出 洞 门	更 爱 林 间 盘 石 上	松 花 飘 落 羽 人 樽
三 月 - 啼 鹃 - 小 楼 - 惊 心 - 三 月==燕 山 三 月 初 三 夜	听 得 啼 鹃 第 一 声	同 是 小 楼 孤 烛 下	主 人 熟 睡 客 惊 心
半 夜 - 渡 江 - 罢 波 - 欲 衔 - 半 夜==半 夜 闻 歌 客 寝 惊	空 余 缥 缈 渡 江 声	湘 妃 舞 罢 波 纹 冷	月 欲 衔 山 天 未 明
牡 丹 - 神 仙 - 神 仙 - 洞 天 - 牡 丹==数 载 幽 栏 种 牡 丹	裹 香 包 艳 待 神 仙	神 仙 既 有 丹 青 术	携 取 何 妨 入 洞 天
斜 阳 - 野 人 - 春 色 - 桥 边 - 斜 阳==夕 照 斜 阳 柳 外 鸦	杏 园 衰 谢 野 人 家	欲 寻 春 色 无 寻 处	尽 在 桥 边 野 草 花
惊 蛰 - 金 鳞 - 滴 水 - 千 峰 - 冷 泉==冷 泉 二 月 雷 惊 蛰	烧 尾 金 鳞 化 作 龙	拖 去 鼻 头 涓 滴 水	洗 清 雁 宕 几 千 峰
明 珠 - 一 家 - 山 纵 - 双 飞 - 明 珠==何 必 明 珠 十 斛 偿	一 家 八 口 托 檀 郎	唐 山 纵 有 西 归 日	不 肯 双 飞 过 墨 洋
泠 泠 - 凉 生 - 好 梦 - 风 雨 - 泠 泠==一 派 泠 泠 绕 槛 清	尘 襟 洗 涤 自 凉 生	夜 深 好 梦 才 惊 破	疑 是 半 天 风 雨 声
直 渠 - 爬 沙 - 河 面 - 千 里 - 直 渠==直 渠 杀 势 烦 才 吏	机 器 爬 沙 聚 水 兵	河 面 常 从 天 上 落	金 堤 千 里 护 都 城
别 驾 - 到 处 - 青 山 - 黄 壤 - 别 驾==庐 陵 别 驾 有 慈 闱	到 处 官 亭 见 彩 衣	总 为 青 山 能 送 老	不 知 黄 壤 却 同 归
茸 茸 - 花 落 - 斜 风 - 一 年 - 草 色==堤 边 草 色 绿 茸 茸	堤 上 桃 花 落 尽 红	细 雨 斜 风 三 月 暮	一 年 春 事 客 愁 中
千 载 - 萧 条 - 杨 柳 - 春 风 - 千 载==一 别 狮 山 千 载 期	萧 条 吟 屋 费 修 治	手 栽 门 户 新 杨 柳	试 问 春 风 长 几 枝
幽 人 - 丹 井 - 长 松 - 半 夜 - 幽 人==幽 人 自 爱 山 中 宿	又 近 葛 洪 丹 井 西	窗 中 有 个 长 松 树	半 夜 子 规 来 上 啼
残 红 - 风 摧 - 怅 望 - 亭 前 - 无 人==残 红 零 落 无 人 赏	雨 打 风 摧 花 不 全	诸 处 见 时 犹 怅 望	况 当 元 九 小 亭 前
枫 宸 - 美 新 - 肠 明 - 天 禄 - 枫 宸==甘 泉 献 赋 风 枫 宸	更 著 剧 秦 与 美 新	设 果 出 肠 明 日 死	投 身 天 禄 又 何 人
爱 花 - 寻 芳 - 道 人 - 今 朝 - 爱 花==平 生 自 是 爱 花 人	到 处 寻 芳 不 遇 真	祗 道 人 间 无 正 色	今 朝 初 见 洛 阳 春
累 累 - 西 风 - 客 怀 - 万 缕 - 黄 花==黄 花 翠 蔓 子 累 累	写 出 西 风 雨 一 篱	愁 绝 客 怀 浑 怕 见	老 来 万 缕 足 秋 思
阳 春 - 红 绿 - 花 如 - 锦 绣 - 阳 春==洛 阳 春 日 最 繁 华	红 绿 阴 中 十 万 家	谁 道 群 花 如 锦 乡	人 将 锦 绣 学 群 花
秋 香 - 楼 台 - 花 上 - 窗 间 - 烂 熳==秋 香 烂 熳 入 屏 帷	金 粟 楼 台 富 贵 时	晓 起 旋 收 花 上 露	窗 间 闲 写 夜 来 诗
酒 旗 - 堤 下 - 人 争 - 中 流 - 酒 旗==酒 旗 相 望 大 堤 头	堤 下 连 樯 堤 下 楼	日 暮 行 人 争 渡 急	桨 声 幽 轧 满 中 流
阴 阴 - 漠 漠 - 长 歌 - 白 头 - 阴 阴==山 木 阴 阴 击 晚 牛	水 田 漠 漠 任 春 鸥	长 歌 大 笑 却 归 去	长 在 农 家 今 白 头
清 香 - 狂 风 - 红 日 - 经 年 - 清 香==清 香 冷 艳 偏 多 处	猛 雨 狂 风 未 有 前	赏 意 正 浓 红 日 坠	如 何 既 去 遂 经 年
石 门 - 看 云 - 晴 后 - 月 夜 - 石 门==石 门 双 阙 入 蓬 瀛	日 日 惟 看 云 雾 生	白 蜃 吹 霓 晴 后 见	翠 蚪 衔 月 夜 中 行
檀 心 - 寒 梅 - 一 枝 - 花 容 - 羽 衣==玉 质 檀 心 翠 羽 衣	寒 梅 开 后 独 当 时	一 枝 折 得 将 谁 赠	想 见 花 容 出 雾 帷
堂 堂 - 无 人 - 云 破 - 万 丈 - 堂 堂==有 客 堂 堂 空 两 手	无 人 为 借 太 阿 来	与 君 上 抉 浮 云 破	放 出 阳 光 万 丈 开
七 宝 - 高 低 - 十 年 - 树 间 - 七 宝==邓 尉 山 边 七 宝 滩	高 低 如 画 好 溪 山	十 年 游 赏 经 行 遍	多 少 名 题 竹 树 间
竹 径 - 杖 藜 - 清 阴 - 斤 斧 - 竹 径==仙 隐 深 深 竹 径 中	杖 藜 还 许 我 相 从	君 能 惜 取 清 阴 在	斤 斧 须 令 赦 箨 龙
万 壑 - 着 雨 - 中 大 - 云 阴 - 摇 风==老 桧 摇 风 万 壑 声	梨 花 着 雨 四 山 明	龛 中 大 士 好 看 客	排 遣 云 阴 作 晚 晴
一 叶 - 法 身 - 明 年 - 春 风 - 飘 空==一 叶 飘 空 便 见 秋	法 身 须 透 闹 啾 啾	明 年 更 有 新 条 在	恼 乱 春 风 卒 未 休
春 水 - 风 寒 - 杜 鹃 - 今 蜀 - 春 水==春 水 方 生 秋 又 残	上 流 无 处 避 风 寒	杜 鹃 飞 向 东 南 去	怕 见 如 今 蜀 道 难
新 图 - 不 用 - 清 奇 - 利 名 - 履 道==何 须 履 道 写 新 图	不 用 悲 歌 缺 唾 壶	岩 壑 清 奇 皆 我 有	利 名 缰 锁 向 来 无
温 润 - 廉 是 - 不 贪 - 玉 人 - 温 润==子 怜 温 润 欲 归 仁	吾 贵 坚 廉 是 宝 身	自 有 不 贪 身 内 宝	玉 人 徒 献 外 来 珍
残 日 - 开 元 - 清 光 - 人 间 - 残 日==半 轮 残 日 掩 斋 埃	依 稀 旬 有 开 元 巡	想 见 清 光 未 破 时	买 尽 人 间 不 平 事
一 脉 - 骨 相 - 曲 肱 - 南 山 - 一 脉==日 饮 云 根 一 脉 泉	知 君 骨 相 自 应 仙	曲 肱 闲 卧 茅 檐 下	买 断 南 山 不 用 钱
垂 虹 - 远 风 - 辽 海 - 水 晶 - 秋 晚==云 帆 秋 晚 过 垂 虹	落 日 鲸 波 动 远 风	欲 借 仙 家 辽 海 鹤	月 明 吹 笛 水 晶 宫
时 得 - 秋 来 - 云 山 - 分 明 - 溪 行==笋 舆 时 得 并 溪 行	溪 水 秋 来 似 鉴 清	仰 春 云 山 劳 眼 力	临 流 照 眼 却 分 明
凿 石 - 傍 水 - 波 清 - 寒 梅 - 天 开==方 池 凿 石 似 天 开	谁 把 霜 英 傍 水 栽	月 白 波 清 无 觅 处	只 知 疏 影 是 寒 梅
黄 花 - 风 味 - 彭 泽 - 花 枝 - 黄 花==可 意 黄 花 是 处 开	芝 兰 风 味 合 相 陪	应 须 学 取 陶 彭 泽	左 把 花 枝 右 把 杯
汾 阴 - 四 海 - 风 月 - 泉 声 - 汾 阴==汾 阴 西 祀 告 升 平	四 海 无 波 镜 样 清	乞 与 幽 人 好 风 月	万 山 里 许 听 泉 声
江 上 - 岩 前 - 石 肠 - 应 风 - 江 上==平 羌 江 上 首 空 回	慈 姥 岩 前 定 把 杯	纵 使 石 肠 都 忘 却	也 应 风 雨 送 愁 来
粉 翅 - 惜 花 - 个 个 - 到 处 - 粉 翅==粉 翅 萦 花 几 度 忙	惜 花 长 是 为 春 光	争 如 个 个 蜂 须 上	到 处 分 甘 作 乳 房
江 南 - 石 上 - 知 更 - 香 烟 - 江 南==江 南 风 致 说 僧 家	石 上 清 香 竹 里 茶	法 藏 名 僧 知 更 好	香 烟 茶 晕 满 袈 裟
笔 端 - 江 南 - 春 归 - 横 斜 - 笔 端==笔 端 造 化 出 天 巧	写 出 江 南 雪 压 枝	谁 道 春 归 无 觅 处	横 斜 全 似 越 溪 时
玉 京 - 不 老 - 丹 灶 - 寒 烟 - 石 门==石 门 定 与 玉 京 连	曾 著 方 壶 不 老 仙	犹 有 当 年 丹 灶 在	空 岩 寂 寂 锁 寒 烟
南 山 - 洛 尾 - 杨 柳 - 孤 舟 - 南 山==日 出 南 山 春 雾 收	浑 浑 洛 尾 入 淮 流	莫 向 行 人 赠 杨 柳	折 将 离 恨 入 孤 舟
珠 帘 - 上 下 - 夜 半 - 九 霄 - 玲 珑==珠 帘 当 面 见 玲 珑	白 鹤 仙 人 上 下 通	夜 半 蕊 珠 重 命 宴	鸣 鞘 声 落 九 霄 中
江 边 - 江 上 - 明 月 - 蛾 眉 - 江 边==江 边 日 暮 不 胜 愁	送 客 沾 衣 江 上 楼	明 月 峡 添 明 月 照	蛾 眉 峰 似 两 眉 愁
龙 山 - 奇 文 - 风 流 - 愧 牢 - 龙 山==龙 山 仙 去 参 谋 死	纵 有 奇 文 欲 似 谁	前 辈 风 流 只 公 在	不 才 我 定 愧 牢 之
睡 已 - 冒 霜 - 酒 醒 - 觅 书 - 已 安==倦 仆 厨 中 睡 已 安	吹 灯 呼 起 冒 霜 寒	酒 醒 无 限 悲 歌 意	不 觅 书 看 觅 剑 看
仙 源 - 通 津 - 武 陵 - 桃 花 - 仙 源==尽 说 仙 源 隔 片 尘	谁 知 枕 上 是 通 津	武 陵 太 守 无 仙 骨	只 见 桃 花 不 见 人
西 风 - 月 华 - 枝 柔 - 绿 叶 - 西 风==西 风 顿 拆 晚 秋 葩	色 映 霜 华 与 月 华	不 特 翠 枝 柔 猗 傩	更 饶 绿 叶 密 交 加
弥 天 - 洋 洋 - 正 气 - 凤 凰 - 弥 天==匝 地 弥 天 日 用 常	寂 然 不 动 已 洋 洋	但 令 正 气 无 参 杂	立 见 岐 山 叫 凤 凰
春 色 - 岁 月 - 白 发 - 玉 颜 - 春 色==禁 城 春 色 又 将 过	岁 月 于 人 奈 老 何	不 向 镜 中 添 白 发	玉 颜 犹 胜 旧 时 多
日 长 - 花 开 - 风 吹 - 春 来 - 长 吟==日 长 吟 院 无 公 事	燕 入 花 开 必 有 诗	莫 道 南 风 吹 雁 去	春 来 亦 有 北 风 时
崔 嵬 - 青 旗 - 一 声 - 太 平 - 九 重==九 重 云 气 郁 崔 嵬	日 转 青 旗 瑞 色 开	晨 跸 一 声 春 又 到	太 平 天 子 上 瑶 杯
藕 花 - 梧 桐 - 凄 凉 - 梦 中 - 藕 花==白 藕 花 前 一 信 风	飒 然 吹 雨 到 梧 桐	可 怜 一 段 凄 凉 意	并 入 西 窗 客 梦 中
鸳 鸯 - 鲜 伴 - 翡 翠 - 酒 樽 - 鸳 鸯==官 池 二 十 四 鸳 鸯	锦 彩 争 鲜 伴 醉 狂	翡 翠 有 儿 知 更 好	几 时 飞 到 酒 樽 傍
万 叠 - 太 白 - 国 锄 - 归 来 - 万 叠==并 海 名 山 万 叠 开	太 慈 太 白 等 蓬 莱	自 从 斋 国 锄 云 后	又 见 夫 人 驾 归 来
西 湖 - 猿 鹤 - 雨 意 - 巾 尽 - 西 湖==又 入 西 湖 醉 过 春	岭 头 猿 鹤 几 时 闻	无 端 雨 意 随 人 去	直 恐 衣 巾 尽 是 云
月 落 - 清 香 - 一 醉 - 百 年 - 月 落==参 横 月 落 梦 何 从	且 领 清 香 入 盏 中	一 岁 见 梅 须 一 醉	梅 前 有 几 百 年 翁
柳 色 - 莺 啼 - 无 人 - 御 沟 - 参 差==柳 色 参 差 掩 画 楼	晓 莺 啼 送 满 宫 愁	年 年 花 落 无 人 见	空 逐 春 泉 出 御 沟
江 上 - 林 间 - 登 山 - 归 梦 - 江 上==江 上 清 香 隔 水 闻	林 间 不 见 雪 纷 纷	春 寒 忽 忆 登 山 屐	归 梦 犹 寻 谷 口 云
陈 言 - 律 吾 - 藁 端 - 前 村 - 圆 字==句 圆 字 稳 削 陈 言	诗 律 吾 曹 合 细 论	五 藁 端 能 压 南 岳	后 村 死 后 有 前 村
风 摇 - 熟 梅 - 去 路 - 撒 手 - 风 摇==风 摇 顶 笠 晓 山 隈	觅 法 心 如 未 熟 梅	去 路 两 肩 担 不 起	会 看 撒 手 得 空 回
杏 子 - 菜 花 - 日 长 - 蝶 飞 - 梅 子==梅 子 金 黄 杏 子 肥	麦 花 雪 白 菜 花 稀	日 长 篱 落 无 人 过	惟 有 蜻 蜒 蛱 蝶 飞
玉 质 - 数 枝 - 东 风 - 桃 李 - 玉 质==高 花 玉 质 照 穷 腊	破 雪 数 枝 春 已 多	一 时 倾 倒 东 风 意	桃 李 争 春 奈 晚 何
道 人 - 扁 舟 - 玉 轴 - 彷 佛 - 道 人==道 人 此 书 欲 在 眼	扁 舟 一 宿 亦 随 身	霁 月 光 风 开 玉 轴	千 年 彷 佛 见 斯 人
出 家 - 荷 花 - 香 销 - 上 赐 - 出 家==淡 服 慵 妆 似 出 家	银 屏 添 水 浸 荷 花	香 销 日 午 经 千 遍	冰 碗 新 尝 上 赐 瓜
白 发 - 年 光 - 著 书 - 悠 悠 - 白 发==闲 将 白 发 照 清 沟	太 息 年 光 逝 不 留	勋 业 无 期 著 书 晚	此 生 与 世 判 悠 悠
莺 语 - 余 香 - 南 亩 - 野 水 - 柳 阴==柳 阴 嫩 绿 藏 莺 语	花 径 余 香 著 燕 泥	南 亩 十 分 农 事 好	平 畴 野 水 称 耕 犁
春 水 - 数 声 - 风 雨 - 神 仙 - 春 水==洞 前 春 水 漾 桃 溪	洞 后 数 声 青 鸟 啼	二 十 四 岩 风 雨 夜	神 仙 过 此 话 刀 圭
月 中 - 碧 树 - 金 粟 - 妖 艳 - 月 中==人 间 植 物 月 中 根	碧 树 分 敷 散 宝 熏	自 是 庄 严 等 金 粟	不 将 妖 艳 比 红 裙
水 晶 - 不 夜 - 图 书 - 三 更 - 水 晶==水 晶 帘 映 宝 灯 明	海 上 移 来 不 夜 城	何 似 图 书 群 玉 府	青 藜 青 对 月 三 更
阑 干 - 聚 散 - 逢 江 - 马 嘶 - 阑 干==芳 郊 欲 别 阑 干 泪	故 国 难 期 聚 散 云	分 手 更 逢 江 驿 暮	马 嘶 猿 叫 不 堪 闻
江 边 - 借 箸 - 仄 席 - 相 如 - 年 年==江 边 胡 虏 年 年 盛	借 箸 应 须 为 扫 除	闻 道 汉 皇 方 仄 席	不 因 词 赋 召 相 如
五 日 - 水 生 - 千 秋 - 晚 晴 - 春 郊==一 百 五 日 春 郊 行	三 十 六 溪 春 水 生	千 秋 观 里 逢 急 雨	射 的 峰 前 看 晚 晴
老 树 - 白 水 - 一 邱 - 归 来 - 断 崖==断 崖 老 树 互 撑 拄	白 水 绿 畦 相 灌 输	焉 得 溪 南 一 邱 壑	放 船 画 作 归 来 图
上 林 - 雪 花 - 柳 条 - 依 依 - 上 林==烟 满 上 林 春 未 归	三 三 两 两 雪 花 飞	柳 条 别 得 东 皇 意	映 堤 拂 水 已 依 依
水 精 - 知 是 - 繁 星 - 得 一 - 水 精==水 精 方 局 石 桥 仙	知 是 柯 山 几 代 孙	月 借 繁 星 作 棋 子	夜 寒 睹 得 一 金 盆
野 水 - 高 低 - 鸾 飞 - 残 阳 - 野 水==野 水 微 茫 路 欲 迷	重 重 沙 渚 自 高 低	鹭 鸾 飞 过 无 心 泊	直 入 残 阳 树 杪 栖
一 年 - 拥 鼻 - 雨 过 - 残 红 - 一 年==一 年 春 事 又 成 空	拥 鼻 微 吟 半 醉 中	夹 路 桃 花 风 雨 过	马 蹄 无 处 避 残 红
茫 茫 - 云 无 - 风 月 - 一 钓 - 泽 国==泽 国 茫 茫 水 接 天	孰 云 无 法 与 人 传	见 成 风 月 难 回 避	尽 在 华 亭 一 钓 船
蜀 门 - 蜀 国 - 氏 长 - 山 川 - 蜀 门==蜀 门 西 更 上 青 天	强 为 公 歌 蜀 国 弦	卓 氏 长 卿 称 士 女	锦 江 玉 垒 献 山 川
叶 落 - 疏 松 - 凌 霄 - 夜 静 - 叶 落==叶 落 山 空 木 露 青	疏 松 老 柏 翠 停 停	高 凌 霄 汉 云 长 护	夜 静 风 涛 响 若 霆
为 霖 - 山 河 - 桧 楫 - 济 川 - 为 霖==未 能 为 雨 与 为 霖	旷 览 山 河 感 不 禁	细 缀 蒲 帆 修 桧 楫	舵 工 也 有 济 川 心
春 意 - 梦 回 - 残 月 - 山 鸟 - 春 意==春 意 已 深 寒 未 了	梦 回 斗 帐 房 栊 悄	五 更 五 点 残 月 销	山 鸟 一 声 先 破 晓
金 殿 - 凤 池 - 恩 波 - 御 沟 - 金 殿==金 殿 分 来 玉 砌 流	黑 龙 河 撤 凤 池 头	后 庭 花 落 恩 波 断	翻 与 南 塘 作 御 沟
神 交 - 仙 风 - 青 云 - 题 诗 - 神 交==诗 社 神 交 识 乃 翁	耳 孙 凛 凛 有 仙 风	青 云 垂 上 斜 飞 去	时 要 题 诗 偏 浙 东
千 丈 - 对 面 - 千 林 - 晓 星 - 千 丈==每 忆 西 山 千 丈 秀	云 霾 对 面 失 空 青	千 林 夜 雪 无 人 迹	独 策 羸 骖 带 晓 星
往 来 - 炉 昼 - 细 雨 - 霏 霏 - 往 来==天 寒 古 寺 往 来 然	门 掩 柴 炉 昼 共 围	细 雨 无 声 潜 自 落	开 帘 时 复 见 霏 霏
晴 日 - 望 中 - 来 到 - 东 风 - 一 川==一 川 晴 日 破 春 容	柳 絮 桃 红 赴 望 中	莫 喜 芳 辰 又 来 到	少 年 能 耐 几 东 风
人 情 - 意 不 - 一 幅 - 寒 温 - 人 事==人 情 人 事 拨 来 无	惟 有 亲 知 意 不 疏	数 幅 沓 来 还 一 幅	寒 温 而 已 作 回 书
巡 檐 - 晓 霜 - 宫 妆 - 汤 饼 - 巡 檐==巡 檐 诗 袖 涨 寒 香	日 炙 南 枝 泫 晓 霜	净 洗 宫 妆 转 明 洁	恰 如 汤 饼 试 何 郎
夭 桃 - 未 为 - 压 树 - 一 日 - 夭 桃==姹 李 夭 桃 竞 放 颠	家 山 习 见 未 为 妍	番 姜 压 树 暹 兰 吐	一 日 还 欣 见 二 贤
腊 雪 - 复 上 - 东 城 - 风 光 - 腊 雪==腊 雪 已 知 收 岁 事	快 晴 喜 复 上 朝 晖	清 樽 要 及 东 城 醉	趁 取 风 光 未 苦 飞
天 台 - 多 情 - 云 收 - 瑶 台 - 天 台==阮 郎 正 好 住 天 台	玉 女 多 情 忍 放 回	雨 散 云 收 一 天 碧	薰 风 吹 梦 到 瑶 台
龙 尾 - 杨 柳 - 翠 华 - 无 人 - 斜 日==斜 日 倒 穿 龙 尾 道	杨 柳 半 枯 秋 色 老	翠 华 西 幸 华 清 宫	长 门 落 叶 无 人 扫
柳 岸 - 精 舍 - 煮 茶 - 残 阳 - 柳 岸==柳 岸 晴 缘 十 里 来	水 边 精 舍 绝 尘 埃	煮 茶 尝 摘 兴 何 极	直 至 残 阳 未 欲 回
千 日 - 玄 都 - 天 门 - 秋 声 - 千 日==中 山 千 日 酒 初 醒	却 爱 玄 都 夜 景 清	起 坐 天 门 吹 玉 笛	月 中 珠 树 起 秋 声
斗 鸡 - 街 觅 - 白 马 - 晓 云 - 斗 鸡==斗 鸡 赢 得 海 东 青	臂 向 东 街 觅 弟 兄	白 马 翩 翩 相 逐 去	灞 陵 原 上 晓 云 平
游 山 - 寂 静 - 不 语 - 满 林 - 游 山==游 山 有 约 爽 秋 时	寂 静 僧 房 花 压 枝	最 是 停 怀 愁 不 语	满 林 啼 鸟 似 催 诗
春 来 - 倚 栏 - 长 条 - 照 影 - 水 阁==水 阁 春 来 乍 减 寒	晓 妆 初 罢 倚 栏 干	长 条 乱 拂 春 波 动	不 许 佳 人 照 影 看
天 马 - 玉 门 - 勒 勋 - 春 色 - 天 马==雅 歌 不 待 来 天 马	谢 质 今 应 闭 玉 门	早 勒 勋 名 上 彝 鼎	放 回 春 色 满 乾 坤
伊 轧 - 沙 鸥 - 小 艇 - 和 雪 - 橹 声==橹 声 伊 轧 下 漓 来	惊 起 沙 鸥 去 又 回	小 艇 暂 停 曲 江 游	推 篷 和 雪 看 寒 梅
风 吹 - 鼓 催 - 春 涨 - 会 与 - 东 风==东 风 吹 雨 晚 潮 生	叠 鼓 催 船 镜 裹 行	底 事 今 年 春 涨 小	去 年 会 与 昼 桥 平
羊 裘 - 中 天 - 帝 座 - 封 侯 - 泽 畔==故 人 泽 畔 被 羊 裘	高 挹 中 天 会 冕 旒	不 使 客 星 侵 帝 座	谩 夸 拜 衮 与 封 侯
巽 二 - 恶 破 - 功 业 - 停 杯 - 巽 二==滕 六 无 端 巽 二 痴	翻 天 作 恶 破 春 迟	邀 梅 勒 柳 何 功 业	谁 与 停 杯 一 问 之
鸡 鸣 - 疾 徐 - 南 来 - 难 并 - 鸡 鸣==鸡 鸣 非 时 乃 祸 口	那 无 荒 更 同 疾 徐	信 知 南 来 事 总 异	不 但 斯 人 难 并 居
高 卧 - 骑 驴 - 一 笑 - 济 时 - 高 卧==避 名 高 卧 白 云 深	扶 醉 骑 驴 下 碧 岑	一 笑 披 袍 惊 隋 处	用 时 知 有 济 时 心
碧 波 - 西 湖 - 春 色 - 扬 州 - 碧 波==碧 波 青 嶂 对 红 楼	千 古 西 湖 乐 未 休	试 把 腰 缠 卖 春 色	不 知 世 上 有 扬 州
碧 涧 - 野 人 - 松 醪 - 葛 藤 - 一 幅==一 幅 新 裁 碧 涧 冰	野 人 留 客 宿 云 层	山 房 恰 好 松 醪 熟	夜 半 无 眠 话 葛 藤
四 时 - 均 调 - 画 戟 - 甘 雨 - 四 时==阳 开 阴 阖 四 时 更	谁 解 均 调 玉 煜 明	画 戟 香 中 沛 恩 泽	祥 风 甘 雨 自 流 行
池 面 - 小 窗 - 秋 来 - 炎 天 - 粼 粼==池 面 粼 粼 已 送 凉	小 窗 危 坐 听 风 篁	不 应 尚 厌 秋 来 热	已 减 炎 天 五 刻 长
风 细 - 日 永 - 冰 壶 - 赭 黄 - 来 风==凉 生 玉 宇 来 风 细	日 永 金 徒 报 漏 稀	皎 洁 冰 壶 清 水 殿	三 千 争 捧 赭 黄 衣
栽 花 - 流 水 - 不 老 - 蜂 蝶 - 栽 花==洛 阳 风 俗 事 栽 花	流 水 园 林 眇 一 涯	移 得 旧 根 春 不 老	错 疑 蜂 蝶 过 邻 家
藤 萝 - 无 尘 - 得 似 - 有 风 - 根 盘==根 盘 蛟 蜃 路 藤 萝	四 面 无 尘 辍 棹 过	得 似 吾 师 始 惆 怅	眼 前 终 日 有 风 波
春 风 - 长 亭 - 相 思 - 梨 花 - 杨 柳==二 月 春 风 杨 柳 青	闻 郎 系 马 到 长 亭	相 思 情 味 如 中 酒	折 尽 梨 花 嗅 不 醒
夕 阳 - 色 浓 - 时 马 - 骡 踪 - 夕 阳==牛 山 日 日 夕 阳 红	鹿 洞 年 年 草 色 浓	更 有 当 时 马 行 处	郴 人 犹 指 旧 骡 踪
树 老 - 穿 溪 - 树 密 - 幽 花 - 树 老==溪 上 清 涟 树 老 苍	行 穿 溪 树 踏 青 阳	溪 深 树 密 无 人 处	只 有 幽 花 度 水 香
高 飞 - 梦 惊 - 玄 真 - 钓 竿 - 碧 落==黄 鹄 高 飞 碧 落 寒	向 来 山 水 梦 惊 残	故 情 若 问 玄 真 子	依 旧 江 头 把 钓 竿
落 尽 - 竹 箨 - 步 步 - 溪 桥 - 尽 桐==落 尽 桐 花 春 已 休	过 墙 新 竹 箨 初 抽	山 行 步 步 黄 泥 滑	小 立 溪 桥 听 雨 鸠
玉 山 - 看 刘 - 闭 门 - 谁 家 - 玉 山==莫 寻 群 玉 山 头 路	莫 看 刘 郎 观 里 花	但 解 闭 门 留 我 住	主 人 休 问 是 谁 家
浅 浅 - 水 仙 - 一 枝 - 雪 花 - 浅 浅==短 短 青 蒲 浅 浅 沙	春 风 不 隔 水 仙 家	一 枝 未 报 江 南 信	旋 琢 湖 水 看 雪 花
春 回 - 香 动 - 一 枝 - 千 片 - 春 回==春 回 积 雪 层 冰 里	香 动 荒 山 野 水 滨	带 月 一 枝 低 弄 影	背 风 千 片 远 随 人
天 柱 - 清 音 - 肝 肠 - 洞 天 - 天 柱==天 柱 峰 头 吐 细 泉	清 音 亭 下 玉 琅 然	可 能 为 涤 肝 肠 滓	容 我 超 摇 五 洞 天
壶 中 - 丰 颊 - 莼 羹 - 催 促 - 壶 中==壶 中 老 子 兴 不 浅	丰 颊 樽 前 胜 玉 梅	肯 为 莼 羹 下 犀 箸	聊 凭 催 促 好 诗 来
看 花 - 红 紫 - 三 月 - 昨 夜 - 梦 中==病 眼 看 花 似 梦 中	可 堪 红 紫 半 成 空	一 年 三 月 春 馀 几	枕 上 那 闻 昨 夜 风
青 青 - 荷 叶 - 花 柳 - 樽 阿 - 梅 子==梅 子 青 青 杏 子 红	绕 城 荷 叶 已 掀 风	莫 嫌 春 尽 无 花 柳	犹 得 清 樽 阿 堵 中
风 雨 - 差 池 - 伤 别 - 司 勋 - 高 楼==高 楼 风 雨 感 斯 文	短 翼 差 池 不 及 群	刻 意 伤 春 复 伤 别	人 间 惟 有 杜 司 勋
毫 厘 - 掣 电 - 别 思 - 是 无 - 千 里==差 之 毫 厘 失 千 里	掣 电 之 机 休 拟 议	不 在 低 头 与 别 思	普 光 即 是 无 师 智
物 华 - 风 前 - 残 红 - 万 家 - 物 华==投 老 殷 勤 向 物 华	风 前 犹 欲 拾 余 花	更 将 梦 逐 残 红 去	遍 入 长 安 百 万 家
青 萍 - 无 根 - 人 道 - 分 明 - 不 种==盆 池 本 不 种 青 萍	春 杪 无 根 也 自 生	人 道 一 宵 生 九 叶	不 知 谁 数 得 分 明
干 将 - 夜 光 - 利 钝 - 玉 匣 - 干 将==越 溪 清 水 淬 干 将	鬼 魅 惊 啼 畏 夜 光	不 共 铅 刀 争 利 钝	何 妨 玉 匣 且 深 藏
离 披 - 千 重 - 树 密 - 月 中 - 离 披==星 榆 叶 叶 昼 离 披	云 粉 千 重 凝 不 飞	昆 玉 楼 台 珠 树 密	夜 来 谁 向 月 中 归
亭 成 - 舞 袖 - 萧 萧 - 西 风 - 裴 相==裴 相 亭 成 未 退 身	空 烦 舞 袖 与 歌 尘	至 今 亭 上 萧 萧 竹	似 对 西 风 怨 主 人
高 卧 - 锦 绣 - 樵 歌 - 客 愁 - 白 云==拂 苔 高 卧 白 云 根	梦 绕 春 风 锦 绣 园	蓦 听 采 樵 歌 一 贡	醒 来 月 挂 客 愁 村
轻 红 - 斜 阳 - 琼 玉 - 水 晶 - 轻 红==轻 红 浇 翠 抹 弓 腰	高 映 斜 阳 跨 碧 霄	半 似 一 条 琼 玉 带	合 成 五 色 水 晶 桥
道 士 - 白 水 - 东 轩 - 风 月 - 道 士==碧 崖 道 士 拍 洪 肩	白 水 真 人 觅 玉 泉	我 似 东 轩 无 一 物	阁 山 风 月 不 论 钱
云 影 - 倚 阑 - 江 湖 - 肠 断 - 青 云==青 云 影 里 自 由 身	几 倚 阑 干 看 不 真	又 是 江 湖 春 雪 尽	年 年 肠 断 玉 关 人
一 日 - 分 明 - 新 竹 - 听 雨 - 一 日==天 漏 都 无 一 日 晴	如 何 翻 覆 太 分 明	一 车 乡 午 过 新 竹	却 少 潇 潇 听 雨 声
金 谷 - 鹧 鸪 - 闻 处 - 月 明 - 第 一==金 谷 歌 传 第 一 流	鹧 鸪 清 怨 碧 烟 愁	夜 来 省 得 曾 闻 处	万 里 月 明 湘 水 秋
踏 青 - 草 木 - 泪 尽 - 得 见 - 郊 原==郊 原 几 度 踏 青 晴	此 日 空 山 草 木 春	泪 尽 两 行 悲 不 尽	眼 前 安 得 见 斯 人
池 塘 - 雨 余 - 黄 梅 - 披 雾 - 池 塘==草 满 池 塘 水 满 川	雨 余 溪 溜 正 溅 溅	黄 梅 恰 在 山 多 处	披 雾 时 看 一 握 天
狨 鞍 - 游 山 - 草 木 - 玉 节 - 懒 跨==懒 跨 狨 鞍 趁 晓 班	却 空 蜡 屐 小 游 山	山 头 草 木 生 光 彩	玉 节 曾 行 紫 翠 间
清 秋 - 倚 楼 - 黄 花 - 重 阳 - 清 秋==何 事 清 秋 已 衣 绵	微 寒 最 怯 倚 楼 天	江 南 今 岁 黄 花 早	醉 嚼 重 阳 半 月 前
万 条 - 一 望 - 城 边 - 画 桥 - 杨 柳==杨 柳 春 风 绿 万 条	凭 鞍 一 望 已 魂 消	当 年 凤 集 城 边 路	曾 爱 纤 纤 拂 画 桥
萧 萧 - 野 花 - 淮 水 - 西 流 - 萧 萧==白 雁 萧 萧 柿 叶 红	野 花 开 尽 六 王 宫	空 余 一 道 秦 淮 水	著 意 西 流 竟 向 东
寂 寞 - 鸟 雀 - 乐 事 - 笙 歌 - 寂 寞==吾 庐 寂 寞 类 荒 村	但 有 林 间 鸟 雀 喧	不 似 楚 家 多 乐 事	笙 歌 拾 得 醉 邻 园
雁 塔 - 名 誉 - 归 来 - 未 见 - 蟾 宫==雁 塔 蟾 宫 尽 假 途	要 须 行 实 副 名 誉	六 经 堂 上 归 来 日	饱 读 平 生 未 见 书
晓 霜 - 天 光 - 催 归 - 断 肠 - 晓 霜==孤 雁 哀 哀 叫 晓 霜	客 衾 如 水 待 天 光	不 缘 杜 宇 催 归 去	未 信 寒 猿 解 断 肠
小 桥 - 水 穿 - 空 蒙 - 从 教 - 小 桥==小 桥 只 在 槿 篱 东	沟 水 穿 篱 曲 折 通	烟 雨 空 蒙 最 堪 乐	从 教 打 湿 败 天 公
百 花 - 尘 埃 - 千 里 - 杜 鹃 - 百 花==归 来 已 负 百 花 期	闲 拂 尘 埃 看 旧 诗	极 目 平 芜 二 千 里	乡 心 惟 有 杜 鹃 知
荷 叶 - 出 没 - 故 人 - 阴 免 - 荷 叶==荷 叶 浦 边 支 港 多	凶 人 出 没 土 人 窝	故 人 饭 我 非 留 滞	月 黑 天 阴 免 夜 过
满 庭 - 梦 中 - 马 上 - 山 月 - 梅 花==落 尽 梅 花 雪 满 庭	故 园 杨 柳 梦 中 青	羌 儿 马 上 传 来 曲	今 夜 关 山 月 里 听
晚 晴 - 星 光 - 飞 去 - 幽 花 - 晚 晴==无 数 舟 航 共 晚 晴	大 星 光 见 月 初 生	背 人 白 鸟 双 飞 去	隔 水 幽 花 一 树 明
微 风 - 晶 色 - 犹 未 - 月 明 - 微 风==微 风 不 动 敛 涛 湍	组 练 晶 晶 色 界 寒	斜 照 发 挥 犹 未 尽	月 明 残 夜 更 来 看
疏 疏 - 月 朗 - 夜 声 - 栏 边 - 疏 疏==涧 草 疏 疏 萤 火 光	山 月 朗 朗 枫 树 长	南 村 犊 子 夜 声 急	应 是 栏 边 新 有 霜
千 里 - 扛 鼎 - 范 增 - 乌 江 - 千 里==八 尺 将 军 千 里 骓	拔 山 扛 鼎 不 妨 奇	范 增 力 尽 无 施 处	路 到 乌 江 君 自 知
山 容 - 波 影 - 出 处 - 猿 鹤 - 山 容==云 抹 山 容 疑 泼 绿	月 涵 波 影 自 摇 金	丈 夫 出 处 如 云 月	猿 鹤 安 能 识 此 心
得 一 - 不 生 - 春 睡 - 露 冷 - 得 一==海 棠 别 得 一 风 光	恨 不 生 香 转 曲 廊	春 睡 太 真 困 未 足	胭 脂 露 冷 湿 红 妆
骄 阳 - 路 长 - 公 怜 - 清 凉 - 骄 阳==病 躯 终 日 困 骄 阳	正 虑 行 行 去 路 长	多 谢 天 公 怜 此 意	时 飞 疏 雨 作 清 凉
紫 盖 - 接 翅 - 摩 云 - 屋 荆 - 紫 盖==紫 盖 横 天 整 复 斜	兴 亡 接 翅 似 昏 鸦	旧 时 石 阙 摩 云 处	荻 屋 荆 扉 一 两 家
南 楼 - 官 舍 - 一 株 - 万 里 - 南 楼==同 上 南 楼 看 月 去	莫 嫌 官 舍 冷 如 僧	一 株 西 北 平 安 火	万 里 东 南 无 尽 灯
野 意 - 水 生 - 风 来 - 一 声 - 野 意==自 随 野 意 订 山 行	香 学 楠 花 白 水 生	借 得 风 来 帆 便 饱	隔 溪 新 度 一 声 莺
出 花 - 水 云 - 素 面 - 清 兴 - 万 叠==六 出 花 头 万 叠 波	水 云 馆 前 不 肯 过	玉 鸾 素 面 如 相 语	人 间 清 兴 今 如 何
鳞 鳞 - 云 低 - 风 流 - 翩 翩 - 鳞 鳞==鳞 鳞 鸳 瓦 静 无 烟	六 幕 云 低 腊 雪 天	应 是 风 流 学 胡 蝶	遇 墙 飞 舞 自 翩 翩
黄 金 - 白 首 - 尝 门 - 西 风 - 黄 金==黄 金 散 作 买 花 资	白 首 谁 能 恋 故 知	同 作 孟 尝 门 下 客	西 风 吹 鬓 独 归 时
江 城 - 城 郭 - 寒 食 - 家 家 - 吹 笛==江 城 吹 笛 晚 风 斜	城 郭 人 稀 噪 乱 鸦	火 冷 烟 青 寒 食 过	家 家 门 巷 扫 桐 花
重 门 - 空 阶 - 微 之 - 何 处 - 寂 寂==重 门 寂 寂 锁 香 云	雨 滴 空 阶 坐 夜 分	老 去 微 之 风 调 在	折 来 何 处 与 双 文
白 头 - 死 生 - 青 山 - 风 雨 - 白 头==白 头 浪 裹 叶 舟 轻	全 靠 樯 桅 寄 死 生	唯 有 青 山 无 一 事	不 忧 风 雨 不 忧 晴
麻 鞋 - 归 来 - 梅 花 - 林 边 - 麻 鞋==小 试 麻 鞋 路 半 乾	归 来 连 得 好 诗 看	去 年 曾 被 梅 花 恼	今 过 林 边 辄 齿 寒
长 江 - 杨 柳 - 西 山 - 歌 舞 - 槛 外==槛 外 长 江 去 不 回	槛 前 杨 柳 后 人 栽	当 时 唯 有 西 山 在	曾 见 滕 王 歌 舞 来
照 眼 - 纵 横 - 骚 人 - 清 秋 - 照 眼==红 苋 如 丹 照 眼 明	卧 开 石 竹 乱 纵 横	骚 人 见 处 终 然 别	只 说 清 秋 采 落 英
翔 风 - 祥 刑 - 一 夕 - 现 夺 - 翔 风==仁 侠 翔 风 勇 驾 臼	皇 华 使 者 出 祥 刑	福 星 一 夕 迁 吴 分	欲 向 陇 山 现 夺 星
一 枕 - 漫 漫 - 白 发 - 窗 前 - 一 枕==一 枕 黄 粱 梦 欲 残	死 生 大 海 浪 漫 漫	鬓 边 白 发 休 除 却	时 向 窗 前 把 镜 看
玉 壶 - 看 花 - 桃 叶 - 辕 车 - 春 酒==玉 壶 春 酒 射 朝 霞	只 看 纤 腰 不 看 花	但 遣 舟 迎 桃 叶 女	仍 须 恩 赐 短 辕 车
入 海 - 摩 天 - 泪 尽 - 一 年 - 入 海==三 万 里 河 东 入 海	五 千 仞 岳 上 摩 天	遗 民 泪 尽 胡 尘 里	南 望 王 师 又 一 年
破 晓 - 今 朝 - 梦 中 - 轻 舟 - 破 晓==破 晓 篙 师 报 放 船	今 朝 不 似 昨 朝 寒	梦 中 草 草 披 衣 起	爱 看 轻 舟 下 急 滩
绛 蜡 - 樽 前 - 江 上 - 纱 窗 - 绛 蜡==绛 蜡 攒 花 夜 气 横	樽 前 更 著 许 风 情	却 将 江 上 风 涛 手	来 听 纱 窗 侧 阮 声
韬 光 - 半 榻 - 幽 鸟 - 漠 漠 - 韬 光==瘦 藤 拄 到 古 韬 光	分 得 山 僧 半 榻 凉	幽 鸟 一 声 春 梦 断	湿 云 漠 漠 护 残 香
春 初 - 轻 身 - 九 秋 - 芳 时 - 春 初==春 初 种 菊 助 盘 蔬	益 气 轻 身 载 旧 图	终 藉 九 秋 扶 正 色	芳 时 偷 得 醉 工 夫
晴 日 - 啼 鸟 - 芳 径 - 高 楼 - 日 暖==晴 日 暖 风 浑 欲 醉	游 蜂 啼 鸟 累 相 关	闲 来 芳 径 步 幽 草	更 上 高 楼 看 远 山
青 苔 - 柴 门 - 花 落 - 白 云 - 雨 后==雨 后 青 苔 路 不 分	柴 门 竹 里 映 斜 曛	松 花 落 尽 无 人 到	只 有 山 童 扫 白 云
月 满 - 树 影 - 天 涯 - 今 宵 - 月 满==霜 满 蒹 葭 月 满 地	断 烟 疏 树 影 参 差	天 涯 莫 道 相 逢 易	昨 岁 今 宵 是 别 离
悠 悠 - 仙 风 - 江 湖 - 溪 访 - 未 见==学 道 悠 悠 未 见 功	敢 云 凡 质 有 仙 风	他 年 一 钵 江 湖 去	先 向 苕 溪 访 葛 洪
雨 打 - 白 头 - 五 湖 - 节 滩 - 雨 打==雨 打 船 蓬 声 百 般	白 头 当 夏 不 禁 寒	五 湖 七 泽 经 行 遍	终 忆 吾 乡 八 节 滩
阴 阴 - 篱 边 - 牵 犬 - 园 家 - 阴 阴==阴 阴 径 底 忽 抽 叶	莫 莫 篱 边 豆 结 花	唳 鹤 清 愁 牵 犬 恨	料 应 不 到 菜 园 家
长 沙 - 楚 竹 - 隐 隐 - 白 鹤 - 秋 水==桂 阳 秋 水 长 沙 县	楚 竹 离 声 为 君 变	青 山 隐 隐 孤 舟 微	白 鹤 双 飞 忽 相 见
萧 萧 - 颓 垣 - 玉 粒 - 破 霜 - 萧 萧==寒 雀 萧 萧 冻 不 喧	背 人 缘 底 过 颓 垣	似 矜 玉 粒 堪 充 饱	啄 破 霜 包 无 乃 冤
鲜 明 - 春 深 - 敌 国 - 倾 城 - 雨 余==雨 余 花 色 倍 鲜 明	最 是 春 深 多 晚 晴	美 酒 壮 人 如 敌 国	千 金 一 笑 买 倾 城
广 寒 - 白 日 - 三 千 - 南 山 - 灵 根==万 古 灵 根 种 广 寒	折 来 白 日 更 升 仙	集 英 曾 对 三 千 字	也 胜 南 山 孟 浩 然
暮 钟 - 亭 亭 - 碧 海 - 云 水 - 暮 钟==杳 杳 芜 城 起 暮 钟	亭 亭 华 月 照 秋 容	便 疑 碧 海 依 墙 堑	云 水 情 知 隔 万 重
腐 草 - 歌 钟 - 市 为 - 光 芒 - 虹 桥==七 里 虹 桥 腐 草 腥	歌 钟 词 赋 两 飘 零	不 随 天 市 为 消 长	文 字 光 芒 聚 德 星
溪 头 - 小 楼 - 无 奈 - 潮 生 - 溪 头==江 家 旧 宅 枕 溪 头	谁 向 溪 湾 著 小 楼	无 奈 当 年 亡 国 恨	潮 生 潮 落 几 时 休
宫 殿 - 泉 飞 - 翁 骑 - 碧 桃 - 宫 殿==金 书 宫 殿 玉 阑 干	雪 瀑 泉 飞 洞 口 寒	日 暮 仙 翁 骑 鹤 去	碧 桃 花 满 石 棋 盘
钓 舟 - 半 生 - 无 人 - 万 里 - 西 风==好 趁 西 风 理 钓 舟	半 生 书 剑 两 悠 悠	凭 高 有 恨 无 人 识	空 负 关 河 万 里 秋
月 满 - 星 稀 - 解 组 - 扁 舟 - 江 边==剩 爱 江 边 月 满 衣	云 高 天 阔 数 星 稀	如 今 解 组 浮 家 去	准 拟 扁 舟 满 载 归
移 花 - 心 匠 - 假 人 - 绿 树 - 移 花==莳 药 移 花 撰 石 名	稍 加 心 匠 可 经 营	天 真 不 假 人 为 力	绿 树 啼 莺 一 两 声
翠 竹 - 归 来 - 留 人 - 门 前 - 翠 竹==翠 竹 峰 前 是 我 家	归 来 重 整 旧 生 涯	烟 霞 尚 有 留 人 意	争 奈 门 前 驷 马 车
松 篁 - 桃 李 - 纤 腰 - 百 结 - 松 篁==不 死 松 篁 劳 借 问	未 开 桃 李 与 催 妆	已 饶 艳 女 纤 腰 舞	偏 犯 贫 儒 百 结 裳
沧 海 - 林 坳 - 扬 州 - 华 表 - 沧 海==沧 海 东 头 鹤 阜 高	仙 人 骑 鹤 下 林 坳	一 声 唳 起 扬 州 去	华 表 空 余 月 下 巢
细 细 - 翠 纹 - 夜 半 - 动 扫 - 细 细==月 傍 细 细 水 波 云	绣 撚 金 描 孔 翠 纹	夜 半 冰 轮 悬 净 碧	太 空 不 动 扫 魔 群
千 门 - 柳 丝 - 和 风 - 晴 日 - 千 门==万 户 千 门 入 建 章	金 绳 界 路 柳 丝 黄	和 风 偏 度 乐 声 细	晴 日 自 随 宫 泉 长
嵯 峨 - 自 须 - 雪 色 - 一 声 - 嵯 峨==背 上 嵯 峨 两 肉 山	明 驼 有 债 自 须 还	玉 霄 峰 头 雪 色 鹿	清 晓 一 声 烟 雨 间
东 君 - 一 雨 - 梅 开 - 飞 檐 - 繁 华==东 君 无 处 不 繁 华	一 雨 才 晴 意 便 佳	客 舍 山 梅 开 遍 了	从 今 懒 飞 檐 头 花
捧 日 - 踏 新 - 绣 衣 - 美 人 - 香 动==紫 烟 捧 日 炉 香 动	万 马 千 车 踏 新 冻	绣 衣 年 少 朝 欲 归	美 人 犹 在 青 楼 梦
嵯 峨 - 石 路 - 乘 高 - 峰 峦 - 嵯 峨==嵯 峨 千 仞 永 康 山	石 路 终 朝 转 屈 盘	政 恐 乘 高 伤 远 目	忽 然 烟 雾 锁 峰 峦
谈 天 - 安 排 - 无 语 - 断 崖 - 谈 天==言 中 谈 天 有 振 斋	五 行 曾 不 涉 安 排	小 轩 对 坐 似 无 语	几 度 晴 云 过 断 崖
东 风 - 恨 不 - 意 已 - 千 红 - 东 风==谁 将 花 烛 聘 东 风	与 海 棠 时 恨 不 同	意 已 不 求 真 会 合	何 妨 一 白 对 千 红
芒 鞋 - 鞅 尘 - 去 来 - 岩 宴 - 芒 鞋==竹 杖 芒 鞋 去 未 能	鞅 尘 十 丈 苦 相 仍	去 来 今 了 三 生 事	输 尔 寒 岩 宴 坐 僧
江 浦 - 水 深 - 花 重 - 凌 波 - 江 浦==采 莲 江 浦 觅 同 心	日 暮 风 生 江 水 深	莫 言 花 重 船 应 没	自 解 凌 波 不 畏 沉
藤 萝 - 枯 树 - 败 叶 - 风 扫 - 藤 萝==藤 萝 荆 棘 离 离 草	枯 树 无 退 还 不 倒	败 叶 知 他 叠 几 重	不 消 一 阵 秋 风 扫
梧 叶 - 丹 枫 - 萧 索 - 西 湖 - 梧 叶==梧 叶 新 黄 柿 叶 红	更 兼 鸟 臼 与 丹 枫	只 言 山 色 秋 萧 索	绣 出 西 湖 三 四 峰
风 吹 - 萦 回 - 一 番 - 今 朝 - 风 吹==日 炙 风 吹 人 倦 乏	山 重 水 复 路 萦 回	一 番 行 病 思 休 息	且 喜 今 朝 入 界 来
刮 地 - 凉 便 - 云 头 - 白 塔 - 风 来==刮 地 风 来 健 葛 衣	一 凉 便 觉 暑 光 低	云 头 龙 挂 如 垂 箸	雨 在 中 峰 白 塔 西
碧 山 - 楼 阁 - 赤 日 - 雪 花 - 碧 山==暑 殿 金 泉 枕 碧 山	清 凉 楼 阁 五 台 间	赤 日 不 行 葱 岭 北	雪 花 长 绕 玉 门 关
一 轮 - 万 古 - 醉 客 - 清 夜 - 一 轮==细 观 才 满 一 轮 月	静 坐 能 销 万 古 心	莫 向 洪 炉 烘 醉 客	只 宜 清 夜 定 禅 林
伴 月 - 残 漏 - 萧 萧 - 雨 声 - 万 瓦==万 瓦 清 霜 伴 月 明	卧 听 残 漏 若 为 情	无 端 木 叶 萧 萧 下	更 与 愁 人 作 雨 声
杖 头 - 柳 岸 - 醉 质 - 归 时 - 杖 头==与 人 替 得 杖 头 闲	日 日 莲 塘 柳 岸 边	烂 醉 质 衣 吾 不 问	归 时 犹 有 买 舟 钱
何 处 - 溪 头 - 水 鸟 - 新 绿 - 何 处==山 翁 何 处 是 便 宜	正 是 溪 头 雨 足 时	水 鸟 傍 人 飞 又 去	一 湾 新 绿 绕 长 堤
雨 如 - 浮 蜡 - 牡 丹 - 飞 花 - 雨 如==谷 雨 如 丝 复 似 尘	煮 瓶 浮 蜡 正 尝 新	牡 丹 破 萼 樱 桃 熟	未 许 飞 花 减 却 春
征 帆 - 雪 浪 - 江 行 - 万 重 - 征 帆==日 日 征 帆 上 水 风	掀 天 雪 浪 骇 鱼 龙	不 须 检 校 江 行 历	知 过 云 山 几 万 重
荷 花 - 两 岸 - 瑶 池 - 醉 脸 - 小 桥==小 桥 划 水 剪 荷 花	两 岸 西 风 晕 晚 霞	恍 似 瑶 池 初 宴 罢	万 妃 醉 脸 沁 铅 华
光 莹 - 红 紫 - 寒 食 - 此 时 - 光 莹==残 雪 浮 光 莹 晓 枝	肯 随 红 紫 贰 妍 姿	年 年 寒 食 风 和 雨	天 遣 天 花 值 此 时
班 春 - 十 年 - 路 傍 - 君 何 - 班 春==班 春 无 术 劝 污 莱	五 十 年 间 此 一 回	黄 发 路 傍 应 怪 问	使 君 何 事 入 山 来
伤 心 - 红 树 - 思 乡 - 碧 玉 - 伤 心==满 眼 伤 心 冬 景 和	一 山 红 树 寺 边 多	仲 宣 无 限 思 乡 泪	漳 水 东 流 碧 玉 波
东 君 - 野 老 - 摇 落 - 小 春 - 东 君==东 君 好 事 惜 年 华	偏 爱 荒 园 野 老 家	一 任 西 风 管 摇 落	小 春 自 管 数 枝 花
碧 水 - 翩 翩 - 斗 鸡 - 桃 李 - 碧 水==金 溪 碧 水 玉 潭 沙	凫 舄 翩 翩 弄 日 华	斗 鸡 香 陌 行 春 倦	为 摘 东 园 桃 李 花
清 绝 - 冰 霜 - 轻 明 - 前 身 - 幽 人==此 花 清 绝 似 幽 人	苦 耐 冰 霜 不 爱 春	蜡 蕊 轻 明 香 万 斛	黄 姑 端 的 是 前 身
目 晴 - 诗 情 - 落 花 - 啼 鸟 - 晴 峦==满 目 晴 峦 总 是 诗	诗 情 飞 絮 逐 游 丝	雨 肥 碧 涧 落 花 水	风 瘦 青 松 啼 鸟 枝
通 津 - 同 气 - 兄 弟 - 和 乐 - 通 津==友 于 相 爱 陟 通 津	同 气 同 居 善 益 亲	自 是 茅 家 好 兄 弟	一 堂 和 乐 棣 华 春
长 合 - 提 壶 - 无 人 - 山 村 - 由 来==迁 客 由 来 长 合 醉	不 烦 幽 鸟 道 提 壶	商 州 未 是 无 人 境	一 路 山 村 有 酒 沽
相 依 - 冷 香 - 气 象 - 鸣 犬 - 露 下==野 菊 相 依 露 下 丛	冷 香 自 送 水 边 风	丰 年 气 象 无 多 子	只 在 鸡 鸣 犬 吠 中
槁 叶 - 婴 儿 - 九 原 - 秉 笔 - 槁 叶==画 取 维 州 如 槁 叶	策 禽 潞 将 似 婴 儿	九 原 精 爽 人 犹 畏	想 见 中 书 秉 笔 时
山 城 - 秋 思 - 雷 鼓 - 峥 嵘 - 山 城==秋 风 入 角 蹙 山 城	更 觉 淮 南 秋 思 清	惯 听 边 威 雷 鼓 里	梅 花 争 发 斗 峥 嵘
归 去 - 山 光 - 兴 亡 - 江 畔 - 东 风==饭 牛 归 去 趁 东 风	柳 色 山 光 绿 映 红	世 事 兴 亡 在 何 处	夕 阳 江 畔 笛 声 中
雨 过 - 流 水 - 一 石 - 夕 阳 - 六 月==雨 过 山 村 六 月 凉	田 田 流 水 稻 花 香	松 边 一 石 平 如 榻	坐 听 风 蝉 送 夕 阳
纤 纤 - 光 芒 - 诗 人 - 味 酸 - 纤 纤==金 钗 双 拜 玉 纤 纤	星 宿 光 芒 动 宝 奁	解 笑 诗 人 夸 博 物	只 知 红 颗 味 酸 甜
壮 志 - 岩 隈 - 身 不 - 腊 梅 - 壮 志==壮 志 摧 颓 貌 亦 衰	岂 知 官 舍 傍 岩 隈	此 身 不 是 京 尘 里	饭 了 沿 山 看 腊 梅
稚 子 - 重 阳 - 明 年 - 梦 中 - 稚 子==稚 子 山 妻 伴 老 翁	重 阳 寻 遍 菊 花 丛	明 年 把 酒 知 何 处	却 忆 高 亭 是 梦 中
水 重 - 青 天 - 黄 尘 - 桃 花 - 杳 然==复 水 重 山 路 杳 然	仙 家 楼 观 入 青 天	那 知 白 首 黄 尘 事	只 伴 桃 花 度 岁 年
裁 就 - 小 桥 - 何 处 - 山 花 - 裁 就==布 衫 裁 就 短 平 腰	两 两 三 三 步 小 桥	粗 态 撩 人 在 何 处	山 花 鬓 畔 露 村 娇
秋 风 - 转 蓬 - 鸿 雁 - 别 离 - 秋 风==凤 林 溪 上 见 秋 风	客 里 相 看 欲 转 蓬	鸿 雁 萧 萧 霜 渐 冷	别 离 况 是 叶 声 中
归 兴 - 留 诗 - 万 壑 - 烦 师 - 归 兴==归 兴 逢 山 便 解 颐	上 人 多 思 乞 留 诗	千 若 万 壑 经 行 处	他 日 烦 师 觅 旧 题
宫 阙 - 江 山 - 属 玉 - 藕 花 - 宫 阙==楚 王 宫 阙 马 王 宫	惟 有 江 山 带 旧 风	属 玉 不 知 兴 废 事	双 双 飞 入 藕 花 丛
玉 京 - 服 日 - 此 心 - 仙 宫 - 玉 京==玉 京 真 子 名 太 一	因 服 日 华 心 如 日	此 心 不 许 世 人 知	只 向 仙 宫 未 曾 出
云 封 - 隐 者 - 蔽 天 - 开 花 - 紫 云==长 平 山 上 紫 云 封	蜀 老 相 传 隐 者 宫	高 树 蔽 天 三 十 里	开 花 十 丈 舞 春 风
碧 水 - 月 明 - 如 画 - 蓝 影 - 碧 水==龙 潭 碧 水 玉 壶 清	印 得 秋 空 两 月 明	百 里 江 山 如 画 稿	青 岩 蓝 影 尽 含 情
卧 阁 - 班 春 - 宁 免 - 宣 明 - 卧 阁==郡 将 移 书 卧 阁 频	假 提 千 骑 出 班 春	校 中 宁 免 时 髦 诮	欲 作 宣 明 面 向 人
成 丛 - 凋 零 - 感 慨 - 秋 风 - 菊 枝==菊 枝 倾 倒 不 成 丛	桐 叶 凋 零 已 半 空	自 是 老 来 多 感 慨	不 应 萧 瑟 为 秋 风
曹 溪 - 上 下 - 解 使 - 朝 云 - 曹 溪==曹 溪 一 路 透 泥 丸	只 在 丹 田 上 下 间	解 使 金 翁 媒 姹 女	朝 云 暮 雨 满 巫 山
法 身 - 无 分 - 翠 竹 - 郁 郁 - 法 身==幻 化 空 身 即 法 身	且 无 分 别 与 缘 情	青 青 翠 竹 无 非 相	郁 郁 黄 花 搭 地 灵
十 年 - 论 文 - 愿 言 - 东 西 - 十 年==四 十 年 间 梦 已 非	论 文 谈 道 意 方 微	愿 言 著 眼 羲 皇 上	南 北 东 西 莫 浪 归
高 卧 - 山 郭 - 花 君 - 闲 坐 - 高 卧==鹿 门 高 卧 寂 无 哗	户 外 青 山 郭 外 斜	妇 解 绣 花 君 解 画	玉 窗 闲 坐 斗 新 茶
凄 凄 - 朝 昏 - 三 千 - 红 颜 - 凄 凄==风 露 凄 凄 秋 景 繁	可 怜 荣 落 在 朝 昏	未 央 宫 里 三 千 女	但 保 红 颜 莫 保 恩
灯 光 - 声 响 - 风 树 - 半 夜 - 客 怀==灯 光 难 照 客 怀 开	忽 听 寒 声 响 似 雷	天 气 无 风 树 无 叶	道 州 半 夜 水 流 来
画 堂 - 作 花 - 林 泉 - 林 泉 - 画 堂==不 掩 歌 唇 向 画 堂	不 须 名 笔 作 花 房	直 应 携 去 林 泉 好	转 觉 林 泉 兴 味 长
渺 渺 - 风 帆 - 鱼 虾 - 王 未 - 渺 渺==渺 渺 澄 江 湛 碧 虚	风 帆 一 幅 挂 轻 蒲	吾 钩 岂 直 鱼 虾 设	入 钓 文 王 未 解 无
江 南 - 花 流 - 风 雨 - 归 来 - 江 南==绿 树 江 南 啼 子 规	落 花 流 水 洗 胭 脂	无 情 风 雨 朝 朝 恶	误 却 归 来 海 燕 迟
远 空 - 画 船 - 疏 疏 - 隐 隐 - 远 空==近 嶂 远 空 同 蔚 蓝	画 船 不 系 酒 微 酣	疏 疏 灯 影 出 烟 际	隐 隐 人 声 在 水 南
生 香 - 冰 雪 - 鹤 发 - 升 堂 - 生 香==翠 绡 飞 盖 拥 生 香	冰 雪 精 神 试 晚 妆	鹤 发 慈 亲 俄 一 笑	玉 人 何 事 晚 升 堂
春 光 - 霜 欺 - 倚 栏 - 竹 外 - 百 花==百 花 头 上 春 光 到	雪 压 霜 欺 意 更 奇	岁 岁 倚 栏 相 望 处	水 边 竹 外 最 南 枝
绿 水 - 浩 浩 - 山 际 - 樵 牧 - 盈 盈==陂 沼 盈 盈 闲 绿 水	郊 原 浩 浩 涌 青 禾	烟 连 山 际 无 人 语	只 有 晚 归 樵 牧 歌
一 水 - 零 落 - 罢 村 - 戴 月 - 一 水==一 水 遥 通 西 渡 头	乱 山 零 落 树 还 稠	先 生 唱 罢 村 田 乐	戴 月 披 蓑 理 钓 舟
石 门 - 乞 真 - 三 许 - 留 诗 - 石 门==上 得 山 来 过 石 门	谒 灵 特 地 乞 真 言	再 三 许 我 前 程 事	敢 不 留 诗 荷 圣 恩
文 章 - 出 尘 - 腾 腾 - 梦 中 - 文 章==满 卷 文 章 为 世 重	出 尘 心 迹 少 人 同	腾 腾 自 得 修 真 理	不 管 浮 生 觉 梦 中
锦 羽 - 波 上 - 霞 明 - 青 山 - 锦 羽==锦 羽 相 呼 暮 沙 曲	波 上 双 声 戛 哀 玉	霞 明 川 静 极 望 中	一 时 飞 灭 青 山 绿
古 文 - 悠 悠 - 一 从 - 死 逢 - 古 文==自 古 文 章 与 命 仇	功 名 身 外 更 悠 悠	一 从 识 得 元 无 事	穷 死 逢 人 不 说 愁
宫 阙 - 海 市 - 纸 钱 - 风 阵 - 宫 阙==宫 阙 金 银 火 化 时	蜃 楼 海 市 望 迷 离	纸 钱 也 要 飘 洋 用	惑 得 台 风 阵 阵 吹
笙 歌 - 隔 帘 - 秋 来 - 夜 长 - 笙 歌==一 派 笙 歌 出 苑 墙	隔 帘 犹 自 暗 闻 香	秋 来 殿 殿 添 宫 漏	只 有 昭 阳 不 夜 长
春 色 - 朵 朵 - 千 载 - 武 陵 - 春 色==海 山 春 色 等 闲 来	朵 朵 还 如 人 面 开	千 载 避 秦 真 此 地	问 君 何 必 武 陵 回
岩 前 - 迢 迢 - 湖 上 - 画 桡 - 岩 前==少 室 岩 前 路 不 遥	毫 芒 才 拟 便 迢 迢	西 湖 湖 上 晚 来 看	小 艇 轻 风 落 画 桡
扰 扰 - 五 夜 - 深 树 - 山 村 - 扰 扰==匆 匆 扰 扰 几 人 闲	梦 醒 鸡 声 五 夜 阑	争 似 鸟 栖 深 树 乐	山 村 日 暮 共 云 还
半 篙 - 两 岸 - 田 家 - 丈 高 - 半 篙==溪 落 洲 荒 水 半 篙	枯 杨 两 岸 冷 萧 骚	田 家 预 办 来 年 事	加 得 陂 头 一 丈 高
鸾 飞 - 凤 衔 - 千 门 - 星 回 - 合 欢==青 鸾 飞 入 合 欢 宫	紫 凤 衔 花 出 禁 中	可 怜 今 夜 千 门 里	银 汉 星 回 一 道 通
朱 樱 - 谁 家 - 握 手 - 离 筵 - 朱 实==朱 樱 此 日 垂 朱 实	郭 外 谁 家 负 郭 田	万 里 相 逢 贪 握 手	高 才 却 望 足 离 筵
绿 苞 - 似 荒 - 春 风 - 蔷 薇 - 楚 楚==楚 楚 初 篁 脱 绿 苞	城 居 约 略 似 荒 郊	土 膏 更 得 春 风 力	直 引 蔷 薇 上 竹 梢
昨 夜 - 清 游 - 鲸 去 - 杯 盘 - 昨 夜==昨 夜 群 仟 宴 十 洲	再 三 招 我 伴 清 游	酒 酣 忽 跨 长 鲸 去	碧 玉 杯 盘 散 不 收
苍 苔 - 西 湖 - 半 臂 - 写 恨 - 绣 衣==忍 见 苍 苔 裹 绣 衣	西 湖 风 急 旅 魂 悲	紫 罗 半 臂 今 犹 在	免 学 欧 阳 写 恨 辞
碧 窗 - 青 灯 - 何 处 - 庭 前 - 蒙 蒙==香 雾 蒙 蒙 罩 碧 窗	青 灯 的 的 灿 银 缸	内 人 何 处 教 吹 管	惊 起 庭 前 鹤 一 双
篱 落 - 梦 中 - 秋 风 - 声 声 - 篱 落==浮 沙 篱 落 乱 鸣 蛩	永 夜 相 寻 客 梦 中	尽 是 秋 风 借 余 力	声 声 却 似 怨 秋 风
桥 下 - 夕 照 - 来 往 - 西 风 - 潺 湲==灞 陵 桥 下 水 潺 湲	人 影 离 披 夕 照 间	来 往 总 怜 车 马 好	西 风 破 帽 独 南 还
苔 矶 - 两 岸 - 在 深 - 一 片 - 苔 矶==垂 竿 终 日 坐 苔 矶	两 岸 芦 花 作 雪 飞	鱼 在 深 波 刚 不 食	蓑 披 一 片 冻 云 归
山 城 - 见 了 - 莲 花 - 结 社 - 山 城==缘 尽 山 城 且 不 归	此 生 相 见 了 无 期	保 持 异 日 莲 花 上	重 说 如 今 结 社 时
亭 台 - 棹 唱 - 为 放 - 翻 翻 - 亭 台==水 上 亭 台 凉 气 多	扣 舷 倚 棹 唱 吴 歌	何 人 为 放 青 莲 出	剪 却 翻 翻 一 万 荷
光 微 - 风 来 - 清 夜 - 星 斗 - 光 微==暮 凉 浮 座 暑 光 微	竹 底 风 来 暗 举 衣	假 寐 不 知 清 夜 久	挂 檐 星 斗 向 人 稀
千 顷 - 沧 江 - 羽 翼 - 沙 鸟 - 千 顷==乱 山 千 顷 翠 相 围	衮 衮 沧 江 去 复 归	安 得 病 身 生 羽 翼	长 随 沙 鸟 自 由 飞
雨 余 - 庭 院 - 画 栏 - 山 光 - 蛙 吹==雨 余 蛙 吹 歇 池 塘	庭 院 人 闲 日 正 长	独 倚 画 栏 看 不 尽	海 棠 无 处 是 山 光
秋 清 - 适 意 - 尽 青 - 鸡 鸣 - 秋 清==新 来 诗 思 与 秋 清	野 径 无 人 适 意 行	道 尽 青 松 知 小 雨	隔 林 怪 在 竹 鸡 鸣
生 灭 - 与 物 - 树 下 - 纵 横 - 生 灭==莫 谈 生 灭 与 无 生	谩 把 心 神 与 物 争	陶 器 一 藏 松 树 下	绿 苔 芳 草 任 纵 横
闭 门 - 纷 纷 - 晓 来 - 梅 花 - 烧 香==读 易 烧 香 自 闭 门	懒 於 世 故 苦 纷 纷	晓 来 静 处 参 生 意	春 到 梅 花 有 几 分
营 巢 - 衔 泥 - 秋 风 - 万 里 - 营 巢==燕 子 营 巢 得 所 依	衔 泥 辛 苦 傍 人 飞	秋 风 一 夜 惊 桐 叶	不 恋 雕 梁 万 里 归
绰 约 - 云 母 - 丹 井 - 为 吊 - 绰 约==绰 约 长 眉 海 上 仙	久 餐 云 母 学 长 年	山 中 丹 井 今 无 恙	为 吊 南 弃 谢 自 然
缥 缈 - 仙 仗 - 草 忽 - 昭 仪 - 缥 缈==卿 云 缥 缈 覆 长 安	仙 仗 凌 霄 颂 百 官	芝 草 忽 生 涵 德 殿	昭 仪 捧 出 侍 臣 看
簇 簇 - 东 风 - 莫 言 - 处 处 - 簇 簇==簇 簇 人 闻 马 粪 香	江 东 风 俗 美 诸 王	莫 言 此 巷 无 寻 处	处 处 皆 成 马 粪 场
黄 花 - 幽 香 - 酩 酊 - 折 枝 - 黄 花==无 限 黄 花 簇 短 篱	幽 香 深 谢 好 风 吹	劝 君 终 日 酩 酊 醉	莫 待 无 花 空 折 枝
关 情 - 萧 然 - 寒 食 - 石 头 - 一 家==一 家 去 住 两 关 情	行 李 萧 然 又 出 京	记 得 别 时 寒 食 后	断 烟 残 雨 石 头 城
老 龙 - 色 鲜 - 云 收 - 日 高 - 老 龙==老 龙 拖 雨 过 平 川	晓 影 初 开 树 色 鲜	有 片 白 云 收 不 尽	日 高 犹 在 讲 堂 边
清 风 - 风 外 - 湛 湛 - 水 边 - 清 风==清 风 为 我 晓 开 关	风 外 浮 云 过 雨 还	湛 湛 可 怜 清 上 下	一 篙 溪 水 水 边 出
穷 通 - 富 贵 - 花 草 - 北 枝 - 穷 通==穷 通 系 命 不 由 才	富 贵 偏 宜 老 后 来	花 草 犹 教 有 先 后	凭 君 试 看 北 枝 梅
雨 过 - 趁 晴 - 田 家 - 有 秋 - 雨 过==雨 过 儿 童 饱 饭 牛	趁 晴 耕 垦 种 来 牟	田 家 作 苦 无 储 蓄	待 哺 全 须 麦 有 秋
一 日 - 偏 明 - 不 怕 - 沧 浪 - 一 日==一 日 溪 流 万 橹 声	簿 书 丛 里 眼 偏 明	青 衫 不 怕 笼 朱 墨	直 下 沧 浪 便 濯 缨
北 斗 - 春 时 - 留 题 - 士 诗 - 北 斗==北 斗 回 杓 欲 建 寅	宫 嫔 排 备 立 春 时	镌 花 贴 子 留 题 处	只 待 金 銮 学 士 诗
秋 水 - 金 丸 - 风 雨 - 玉 盘 - 水 寒==袖 里 青 锋 秋 水 寒	谁 疑 双 燕 是 金 丸	出 门 风 雨 如 何 去	空 有 霜 髭 在 玉 盘
江 头 - 黄 昏 - 深 夜 - 残 灯 - 江 头==月 出 江 头 半 掩 门	待 郎 不 至 又 黄 昏	深 夜 忽 听 巴 渝 曲	起 剔 残 灯 酒 尚 温
