水 晶 - 不 夜 - 图 书 - 三 更 - 水 晶==水 晶 帘 映 宝 灯 明	海 上 移 来 不 夜 城	何 似 图 书 群 玉 府	青 藜 青 对 月 三 更
造 化 - 门 前 - 雨 晴 - 风 暖 - 造 化==懒 问 谁 持 造 化 权	门 前 春 事 正 暄 妍	雨 晴 花 色 明 如 锦	风 暖 莺 声 滑 似 弦
座 上 - 音 阐 - 世 主 - 增 辉 - 座 上==须 弥 座 上 敛 伽 黎	海 口 潮 音 阐 大 机	世 主 大 檀 能 藻 鉴	灵 山 嘉 会 愈 增 辉
梅 花 - 江 风 - 绰 约 - 四 时 - 梅 花==邾 城 山 下 梅 花 树	腊 月 江 风 好 在 无	争 似 姑 山 寻 绰 约	四 时 长 见 雪 肌 肤
梧 桐 - 菜 花 - 杜 鹃 - 寒 食 - 梧 桐==村 南 村 北 梧 桐 树	山 后 山 前 白 菜 花	莫 向 杜 鹃 啼 处 宿	楚 乡 寒 食 客 思 家
桃 花 - 江 水 - 满 地 - 河 豚 - 两 枝==竹 外 桃 花 三 两 枝	春 江 水 暖 鸭 先 知	蒌 蒿 满 地 芦 芽 短	正 是 河 豚 欲 上 时
春 开 - 鸟 语 - 罗 袜 - 青 来 - 春 开==天 宁 佛 阁 早 春 开	鸟 语 风 铃 次 第 催	怪 道 回 船 湿 罗 袜	严 将 军 墓 踏 青 来
昆 阳 - 饮 酒 - 相 思 - 风 吹 - 美 人==昆 阳 市 上 美 人 家	饮 酒 曾 停 过 客 车	万 里 相 思 不 相 见	东 风 吹 尽 蜜 檀 花
野 水 - 棱 棱 - 寒 气 - 石 桥 - 月 冷==月 冷 碧 云 笼 野 水	棱 棱 瘦 耸 吟 肩 起	一 天 寒 气 湿 衣 裳	人 在 石 桥 香 影 里
佳 名 - 融 液 - 雪 花 - 风 格 - 佳 名==一 种 佳 名 两 字 猜	蜜 脾 融 液 腊 中 开	雪 花 不 敢 迷 真 色	风 格 都 缘 不 是 梅
半 山 - 酒 旗 - 里 山 - 孔 方 - 半 山==半 山 辱 国 卖 丛 祠	锺 步 诸 坊 卷 酒 旗	村 里 山 农 语 音 好	孔 方 兄 已 赦 鹅 儿
原 野 - 蒙 茸 - 千 钟 - 骑 马 - 原 野==营 州 少 年 厌 原 野	狐 裘 蒙 茸 猎 城 下	虏 酒 千 钟 不 醉 人	胡 儿 十 岁 能 骑 马
东 郊 - 融 和 - 游 人 - 不 暖 - 苍 苍==东 郊 无 地 不 苍 苍	日 气 融 和 自 有 香	最 是 游 人 行 乐 处	不 寒 不 暖 昼 偏 长
雨 重 - 闻 虏 - 晴 日 - 江 边 - 雨 重==蜜 雨 重 阴 一 月 馀	似 闻 虏 马 又 长 驱	怪 来 林 外 升 晴 日	已 奏 江 边 报 捷 书
山 阴 - 衔 杯 - 清 绝 - 瑶 琴 - 山 阴==欲 作 山 阴 兴 尽 回	良 思 与 子 共 衔 杯	要 须 人 境 俱 清 绝	好 抱 瑶 琴 踏 雪 来
玉 辇 - 春 风 - 年 年 - 夕 照 - 玉 辇==玉 辇 宸 游 事 已 空	尚 余 奎 藻 绘 春 风	年 年 花 鸟 无 穷 恨	尽 在 苍 梧 夕 照 中
暗 朱 - 一 水 - 知 有 - 归 去 - 暗 朱==两 山 松 栎 暗 朱 藤	一 水 中 间 胜 武 陵	午 梵 隔 云 知 有 寺	夕 阳 归 去 不 逢 僧
湖 边 - 烟 雨 - 歌 舞 - 青 山 - 游 湖==湖 边 多 少 游 湖 者	半 在 断 桥 烟 雨 间	尽 逐 春 风 看 歌 舞	几 人 著 眼 到 青 山
溪 头 - 凌 波 - 苹 花 - 撩 乱 - 单 衣==溪 头 风 迅 怯 单 衣	两 桨 凌 波 去 似 飞	折 得 苹 花 双 叶 子	绿 鬟 撩 乱 带 香 归
诗 通 - 新 酿 - 窥 一 - 千 忧 - 诗 通==近 诗 通 谱 江 西 社	新 酿 才 先 天 下 秋	已 许 眼 中 窥 一 豹	可 容 杯 里 散 千 忧
鹊 飞 - 长 须 - 鸡 豚 - 山 行 - 飞 鸣==乾 鹊 飞 鸣 绕 路 隅	长 须 迎 望 果 持 书	鸡 豚 本 自 无 烦 饷	七 日 山 行 惯 食 蔬
风 流 - 川 室 - 细 赏 - 煎 陆 - 风 流==文 献 风 流 想 故 家	玉 川 室 迩 已 人 遐	何 时 细 赏 文 清 竹	与 客 同 煎 陆 羽 茶
壮 节 - 飞 去 - 苍 藤 - 白 石 - 壮 节==壮 节 亭 前 野 碧 滋	髯 龙 飞 去 忽 经 时	只 应 黄 犊 苍 藤 路	尚 有 清 泉 白 石 知
纹 回 - 花 红 - 幽 人 - 造 化 - 波 纹==波 纹 回 处 恰 双 鱼	小 草 花 红 点 绿 蒲	不 是 幽 人 看 管 领	枉 教 造 化 着 工 夫
卷 地 - 山 鸟 - 朱 门 - 首 念 - 卷 地==北 风 卷 地 寒 侵 骨	冻 雪 连 山 鸟 不 飞	试 问 朱 门 余 酒 肉	几 人 回 首 念 无 衣
细 韵 - 影 兼 - 盘 根 - 梧 桐 - 细 韵==细 韵 飕 飕 入 骨 凉	影 兼 巢 鹤 过 高 墙	盘 根 一 种 依 平 地	自 是 梧 桐 不 久 长
百 里 - 西 山 - 又 终 - 扁 舟 - 一 水==一 水 濡 须 百 里 间	举 头 遥 见 水 西 山	微 波 不 动 又 终 日	安 得 扁 舟 送 我 还
千 官 - 一 日 - 自 格 - 深 仁 - 千 官==千 官 移 杖 拱 端 门	一 日 鸡 竿 万 里 春	汤 网 本 疏 民 自 格	要 知 家 法 在 深 仁
欲 牵 - 踏 青 - 忆 我 - 花 繁 - 共 寻==欲 牵 淮 舸 共 寻 源	且 踏 青 青 绕 杏 园	忆 我 旧 时 光 宅 路	依 然 桑 柳 映 花 繁
蕙 帐 - 阑 珊 - 乡 梦 - 春 风 - 蕙 帐==蕙 帐 烟 凝 昼 掩 关	落 花 时 节 雨 阑 珊	客 来 惊 起 还 乡 梦	绕 屋 春 风 绿 树 寒
采 莲 - 波 心 - 花 深 - 花 深 - 采 莲==采 莲 时 节 懒 匀 妆	日 到 波 心 拨 棹 忙	莫 向 荷 花 深 处 去	荷 花 深 处 有 鸳 鸯
翠 华 - 年 年 - 漠 漠 - 梅 开 - 翠 华==翠 华 不 向 苑 中 来	可 是 年 年 惜 露 台	水 际 春 风 寒 漠 漠	宫 梅 却 作 野 梅 开
寒 食 - 庭 院 - 麦 易 - 红 药 - 清 明==寒 食 清 明 一 箭 过	晚 晴 庭 院 绿 阴 多	兔 葵 燕 麦 易 轻 脱	红 药 碧 桃 须 孰 何
无 人 - 一 径 - 西 湖 - 浅 红 - 无 人==裹 饭 无 人 过 子 桑	拒 霜 一 径 雨 昏 黄	花 根 记 缚 西 湖 缆	江 浅 红 深 醉 夕 阳
百 尺 - 没 提 - 三 寸 - 虚 空 - 百 尺==百 尺 竿 头 一 缕 丝	没 提 撕 处 急 提 撕	离 钩 三 寸 忽 抛 却	正 是 虚 空 粉 碎 时
微 茫 - 连 朝 - 深 藏 - 分 明 - 微 茫==坌 岭 微 茫 八 里 间	连 朝 吐 雾 罩 鸦 鬟	此 中 定 有 深 藏 豹	未 许 分 明 见 一 斑
狐 裘 - 酒 醒 - 三 尺 - 雪 中 - 狐 裘==狐 裘 卧 载 锦 驼 车	酒 醒 冰 髭 结 乱 珠	三 尺 马 鞭 装 白 玉	雪 中 画 字 草 军 书
营 营 - 枯 枝 - 面 壁 - 几 首 - 营 营==浮 世 营 营 只 自 私	谁 参 落 叶 与 枯 枝	西 来 面 壁 原 无 语	却 费 圆 通 几 首 诗
春 光 - 霜 欺 - 倚 栏 - 竹 外 - 百 花==百 花 头 上 春 光 到	雪 压 霜 欺 意 更 奇	岁 岁 倚 栏 相 望 处	水 边 竹 外 最 南 枝
小 雪 - 酿 梅 - 无 人 - 萧 萧 - 小 雪==琳 馆 清 深 小 雪 残	酿 梅 天 气 不 多 寒	客 窗 竟 日 无 人 到	只 有 萧 萧 竹 数 竿
晴 日 - 望 中 - 来 到 - 东 风 - 一 川==一 川 晴 日 破 春 容	柳 絮 桃 红 赴 望 中	莫 喜 芳 辰 又 来 到	少 年 能 耐 几 东 风
吹 雨 - 洞 庭 - 天 外 - 一 点 - 风 吹==社 风 吹 雨 楚 江 晴	舟 叶 轻 飞 过 洞 庭	万 里 湖 天 天 外 水	君 山 一 点 望 中 青
三 年 - 种 山 - 行 乐 - 梦 魂 - 三 年==三 年 一 榻 占 清 间	门 外 苍 然 是 种 山	步 月 迎 风 行 乐 地	从 今 应 入 梦 魂 间
坐 钓 - 翠 罗 - 日 暮 - 一 纸 - 柔 橹==柔 橹 无 声 坐 钓 鱼	浪 花 飞 点 翠 罗 裾	空 江 日 暮 无 来 客	肠 断 三 湘 一 纸 书
白 发 - 无 言 - 往 来 - 百 里 - 白 发==白 发 萧 萧 送 出 门	相 携 相 看 两 无 言	只 应 今 日 往 来 梦	搅 破 百 里 梅 花 村
野 亭 - 院 落 - 一 枝 - 清 明 - 寂 寞==素 香 寂 寞 野 亭 空	不 似 秋 千 院 落 中	卧 对 一 枝 愁 病 酒	清 明 今 日 雨 兼 风
三 江 - 眼 此 - 如 画 - 丹 青 - 三 江==休 说 三 江 兴 五 湖	平 生 心 眼 此 中 舒	人 人 总 道 浑 如 画	祗 恐 丹 青 画 不 如
鬓 霜 - 芍 药 - 江 水 - 洛 阳 - 鬓 霜==南 渡 年 来 两 鬓 霜	牡 丹 芍 药 但 他 乡	即 从 江 水 浮 淮 水	便 上 维 扬 向 洛 阳
坐 久 - 风 枝 - 三 更 - 闭 门 - 人 语==坐 久 不 闻 人 语 喧	风 枝 吹 动 宿 禽 翻	几 家 负 却 三 更 月	未 到 钟 声 已 闭 门
一 树 - 瑶 芳 - 吹 笛 - 冰 肌 - 一 树==官 梅 一 树 小 池 头	绕 着 瑶 芳 看 不 休	为 语 邻 舟 莫 吹 笛	冰 肌 香 骨 未 禁 愁
夹 道 - 画 堂 - 三 年 - 飞 燕 - 夹 道==渭 桥 夹 道 上 瑶 卮	甲 馆 画 堂 开 祸 基	甘 露 三 年 造 新 室	不 斗 飞 燕 入 宫 时
云 峰 - 泓 澄 - 芳 饵 - 高 名 - 苍 翠==苍 翠 云 峰 开 俗 眼	泓 澄 烟 水 浸 尘 心	唯 将 道 业 为 芳 饵	钓 得 高 名 直 至 今
暮 雨 - 客 子 - 扁 舟 - 西 风 - 暮 雨==暮 雨 生 寒 衣 袂 薄	楚 乡 客 子 正 伤 情	扁 舟 莫 向 芦 边 宿	夜 半 西 风 有 雁 声
细 叶 - 修 眉 - 东 风 - 北 去 - 细 叶==细 叶 如 眉 绿 未 匀	修 眉 浑 似 带 愁 颦	输 他 桃 杏 东 风 里	不 管 南 游 北 去 人
昔 得 - 之 几 - 利 名 - 最 为 - 师 吾==吏 师 吾 昔 得 三 贤	回 首 思 之 几 许 年	屈 指 利 名 多 少 事	其 间 廉 节 最 为 先
人 事 - 故 践 - 颍 水 - 钓 竿 - 人 事==人 事 从 来 无 处 定	世 涂 多 故 践 言 难	谁 如 颍 水 闲 居 士	十 顷 西 湖 一 钓 竿
石 门 - 圣 凡 - 自 愧 - 山 灵 - 千 仞==千 仞 云 崖 耸 石 门	古 传 此 地 圣 凡 分	我 曹 自 愧 群 峰 诮	未 必 山 灵 解 勒 文
水 仙 - 星 悬 - 知 旧 - 英 姿 - 水 仙==处 士 当 年 配 水 仙	范 公 亦 俨 客 星 悬	谁 知 旧 日 番 君 国	飒 爽 英 姿 盖 九 贤
茫 茫 - 千 年 - 多 情 - 相 随 - 衰 草==茫 茫 衰 草 与 云 平	斗 气 千 年 不 复 明	惟 有 多 情 篷 上 月	相 随 客 子 过 丰 城
壁 上 - 萍 游 - 故 人 - 依 依 - 壁 上==壁 上 栖 鸦 粉 剥 红	萍 游 无 定 得 风 同	故 人 妙 墨 何 人 识	文 豹 依 依 雾 雨 中
高 举 - 松 下 - 千 帙 - 呼 儿 - 竹 边==竹 边 闻 鹤 思 高 举	松 下 观 禽 觉 倦 飞	幸 有 故 书 千 帙 在	呼 儿 共 读 嗣 前 徽
桂 花 - 枫 叶 - 社 日 - 秋 风 - 桂 花==桂 花 已 是 上 番 香	枫 叶 飘 红 柿 叶 黄	社 日 雨 多 晴 较 少	秋 风 昼 热 暮 差 凉
古 木 - 何 处 - 元 杰 - 登 临 - 古 木==高 岩 古 木 根 如 辋	辋 坏 元 根 何 处 寻	下 有 唐 有 元 杰 记	读 之 聊 足 慰 登 临
水 晶 - 来 夜 - 独 立 - 无 云 - 水 晶==素 娥 懒 驾 水 晶 轮	此 夕 飞 来 夜 欲 分	送 客 出 门 还 独 立	一 天 清 露 湛 无 云
看 花 - 江 城 - 指 南 - 碧 苔 - 看 花==尽 日 看 花 君 不 来	江 城 半 夜 与 君 开	楼 中 共 指 南 园 火	红 烬 随 花 落 碧 苔
高 楼 - 白 头 - 似 城 - 惜 别 - 高 楼==京 华 可 望 无 高 楼	闻 道 故 人 多 白 头	此 身 却 似 城 东 柳	惜 别 伤 离 不 自 愁
百 尺 - 不 定 - 浮 云 - 月 钩 - 百 尺==六 曲 雕 栏 百 尺 楼	帘 波 不 定 瓦 如 流	浮 云 已 映 楼 西 北	更 向 云 西 待 月 钩
青 楼 - 黛 对 - 知 新 - 织 素 - 青 楼==重 上 青 楼 拂 蛛 网	却 匀 愁 黛 对 菱 波	也 知 新 旧 争 多 少	敢 话 机 头 织 素 多
万 叠 - 地 轴 - 沧 溟 - 首 冠 - 万 叠==万 叠 云 涛 墨 海 间	天 机 地 轴 共 回 环	悠 然 便 有 沧 溟 意	况 在 灵 鳌 首 冠 山
水 石 - 婆 娑 - 杖 藜 - 秋 空 - 水 石==何 日 刀 头 水 石 间	婆 娑 犹 得 一 官 闲	杖 藜 早 晚 寻 幽 处	望 断 秋 空 不 见 山
秋 虫 - 万 里 - 千 仞 - 一 杯 - 秋 虫==烟 帷 瑟 怨 九 秋 虫	霞 锦 书 浓 万 里 鸿	未 得 振 衣 千 仞 上	直 须 埋 照 一 杯 中
有 意 - 溪 门 - 紫 府 - 几 程 - 有 意==岩 树 交 柯 如 有 意	欲 将 密 叶 蔽 溪 门	紫 府 沿 源 应 不 远	未 知 相 去 几 程 云
桃 李 - 亲 旧 - 风 味 - 关 情 - 家 家==家 家 有 分 闲 桃 李	岁 岁 相 亲 旧 燕 莺	老 子 今 年 风 味 恶	稻 针 麻 甲 尚 关 情
零 落 - 折 枝 - 风 味 - 三 年 - 零 落==残 梅 零 落 不 禁 吹	真 是 无 花 空 折 枝	堪 笑 老 人 风 味 减	三 年 不 作 送 梅 诗
百 里 - 烟 霞 - 神 仙 - 一 家 - 山 川==洞 府 山 川 百 里 赊	洞 门 藤 蔓 锁 烟 霞	神 仙 不 与 人 间 异	弟 妹 还 应 共 一 家
悠 悠 - 金 铃 - 绿 衣 - 万 岁 - 秦 云==秦 云 越 树 路 悠 悠	锁 掣 金 铃 百 怨 休	中 有 能 言 绿 衣 鸟	还 呼 万 岁 一 回 头
秋 霜 - 低 飞 - 游 蜂 - 百 花 - 秋 霜==轻 绡 剪 翅 约 秋 霜	点 水 低 飞 恋 野 塘	忽 趁 游 蜂 过 墙 去	可 怜 不 识 百 花 香
江 湖 - 横 行 - 刚 柔 - 公 子 - 江 湖==江 湖 使 者 草 泥 香	郭 索 横 行 得 意 扬	占 得 刚 柔 分 外 内	由 来 公 子 是 无 肠
耆 老 - 大 泽 - 变 化 - 天 马 - 耆 老==耆 老 相 传 亦 可 嗟	深 山 大 泽 自 龙 蛇	老 蛟 变 化 初 何 怪	天 马 从 来 产 渥 洼
春 思 - 流 水 - 空 回 - 夕 阳 - 飘 飘==杨 柳 飘 飘 春 思 长	绿 桥 流 水 绕 官 墙	碧 云 望 断 空 回 首	一 半 阑 干 无 夕 阳
绿 云 - 玉 节 - 旧 曲 - 潇 湘 - 云 飞==绿 云 飞 兴 风 翎 长	翠 葆 轻 摇 玉 节 香	旧 曲 不 弹 瑶 瑟 怨	秋 风 秋 雨 梦 潇 湘
亭 前 - 夜 偏 - 何 处 - 故 乡 - 亭 前==紫 英 亭 前 露 欲 香	习 家 池 上 夜 偏 长	醉 来 见 月 知 何 处	还 道 清 光 是 故 乡
幽 香 - 钗 头 - 供 燕 - 玉 堂 - 一 轮==一 轮 月 影 涨 幽 香	碧 玉 钗 头 白 玉 妆	持 似 此 花 供 燕 几	玉 堂 端 可 寿 萱 堂
万 里 - 年 光 - 柳 花 - 东 风 - 关 山==万 里 关 山 无 尽 期	年 光 春 色 使 人 悲	柳 花 只 似 悠 扬 梦	日 逐 东 风 少 住 时
城 郭 - 高 顶 - 冷 落 - 阑 干 - 城 郭==城 郭 经 寒 近 佛 生	偶 来 高 顶 作 山 行	竹 房 冷 落 无 僧 在	独 倚 阑 干 听 晚 莺
江 上 - 遥 山 - 凭 栏 - 水 云 - 江 上==钱 塘 江 上 撑 空 塔	塔 外 遥 山 翠 作 堆	酒 罢 凭 栏 呼 落 日	水 云 深 处 子 陵 台
新 年 - 今 日 - 芒 真 - 寒 温 - 新 年==旧 年 不 雪 新 年 雪	今 日 非 春 明 日 春	滕 六 勾 芒 真 劣 相	寒 温 相 语 作 比 邻
风 霜 - 秋 天 - 意 厚 - 松 枝 - 风 霜==白 社 风 霜 惊 暮 年	铜 瓶 桑 落 慰 秋 天	怜 君 意 厚 留 新 画	不 著 松 枝 当 酒 钱
祥 烟 - 樱 桃 - 年 年 - 花 落 - 丽 日==丽 日 祥 烟 锁 禁 林	樱 桃 初 熟 可 成 阴	年 年 翠 辇 来 游 幸	花 落 春 宫 一 寸 深
天 台 - 风 光 - 遗 迹 - 青 来 - 天 台==寻 幽 觅 胜 到 天 台	触 目 风 光 剪 剪 开	欲 问 昙 猷 旧 遗 迹	千 山 排 闼 送 青 来
花 日 - 江 南 - 无 人 - 蜂 暖 - 花 日==涧 草 岩 花 日 日 开	江 南 秋 尽 似 春 回	旋 开 还 落 无 人 顾	惟 有 山 蜂 暖 尚 来
图 画 - 能 画 - 但 写 - 蹁 跹 - 图 画==个 中 著 我 添 图 画	能 画 今 谁 如 辋 川	但 写 一 蓑 仍 一 笠	不 须 羽 服 记 蹁 跹
悠 悠 - 江 南 - 行 客 - 清 流 - 陈 迹==庾 公 陈 迹 已 悠 悠	春 到 江 南 天 尽 头	依 旧 冰 芬 照 行 客	瘴 烟 原 不 犯 清 流
夜 半 - 去 路 - 千 珠 - 生 还 - 夜 半==田 文 夜 半 至 函 关	鸡 未 鸣 时 去 路 难	不 是 三 千 珠 履 客	如 何 秦 地 得 生 还
苍 苍 - 濯 濯 - 欲 为 - 题 诗 - 苍 苍==云 中 不 改 苍 苍 色	春 后 宁 同 濯 濯 姿	欲 为 渠 侬 下 转 语	笔 无 潮 力 强 题 诗
冬 风 - 春 至 - 千 里 - 漫 漫 - 冬 风==一 冬 风 雪 苦 多 寒	春 至 冰 霜 更 积 攒	咫 尺 端 如 隔 千 里	况 于 楚 粤 路 漫 漫
别 离 - 送 春 - 归 去 - 垂 杨 - 别 离==作 恶 情 怀 是 别 离	老 夫 懒 作 送 春 诗	东 君 归 去 无 踪 迹	试 问 垂 杨 便 可 知
小 笠 - 渔 翁 - 片 帆 - 清 江 - 小 笠==小 笠 轻 蓑 卧 短 蓬	晓 歌 楚 曲 和 渔 翁	片 帆 自 识 归 来 路	借 得 清 江 一 钓 风
东 风 - 折 镜 - 春 夜 - 待 宫 - 东 风==海 上 东 风 犯 雪 来	腊 前 先 折 镜 湖 梅	遥 思 禁 苑 青 春 夜	坐 待 宫 人 画 诏 回
泠 泠 - 焦 桐 - 坠 叶 - 潇 湘 - 泠 泠==泠 泠 风 举 碧 罗 裳	一 曲 焦 桐 月 在 床	寂 历 寒 波 兼 坠 叶	不 知 何 处 是 潇 湘
榴 花 - 白 头 - 春 意 - 摘 叶 - 榴 花==五 月 榴 花 忽 见 春	白 头 喜 遇 一 番 新	可 能 略 不 解 春 意	只 有 寻 枝 摘 叶 人
石 桥 - 清 风 - 看 花 - 春 归 - 石 桥==石 桥 门 外 送 斜 晖	柳 洒 清 风 透 客 衣	老 眼 看 花 能 有 几	如 何 啼 鸟 暮 春 归
萧 萧 - 清 夜 - 更 教 - 第 一 - 伊 水==瘦 玉 萧 萧 伊 水 头	风 宜 清 夜 露 宜 秋	更 教 仙 骥 傍 边 立	尽 是 人 间 第 一 流
粉 腻 - 燕 燕 - 丹 青 - 丹 青 - 粉 腻==粉 腻 涂 来 两 翅 华	轻 于 燕 燕 受 风 斜	当 年 只 道 丹 青 树	谁 识 丹 青 画 不 差
侵 人 - 雪 消 - 诗 情 - 江 山 - 月 侵==岁 月 侵 人 去 若 奔	雪 消 归 水 不 留 痕	诗 情 本 自 无 多 子	深 谢 江 山 稍 见 存
南 浦 - 使 我 - 憔 悴 - 洛 阳 - 南 浦==送 君 南 浦 泪 如 丝	君 向 东 州 使 我 悲	为 报 故 人 憔 悴 尽	如 今 不 似 洛 阳 时
树 色 - 石 门 - 桃 花 - 云 水 - 树 色==树 色 苍 凉 晓 欲 迷	石 门 初 入 鹧 鸪 啼	桃 花 不 隔 秦 人 路	流 出 红 云 水 涨 溪
名 贤 - 高 名 - 环 北 - 西 山 - 名 贤==名 贤 得 位 古 来 难	君 有 高 名 宇 宙 间	愿 率 众 星 环 北 极	要 令 百 世 仰 西 山
纤 纤 - 深 竹 - 白 云 - 思 虑 - 花 雨==云 阵 纤 纤 洗 花 雨	深 竹 新 闻 子 规 语	青 山 白 云 吾 定 居	枯 肠 那 著 归 思 虑
寻 溪 - 一 泓 - 高 下 - 潺 潺 - 寻 溪==穿 竹 寻 溪 到 穷 处	一 泓 寒 碧 澹 无 情	谁 令 岩 窦 有 高 下	泻 作 潺 潺 鸣 玉 声
公 卿 - 无 心 - 封 侯 - 千 年 - 公 卿==逢 人 休 要 说 公 卿	老 去 无 心 慕 宠 荣	李 不 封 侯 刘 不 第	千 年 青 史 亦 传 名
玲 珑 - 光 寒 - 无 语 - 虚 明 - 万 石==空 洞 玲 珑 万 石 攒	中 间 逗 入 翠 光 寒	人 来 坐 对 山 无 语	表 里 虚 明 不 碍 观
端 坐 - 众 生 - 窗 外 - 春 风 - 端 坐==端 坐 圆 通 妙 微 相	众 生 眼 里 堆 青 嶂	晓 来 窗 外 听 啼 禽	春 风 不 在 花 枝 上
黄 叶 - 秋 色 - 狂 吹 - 咄 咄 - 卷 地==黄 叶 鸣 林 卷 地 风	一 天 秋 色 雁 横 空	风 狂 吹 作 欹 斜 字	似 我 遥 书 咄 咄 中
知 寒 - 行 吟 - 席 投 - 法 师 - 知 寒==江 草 知 寒 柳 半 衰	行 吟 怨 别 独 迟 迟	何 人 讲 席 投 如 意	唯 有 东 林 远 法 师
玉 女 - 铁 心 - 愿 分 - 人 间 - 玉 女==玉 女 攒 空 拥 雾 鬟	铁 心 千 古 照 溪 湾	愿 分 一 滴 清 溪 水	去 洗 人 间 脂 粉 颜
崔 嵬 - 何 如 - 颓 垣 - 想 曾 - 崔 嵬==崔 嵬 十 二 峙 乾 和	五 柱 何 如 马 伏 波	败 堑 颓 垣 今 日 见	想 曾 荆 棘 汉 铜 驼
鹤 顶 - 三 尺 - 五 老 - 岁 寒 - 鹤 顶==休 问 霜 林 鹤 顶 丹	空 庭 三 尺 绿 新 攒	从 渠 五 老 掀 髯 笑	我 自 与 师 盟 岁 寒
寒 水 - 未 匀 - 酒 旗 - 作 诗 - 寒 水==一 池 寒 水 绿 粼 粼	池 上 初 梅 白 未 匀	谁 念 酒 旗 飞 动 处	唐 朝 曾 住 作 诗 人
精 神 - 参 差 - 春 色 - 缠 着 - 精 神==精 神 淡 伫 霜 犹 薄	肤 貌 参 差 发 未 温	试 向 南 枝 看 春 色	夜 来 缠 着 两 三 分
悠 悠 - 随 风 - 无 人 - 青 青 - 悠 悠==柳 絮 悠 悠 拂 面 轻	随 风 到 处 若 为 情	西 池 应 也 无 人 到	一 面 青 青 萍 自 生
正 始 - 掷 地 - 尘 土 - 一 吟 - 正 始==雅 思 追 期 正 始 音	若 将 掷 地 定 成 金	年 来 尘 土 双 侵 鬓	赖 有 清 诗 时 一 吟
华 屋 - 投 梭 - 故 人 - 哭 西 - 华 屋==华 屋 丘 山 可 柰 何	百 年 光 景 一 投 梭	故 人 唯 有 羊 昙 在	恸 哭 西 州 不 忍 歌
向 日 - 徘 徊 - 春 雨 - 去 来 - 向 日==岭 上 英 英 向 日 开	帝 乡 情 态 自 徘 徊	如 何 一 施 阳 春 雨	依 旧 无 心 归 去 来
一 片 - 衡 阳 - 清 都 - 潇 湘 - 一 片==一 片 仙 云 入 帝 乡	数 声 秋 雁 至 衡 阳	借 问 清 都 旧 花 月	岂 知 迁 客 泣 潇 湘
花 开 - 凉 飙 - 林 泉 - 风 光 - 花 开==夜 合 花 开 放 晓 晴	凉 飙 新 爽 小 池 亭	幽 人 雅 称 林 泉 兴	弄 月 吟 风 光 更 清
湖 上 - 芦 叶 - 江 头 - 水 边 - 湖 上==丹 湖 湖 上 送 行 舟	白 雁 啼 残 芦 叶 秋	采 石 江 头 旧 时 路	题 诗 还 忆 水 边 楼
云 堆 - 红 尘 - 野 人 - 窗 前 - 里 结==乱 云 堆 里 结 茅 庐	已 共 红 尘 迹 渐 疏	莫 问 野 人 生 计 事	窗 前 流 水 枕 前 书
秋 来 - 蹇 驴 - 歌 舞 - 诗 人 - 秋 来==杜 老 秋 来 眼 更 寒	蹇 驴 无 复 逐 金 鞍	南 邻 郤 有 新 歌 舞	借 与 诗 人 一 面 看
四 面 - 风 流 - 野 鹿 - 偷 香 - 四 面==玉 栏 四 面 护 花 王	一 段 风 流 似 洛 阳	深 院 不 须 驱 野 鹿	只 愁 蜂 蝶 暗 偷 香
江 行 - 梅 雨 - 无 人 - 庐 山 - 江 行==江 行 初 见 雪 中 梅	梅 雨 霏 微 棹 始 回	莫 道 无 人 肯 相 送	庐 山 犹 自 过 湖 来
眺 望 - 高 山 - 月 上 - 素 娥 - 眺 望==登 楼 眺 望 雪 晴 天	银 作 高 山 玉 作 田	最 好 夜 深 明 月 上	素 娥 滕 六 斗 婵 娟
水 精 - 寂 寞 - 镜 里 - 神 仙 - 宫 殿==水 精 宫 殿 从 来 小	寂 寞 蓬 莱 不 可 游	十 万 人 家 明 镜 里	神 仙 都 会 是 杭 州
如 茵 - 江 南 - 飞 絮 - 落 花 - 如 茵==原 头 芳 草 绿 如 茵	寒 食 江 南 已 过 春	飞 絮 漫 天 兼 绕 路	落 花 如 海 倍 愁 人
西 风 - 云 裳 - 一 杯 - 乡 里 - 风 暖==半 饷 西 风 暖 换 凉	岩 花 月 魄 衬 云 裳	一 杯 旋 擘 翠 橙 香	无 何 乡 里 是 吾 乡
冰 霜 - 阳 和 - 柳 条 - 东 风 - 冰 霜==冰 霜 枯 冻 度 穷 冬	昨 夜 阳 和 始 用 工	多 少 柳 条 知 此 意	一 时 开 眼 望 东 风
馨 香 - 东 篱 - 微 利 - 殷 勤 - 馨 香==来 从 西 域 馨 香 异	翻 作 东 篱 品 自 新	悟 此 肯 为 微 利 役	殷 勤 来 赏 属 幽 人
小 春 - 晴 窗 - 物 胡 - 花 怎 - 小 春==海 棠 搀 得 小 春 天	独 向 晴 窗 弄 午 烟	造 物 胡 为 太 颠 倒	此 花 怎 敢 占 梅 先
沙 上 - 冠 盖 - 一 片 - 死 生 - 沙 上==我 作 朱 金 沙 上 游	诸 君 冠 盖 渡 瓜 洲	淮 云 一 片 不 相 隔	南 北 死 生 分 路 头
上 望 - 寒 色 - 风 吹 - 江 南 - 妙 峰==偶 向 妙 峰 亭 上 望	一 襟 寒 色 近 春 分	晴 风 吹 放 天 全 露	吹 尽 江 南 江 北 云
霜 月 - 风 标 - 遗 恨 - 名 花 - 霜 月==霜 月 交 辉 色 愈 明	风 标 高 节 圣 之 清	谤 观 毫 发 无 遗 恨	始 信 名 花 集 大 成
风 轻 - 露 华 - 鹊 桥 - 蛛 丝 - 风 轻==紫 宙 风 轻 敛 夕 霏	露 华 应 湿 六 铢 衣	鹊 桥 贪 问 经 年 恨	不 觉 蛛 丝 减 旧 机
目 晴 - 诗 情 - 落 花 - 啼 鸟 - 晴 峦==满 目 晴 峦 总 是 诗	诗 情 飞 絮 逐 游 丝	雨 肥 碧 涧 落 花 水	风 瘦 青 松 啼 鸟 枝
秀 气 - 翩 翩 - 后 土 - 八 仙 - 秀 气==香 得 坤 灵 秀 气 全	蕊 珠 团 外 蝶 翩 翩	亲 曾 后 土 祠 中 看	不 是 人 间 聚 八 仙
凝 眸 - 直 下 - 如 相 - 动 地 - 凝 眸==据 坐 凝 眸 语 未 形	一 槌 直 下 意 何 明	倒 行 此 令 如 相 委	无 限 清 风 动 地 生
洛 邑 - 红 尘 - 凉 生 - 清 风 - 洛 邑==洛 邑 舟 中 万 里 均	舟 车 白 浪 与 红 尘	微 掀 衣 角 凉 生 面	不 是 清 风 动 白 苹
落 景 - 天 寒 - 面 微 - 风 前 - 落 景==落 景 秋 云 晚 不 开	天 寒 古 岸 野 船 回	初 惊 波 面 微 澜 起	已 觉 风 前 细 雨 来
知 味 - 无 限 - 山 中 - 江 湖 - 知 味==闭 门 深 坐 日 知 味	无 限 好 山 都 懒 游	城 里 山 中 俱 是 隐	江 湖 不 若 两 忘 休
窗 寒 - 两 岸 - 吟 诗 - 绿 阴 - 光 摇==水 光 摇 入 碧 窗 寒	两 岸 斜 阳 照 乱 山	才 一 吟 诗 便 多 事	只 消 静 对 绿 阴 闲
屋 下 - 云 生 - 疆 界 - 无 心 - 屋 下==屋 下 种 花 檐 露 满	窗 前 叠 石 岫 云 生	春 风 不 解 分 疆 界	本 自 无 心 却 有 情
莺 啭 - 垂 金 - 东 君 - 花 红 - 日 暖==日 暖 风 和 莺 啭 新	柳 垂 金 线 击 东 君	东 君 不 惜 无 私 力	一 点 花 红 一 点 春
玉 炉 - 双 凤 - 金 殿 - 珠 帘 - 玉 炉==翠 华 香 重 玉 炉 添	双 凤 楼 头 晓 日 暹	扇 掩 红 鸾 金 殿 悄	一 声 清 跸 卷 珠 帘
归 休 - 处 处 - 花 木 - 百 年 - 功 成==功 成 三 径 欲 归 休	结 束 池 亭 处 处 幽	花 木 成 时 春 更 好	如 何 不 作 百 年 留
农 家 - 一 门 - 知 来 - 诗 人 - 农 家==我 本 农 家 世 贱 贫	一 门 相 继 亦 簪 绅	当 知 来 处 非 今 日	莫 学 诗 人 只 为 身
卷 帘 - 檐 溜 - 如 拭 - 一 川 - 卷 帘==呼 童 卷 帘 收 架 书	檐 溜 忽 断 云 萧 疏	山 光 水 影 净 如 拭	一 川 秋 意 生 芙 蕖
山 林 - 升 沉 - 水 禽 - 幽 人 - 山 林==投 迹 山 林 不 厌 深	老 来 宁 复 计 升 沉	水 禽 得 得 来 相 伴	应 识 幽 人 一 片 主
狂 风 - 婵 娟 - 关 西 - 小 怜 - 狂 风==十 日 狂 风 不 偶 然	未 教 桃 李 斗 婵 娟	关 西 将 士 曾 如 此	直 入 齐 宫 斩 小 怜
枝 叶 - 草 木 - 楚 歌 - 有 戚 - 枝 叶==合 欢 枝 叶 想 腰 身	不 共 长 安 草 木 春	若 听 楚 歌 能 楚 舞	未 央 空 有 戚 夫 人
沧 浪 - 菡 萏 - 纷 纷 - 江 天 - 沧 浪==一 泓 绿 净 沧 浪 水	千 朵 红 稠 菡 萏 花	病 眼 纷 纷 何 所 似	江 天 落 日 散 余 霞
苍 苔 - 芰 荷 - 波 上 - 似 画 - 苍 苔==凿 破 苍 苔 涨 作 池	芰 荷 分 得 绿 参 差	晓 开 一 朵 烟 波 上	似 画 真 妇 出 浴 时
孤 吟 - 鸡 犬 - 傥 能 - 水 墨 - 孤 吟==抱 膝 孤 吟 欠 范 模	原 随 鸡 犬 藉 丹 炉	傥 能 化 得 尘 凡 骨	差 胜 无 声 水 墨 图
乘 兴 - 冷 涵 - 曹 溪 - 在 下 - 乘 兴==乘 兴 飞 帆 别 翠 峰	水 光 春 静 冷 涵 空	到 人 若 问 曹 溪 意	祇 报 卢 能 在 下 风
灞 岸 - 相 倚 - 飞 絮 - 垂 丝 - 灞 岸==灞 岸 晴 来 送 别 频	相 偎 相 倚 不 胜 春	自 家 飞 絮 犹 无 定	争 解 垂 丝 绊 路 人
青 草 - 茅 屋 - 来 来 - 浓 阴 - 青 草==青 草 湖 边 白 石 西	花 篱 茅 屋 酒 帘 低	来 来 去 去 双 黄 鸟	不 到 浓 阴 不 肯 啼
羽 扇 - 健 儿 - 铁 马 - 半 天 - 羽 扇==将 军 羽 扇 自 临 戎	帐 下 健 儿 争 立 功	铁 马 莫 来 淮 上 牧	汉 家 旗 纛 半 天 红
绿 阴 - 静 听 - 枕 簟 - 禅 心 - 阴 阴==庭 前 槐 树 绿 阴 阴	静 听 玄 蝉 尽 日 吟	枕 簟 虚 凉 清 梦 境	了 无 俗 物 动 禅 心
竹 杖 - 寻 桃 - 冷 翠 - 挂 树 - 竹 杖==偶 呼 邻 稚 携 竹 杖	试 入 仙 窟 寻 桃 源	日 斜 小 憩 冷 翠 谷	惊 散 挂 树 黄 黑 猿
微 风 - 落 日 - 明 何 - 玉 人 - 微 风==微 风 吹 颊 酒 初 醒	落 日 舟 横 杜 若 汀	水 秀 山 明 何 所 似	玉 人 临 镜 晕 螺 青
秋 清 - 无 人 - 月 华 - 蛩 鸣 - 秋 清==四 时 那 得 如 秋 清	夜 静 无 人 琴 有 声	月 华 如 水 不 动 尘	无 端 耳 畔 寒 蛩 鸣
二 百 - 杰 阁 - 徙 倚 - 秋 风 - 二 百==张 公 一 去 二 百 载	杰 阁 依 然 横 霭 中	徙 倚 看 碑 仍 看 画	时 闻 柏 子 落 秋 风
曹 溪 - 上 下 - 解 使 - 朝 云 - 曹 溪==曹 溪 一 路 透 泥 丸	只 在 丹 田 上 下 间	解 使 金 翁 媒 姹 女	朝 云 暮 雨 满 巫 山
啼 鸟 - 春 园 - 春 雨 - 吴 中 - 残 红==满 川 啼 鸟 怨 残 红	水 郭 春 园 柳 絮 风	春 雨 一 番 江 水 阔	草 痕 将 绿 到 吴 中
高 挂 - 万 仞 - 游 仙 - 冠 盖 - 高 挂==一 帆 高 挂 出 红 尘	万 仞 长 歌 入 紫 云	莫 道 游 仙 别 无 侣	玉 清 冠 盖 许 同 群
春 色 - 江 上 - 红 腻 - 一 卷 - 春 色==拜 朔 台 前 春 色 深	碧 云 江 上 几 沉 吟	霏 红 腻 绿 莲 花 女	抽 尽 芭 蕉 一 卷 心
朱 颜 - 绿 酒 - 三 山 - 闭 门 - 不 老==朱 颜 不 老 画 中 人	绿 酒 追 欢 梦 里 身	堪 笑 三 山 衰 病 叟	闭 门 寂 寂 过 新 春
垂 老 - 天 明 - 多 少 - 一 茎 - 垂 老==垂 老 何 时 见 弟 兄	背 灯 愁 泣 到 天 明	不 知 短 发 能 多 少	一 滴 秋 霖 白 一 茎
江 水 - 人 烟 - 杳 杳 - 一 川 - 水 边==峭 壁 崩 崖 江 水 边	深 山 日 暮 见 人 烟	沧 波 杳 杳 连 三 峡	寒 草 清 清 自 一 川
新 月 - 星 斗 - 在 天 - 雪 飞 - 新 月==新 月 何 曾 展 画 帏	便 教 星 斗 避 寒 辉	量 量 自 在 天 公 最	昨 日 峰 头 有 雪 飞
岚 光 - 幽 人 - 茅 舍 - 绝 顶 - 苍 翠==乱 山 苍 翠 霭 岚 光	采 药 幽 人 凤 子 香	路 转 峰 回 茅 舍 静	好 寻 绝 顶 访 僧 房
山 石 - 结 庐 - 泉 鸣 - 何 处 - 山 石==路 绕 苍 山 石 挂 藤	结 庐 深 入 白 云 层	泉 鸣 便 隔 人 间 世	采 药 知 从 何 处 僧
东 西 - 贵 贱 - 樽 有 - 武 陵 - 东 西==箭 飞 乌 兔 竞 东 西	贵 贱 贤 愚 不 梦 齐	匣 里 有 琴 樽 有 酒	人 间 便 是 武 陵 溪
国 书 - 刺 史 - 醉 客 - 绿 杨 - 国 书==莫 言 鲁 国 书 生 懦	莫 把 杭 州 刺 史 欺	醉 客 请 君 开 眼 望	绿 杨 风 下 有 红 旗
生 涯 - 渔 舟 - 黄 庭 - 风 波 - 生 涯==集 仙 仙 客 问 生 涯	买 得 渔 舟 度 岁 华	案 有 黄 庭 尊 有 酒	少 风 波 外 便 为 家
春 初 - 轻 身 - 九 秋 - 芳 时 - 春 初==春 初 种 菊 助 盘 蔬	益 气 轻 身 载 旧 图	终 藉 九 秋 扶 正 色	芳 时 偷 得 醉 工 夫
如 焚 - 遣 上 - 为 霖 - 行 雨 - 如 焚==大 旱 如 焚 气 不 苏	云 师 谁 遣 上 天 衢	人 人 准 拟 为 霖 甚	风 动 雷 行 雨 却 无
挟 策 - 寂 寥 - 半 山 - 野 水 - 苍 头==蹇 驴 挟 策 一 苍 头	罢 相 归 来 隐 寂 寥	看 到 半 山 三 不 足	依 然 野 水 漫 青 苗
骨 秀 - 小 小 - 得 月 - 日 长 - 骨 秀==二 雏 毛 骨 秀 仍 奇	小 小 能 吟 大 大 诗	想 得 月 中 仙 桂 树	各 从 生 日 长 新 枝
客 路 - 秋 色 - 一 封 - 独 坐 - 别 离==客 路 寻 常 怨 别 离	况 逢 秋 色 倍 堪 悲	一 封 书 到 千 山 暮	正 是 思 君 独 坐 时
翩 翩 - 娱 宾 - 座 中 - 青 春 - 游 骑==游 骑 翩 翩 从 使 君	娱 宾 亭 上 宴 西 曛	座 中 不 用 频 辞 酒	明 日 青 春 已 一 分
云 开 - 江 湖 - 眼 界 - 望 中 - 云 开==云 开 层 观 切 高 寒	三 面 江 湖 一 面 山	眼 界 不 知 多 少 远	望 中 幽 鸟 暮 飞 还
营 巢 - 衔 泥 - 秋 风 - 万 里 - 营 巢==燕 子 营 巢 得 所 依	衔 泥 辛 苦 傍 人 飞	秋 风 一 夜 惊 桐 叶	不 恋 雕 梁 万 里 归
云 山 - 依 依 - 南 来 - 双 旌 - 云 山==渺 渺 云 山 去 几 重	依 依 独 听 广 陵 钟	明 朝 借 问 南 来 客	五 马 双 旌 何 处 逢
爱 日 - 逢 觞 - 春 老 - 搜 诗 - 花 残==花 残 爱 日 惟 愁 尽	病 渴 逢 觞 却 厌 多	不 分 闲 中 觉 春 老	强 搜 诗 句 逐 阴 何
漫 漫 - 春 风 - 纷 纷 - 殷 勤 - 漫 漫==漫 漫 红 紫 是 谁 栽	八 月 春 风 暗 里 来	过 眼 纷 纷 难 尽 忆	殷 勤 却 看 稻 花 开
松 篁 - 当 轩 - 游 人 - 青 山 - 松 篁==三 面 松 篁 簇 梵 宫	当 轩 冷 砌 画 屏 风	游 人 试 问 空 门 理	云 起 青 山 鹤 山 笼
桃 李 - 一 番 - 解 箨 - 可 人 - 成 蹊==吹 尽 成 蹊 桃 李 尘	兔 葵 燕 麦 一 番 新	只 应 解 箨 抽 青 玉	霜 节 棱 棱 尚 可 人
雁 塞 - 云 州 - 因 请 - 内 史 - 雁 塞==雁 塞 五 山 临 汗 漫	云 州 一 路 出 青 冥	何 因 请 住 嘉 祥 寺	内 史 新 修 湖 上 亭
潺 潺 - 如 水 - 窗 间 - 鼻 观 - 山 紫==碧 涧 潺 潺 暮 山 紫	闭 关 危 坐 心 如 水	窗 间 微 见 一 枝 横	鼻 观 得 香 尤 可 喜
五 里 - 清 虚 - 选 得 - 精 蓝 - 西 山==西 山 州 城 五 里 馀	大 云 仙 洞 最 清 虚	近 来 选 得 禅 师 住	是 处 精 蓝 尽 不 如
祝 史 - 十 年 - 瑶 林 - 游 仙 - 祝 史==曾 为 祝 史 趋 真 馆	屈 指 于 今 二 十 年	琪 树 瑶 林 成 想 像	直 疑 当 日 梦 游 仙
蔷 薇 - 蔷 薇 - 龙 头 - 莺 归 - 蔷 薇==还 家 消 息 约 蔷 薇	眼 看 蔷 薇 日 日 稀	不 踏 龙 头 游 碧 落	君 恩 许 伴 晚 莺 归
笔 端 - 骚 人 - 枫 林 - 深 夜 - 一 片==一 片 潇 湘 落 笔 端	骚 人 千 古 带 愁 看	不 堪 秋 著 枫 林 港	雨 阔 烟 深 夜 钓 寒
水 平 - 画 图 - 楼 台 - 西 湖 - 水 平==梅 霖 初 歇 水 平 湖	湖 上 青 山 展 画 图	更 著 楼 台 相 掩 映	风 流 端 不 减 西 湖
东 风 - 斜 阳 - 佳 人 - 青 山 - 东 风==长 桥 纳 纳 袅 东 风	倒 射 斜 阳 千 丈 红	晚 色 自 佳 人 不 见	青 山 翠 雾 碧 波 中
残 雪 - 微 茫 - 幽 人 - 一 曲 - 汀 洲==君 山 残 雪 点 汀 洲	黄 浦 微 茫 失 远 流	犹 有 幽 人 徐 酉 望	洞 箫 一 曲 出 江 楼
杨 柳 - 花 愁 - 离 亭 - 潇 湘 - 江 头==扬 子 江 头 杨 柳 春	杨 花 愁 杀 渡 江 人	数 声 风 笛 离 亭 晚	君 向 潇 湘 我 向 秦
韫 椟 - 日 新 - 垂 柳 - 被 发 - 韫 椟==洛 京 韫 椟 起 儒 珍	地 讲 忠 规 德 日 新	禁 苑 金 丝 舞 垂 柳	万 方 已 被 发 生 仁
日 边 - 神 光 - 为 瑞 - 花 开 - 日 边==天 书 亲 自 日 边 平	一 道 神 光 遍 九 垓	为 瑞 为 祥 恩 力 大	直 教 枯 木 解 花 开
凄 凉 - 霜 叶 - 一 杯 - 行 客 - 江 天==江 天 惨 澹 日 凄 凉	木 未 经 霜 叶 未 黄	今 日 楼 头 一 杯 酒	明 朝 行 客 在 谁 乡
同 气 - 齐 名 - 寒 水 - 一 茎 - 同 气==蕙 兰 同 气 犹 争 长	姚 魏 齐 名 各 一 家	不 似 优 昙 照 寒 水	一 茎 能 现 四 边 花
看 山 - 白 云 - 无 穷 - 只 是 - 看 山==日 日 看 山 不 厌 山	白 云 吞 吐 翠 微 间	静 明 光 里 无 穷 乐	只 是 令 人 下 语 难
雨 过 - 菱 歌 - 繁 霜 - 归 去 - 雨 过==南 风 雨 过 若 耶 深	莲 女 菱 歌 乱 别 心	后 夜 繁 霜 凋 绿 盖	洞 房 归 去 理 秋 砧
斜 阳 - 一 片 - 春 雨 - 风 摇 - 斜 阳==斜 阳 葛 岭 少 人 行	一 片 荒 山 系 废 兴	留 得 临 湖 春 雨 观	东 风 摇 落 木 香 棚
鸡 唱 - 安 排 - 催 耕 - 晓 星 - 鸡 唱==鸡 唱 三 声 天 欲 明	安 排 饭 碗 与 茶 瓶	良 人 犹 怒 催 耕 早	自 扯 蓬 窗 看 晓 星
泪 痕 - 黄 昏 - 是 并 - 明 月 - 泪 痕==宫 草 平 阶 拥 泪 痕	檐 禽 浙 浙 送 黄 昏	君 王 岂 是 并 州 估	明 月 梨 花 独 掩 门
桥 下 - 桥 边 - 青 山 - 蛾 眉 - 悠 悠==具 区 桥 下 水 悠 悠	具 区 桥 边 郎 发 舟	郎 舟 好 载 青 山 去	免 使 蛾 眉 相 对 愁
怪 石 - 无 人 - 来 嫡 - 西 湖 - 玲 珑==玲 珑 怪 石 巧 相 扶	奇 绝 无 人 作 画 图	要 是 飞 来 嫡 孙 行	恨 君 生 不 近 西 湖
仙 娥 - 仙 娥 - 一 曲 - 金 钿 - 仙 娥==古 来 花 貌 说 仙 娥	自 是 仙 娥 薄 命 多	一 曲 霓 裳 未 终 舞	金 钿 甲 委 马 嵬 坡
坛 边 - 白 鹿 - 千 树 - 无 主 - 坛 边==坛 边 松 在 鹤 巢 空	白 鹿 闲 行 旧 径 中	手 植 红 桃 千 树 发	满 山 无 主 任 春 风
山 巅 - 知 在 - 恙 否 - 探 梅 - 山 巅==君 曾 夷 视 北 山 巅	险 阻 谁 知 在 眼 前	亟 欲 问 君 无 恙 否	小 春 催 到 探 梅 天
十 年 - 饱 连 - 盐 策 - 讲 明 - 十 年==三 十 年 来 边 宿 兵	大 农 无 计 饱 连 营	元 来 有 个 浮 盐 策	南 渡 诸 贤 未 讲 明
山 田 - 三 峰 - 生 两 - 过 此 - 山 田==笋 与 咿 辄 下 山 田	遥 指 三 峰 返 照 边	安 得 肉 身 生 两 翅	霎 时 飞 过 此 山 前
日 新 - 数 枝 - 佳 句 - 可 人 - 日 新==寒 暑 回 还 日 日 新	数 枝 留 得 几 多 春	君 能 弹 压 凭 佳 句	一 段 清 襟 亦 可 人
快 剑 - 一 片 - 荷 花 - 烟 柳 - 快 剑==杀 胡 快 剑 是 清 讴	牛 渚 依 然 一 片 秋	却 恨 荷 花 留 玉 辇	竟 忘 烟 柳 汴 宫 愁
步 虚 - 太 乙 - 明 珠 - 月 上 - 步 虚==绿 章 封 事 步 虚 仙	来 自 东 皇 太 乙 边	满 袖 明 珠 出 光 怪	又 随 溪 月 上 归 船
残 香 - 泪 眼 - 水 声 - 哀 怨 - 残 香==黄 绢 碑 残 香 草 生	当 时 泪 眼 不 曾 晴	至 今 流 水 声 呜 咽	犹 是 曹 娥 哀 怨 声
烟 雨 - 梅 花 - 万 里 - 猿 啼 - 雨 昏==秭 归 江 头 烟 雨 昏	客 舟 夜 系 梅 花 村	相 逢 万 里 各 羁 旅	不 待 猿 啼 已 断 魂
绿 水 - 鸣 条 - 龙 舟 - 万 缕 - 绿 水==绿 水 成 文 柳 带 摇	东 风 初 到 不 鸣 条	龙 舟 欲 过 偏 留 恋	万 缕 轻 丝 拂 御 桥
延 年 - 蟾 宫 - 娥 蒙 - 桂 花 - 延 年==饮 冰 啮 雪 傅 延 年	要 比 蟾 宫 桂 子 妍	忽 遇 嫦 娥 蒙 一 盼	桂 花 未 敢 著 鞭 先
红 蕊 - 数 枝 - 春 意 - 凌 寒 - 红 蕊==红 蕊 曾 游 此 地 来	青 青 今 见 数 枝 梅	只 应 尚 有 娇 春 意	不 肯 凌 寒 取 次 开
一 竿 - 片 片 - 柳 条 - 荷 衣 - 一 竿==澹 溪 溪 上 一 竿 丝	牵 动 闲 云 片 片 飞	折 尽 柳 条 穿 不 得	荷 衣 裹 向 碧 山 归
梁 苑 - 数 回 - 岁 月 - 白 头 - 梁 苑==昔 从 邺 下 游 梁 苑	孤 店 曾 经 十 数 回	岁 月 暗 移 人 事 改	白 头 重 到 小 韩 来
仙 骨 - 琼 楼 - 雪 里 - 僧 舍 - 仙 骨==使 君 仙 骨 迥 无 俦	合 上 琼 楼 倒 玉 舟	雪 里 渔 蓑 诗 更 好	盛 传 僧 舍 与 歌 楼
扰 扰 - 光 寒 - 斜 插 - 夫 君 - 扰 扰==扰 扰 香 云 湿 未 干	鸦 领 蝉 翼 腻 光 寒	侧 边 斜 插 黄 金 凤	妆 罢 夫 君 带 笑 看
垂 虹 - 闲 倚 - 鲈 鱼 - 秋 风 - 垂 虹==昨 天 移 棹 泊 垂 虹	闲 倚 篷 窗 问 钓 翁	为 底 鲈 鱼 低 价 卖	年 来 朝 市 怕 秋 风
马 上 - 马 坐 - 通 姓 - 银 瓶 - 谁 家==马 上 谁 家 薄 媚 郎	临 阶 下 马 坐 人 床	不 通 姓 字 粗 豪 甚	指 点 银 瓶 索 酒 尝
碧 波 - 采 莲 - 千 里 - 风 雨 - 碧 波==莲 渚 愁 红 荡 碧 波	吴 娃 齐 唱 采 莲 歌	横 塘 一 别 已 千 里	芦 苇 萧 萧 风 雨 多
山 川 - 西 偏 - 险 阻 - 峻 岭 - 山 川==房 陵 郡 僻 皆 山 川	竹 山 更 在 房 西 偏	道 由 房 城 绝 险 阻	高 崖 峻 岭 相 绵 延
天 涯 - 幽 恨 - 千 里 - 看 花 - 天 涯==牢 落 天 涯 邂 逅 逢	清 愁 幽 恨 与 谁 同	故 园 肠 断 三 千 里	客 裹 看 花 岁 又 穷
白 玉 - 方 丈 - 金 花 - 乾 清 - 白 玉==天 上 琳 宫 白 玉 梯	别 开 方 丈 五 云 西	金 花 传 赐 仙 官 诰	上 有 乾 清 御 墨 题
渔 火 - 林 钟 - 幽 人 - 僧 房 - 渔 火==天 远 湖 南 渔 火 稀	隔 林 钟 磬 度 微 微	不 知 此 夕 幽 人 兴	月 出 僧 房 归 未 归
红 稀 - 春 回 - 无 人 - 枝 头 - 红 稀==芳 歇 红 稀 蝶 懒 来	潇 潇 风 雷 送 春 回	绿 阴 如 许 无 人 看	软 玉 枝 头 已 有 梅
人 静 - 雨 露 - 紫 香 - 清 阴 - 人 静==福 庭 人 静 少 攀 援	雨 露 偏 滋 影 易 繁	磊 落 紫 香 香 亚 树	清 阴 满 地 昼 当 轩
白 杨 - 寒 食 - 柳 色 - 玉 钩 - 白 杨==雷 塘 无 限 白 杨 花	寒 食 西 风 集 暮 鸦	莫 向 旧 堤 窥 柳 色	春 锄 争 上 玉 钩 斜
云 开 - 凤 衔 - 沽 酒 - 入 山 - 白 云==柴 扉 常 对 白 云 开	玉 凤 衔 花 去 又 回	不 学 东 林 远 沽 酒	渊 明 多 谢 入 山 来
游 骑 - 佳 人 - 方 丈 - 漫 漫 - 游 骑==偏 憎 游 骑 香 蹄 污	最 称 佳 人 素 手 团	方 丈 老 翁 容 膝 外	出 门 四 顾 尽 漫 漫
悠 悠 - 诗 人 - 蝉 声 - 杨 柳 - 悠 悠==闲 庭 凉 思 晚 悠 悠	谁 遣 诗 人 到 水 头	两 岸 蝉 声 西 照 里	岂 容 杨 柳 不 先 秋
照 人 - 临 轩 - 东 风 - 东 风 - 日 照==菱 花 初 日 照 人 空	妆 罢 临 轩 数 落 红	不 得 东 风 花 不 发	花 飞 犹 自 怨 东 风
轩 窗 - 夜 凉 - 明 月 - 迎 风 - 水 轩==羔 水 轩 窗 宜 夏 居	夜 凉 如 水 似 和 初	科 头 枕 石 卧 明 月	仰 面 迎 风 看 太 虚
乞 巧 - 玉 指 - 年 年 - 别 离 - 乞 巧==乞 巧 楼 前 乞 巧 时	金 针 玉 指 弄 春 丝	牛 郎 织 女 年 年 会	可 惜 容 颜 永 别 离
清 风 - 新 秋 - 桃 花 - 枕 上 - 清 风==一 夜 清 风 动 扇 愁	背 时 容 色 入 新 秋	桃 花 脸 里 汪 汪 泪	忍 到 更 深 枕 上 流
故 人 - 气 象 - 无 味 - 有 情 - 故 人==邂 逅 故 人 逃 难 处	王 孙 气 象 独 升 平	诗 吟 摩 诘 如 无 味	画 到 阳 关 别 有 情
到 处 - 淡 烟 - 奇 花 - 春 妍 - 弦 歌==弦 歌 到 处 即 熙 然	桑 柘 青 含 淡 淡 烟	肯 倩 奇 花 树 民 怨	为 人 岁 岁 作 春 妍
风 雨 - 白 发 - 是 元 - 陈 惊 - 雨 过==车 驰 卒 奔 风 雨 过	白 发 故 人 余 一 个	幸 是 元 无 左 阿 君	何 须 不 著 陈 惊 坐
春 寒 - 冰 雪 - 书 窗 - 游 蜂 - 寒 花==旧 说 春 寒 花 较 迟	况 今 冰 雪 已 逾 时	一 枝 借 得 书 窗 暖	未 许 游 蜂 戏 蝶 知
但 风 - 春 愁 - 诗 人 - 诗 七 - 但 风==不 但 风 饕 雨 更 尤	落 英 满 地 诉 春 愁	诗 人 分 韵 留 春 处	一 句 韩 诗 七 个 阄
居 山 - 世 名 - 烟 霞 - 知 寒 - 山 城==居 山 城 市 罕 逢 人	傲 世 名 高 混 世 尘	满 目 烟 霞 常 作 伴	方 知 寒 暑 易 为 春
苍 苔 - 团 团 - 漱 玉 - 风 卷 - 石 壁==石 壁 苍 苔 露 未 乾	小 池 射 日 石 团 团	弄 泉 漱 玉 归 何 暮	风 卷 横 云 细 细 看
庭 燎 - 霞 觞 - 五 夜 - 白 日 - 庭 燎==元 会 初 分 庭 燎 光	君 王 亲 御 紫 霞 觞	不 知 五 夜 春 多 少	白 日 犹 闻 蜡 炬 香
东 君 - 游 人 - 天 香 - 笑 脸 - 东 君==不 谓 东 君 雨 后 春	尚 多 红 紫 待 游 人	天 香 更 有 西 京 种	来 伴 宾 筵 笑 脸 新
鹤 书 - 寂 寥 - 明 月 - 山 犹 - 鹤 书==高 栖 不 受 鹤 书 招	北 干 家 园 久 寂 寥	明 月 空 怀 人 姓 许	故 山 犹 自 岫 名 萧
白 马 - 矣 肯 - 合 星 - 日 月 - 白 马==白 马 盟 存 矢 弗 寒	玩 其 肆 矣 肯 泥 蟠	风 云 未 合 星 先 陨	输 与 江 东 日 月 宽
野 水 - 森 森 - 一 番 - 金 色 - 雪 消==雪 消 野 水 半 融 泥	冻 柳 森 森 态 未 齐	昨 夜 一 番 春 雨 好	淡 黄 金 色 满 湖 堤
黄 菊 - 清 香 - 今 日 - 霜 蟹 - 疏 篱==倚 风 黄 菊 绕 疏 篱	自 有 清 香 处 处 知	今 日 王 孙 好 收 采	浊 醪 霜 蟹 正 堪 持
风 光 - 独 得 - 一 枝 - 第 一 - 风 光==九 十 风 光 次 第 分	天 怜 独 得 殿 残 春	一 枝 剩 欲 簪 双 髻	未 有 人 间 第 一 人
盘 桓 - 楼 上 - 清 兴 - 夜 深 - 江 行==江 行 山 立 月 盘 桓	有 客 无 言 楼 上 看	清 兴 肯 随 城 漏 尽	夜 深 风 露 恐 高 寒
石 头 - 清 流 - 穷 幽 - 一 片 - 石 头==枯 箨 危 根 缴 石 头	千 竿 交 映 近 清 流	堪 珍 仲 宝 穷 幽 笔	留 得 荆 湘 一 片 秋
恰 恰 - 风 摇 - 半 夜 - 秋 声 - 竹 斋==恰 恰 方 池 款 竹 斋	风 摇 窗 扇 掩 还 开	无 端 半 夜 疏 荷 雨	更 带 秋 声 入 梦 来
火 云 - 一 叶 - 园 林 - 砧 杵 - 奇 峰==火 云 犹 未 敛 奇 峰	欹 枕 初 惊 一 叶 风	几 处 园 林 萧 瑟 里	谁 家 砧 杵 寂 寥 中
江 边 - 骑 驴 - 间 非 - 笑 渠 - 鲤 鱼==采 石 江 边 踏 鲤 鱼	华 山 县 里 自 骑 驴	世 间 非 醉 亦 非 睡	白 堕 黄 粱 莫 笑 渠
疏 棂 - 蟾 光 - 离 骚 - 菊 花 - 面 面==小 楼 面 面 著 疏 棂	静 有 蟾 光 绝 市 声	读 罢 离 骚 临 晋 帖	菊 花 香 裹 数 寒 更
定 吾 - 翠 柏 - 知 几 - 到 处 - 白 鹭==轻 鸥 白 鹭 定 吾 友	翠 柏 幽 篁 是 可 人	海 角 逢 春 知 几 度	卧 游 到 处 总 伤 神
黄 鹂 - 杜 鹃 - 玉 辇 - 西 风 - 黄 鹂==梦 入 黄 鹂 紫 殿 阴	天 津 空 费 杜 鹃 心	宣 和 玉 辇 君 休 问	老 在 西 风 五 国 林
和 气 - 紫 霄 - 主 间 - 宸 朝 - 和 气==东 方 和 气 斗 回 杓	龙 角 中 星 转 紫 霄	圣 主 间 安 天 未 晓	求 衣 亲 记 玉 宸 朝
玉 露 - 月 挂 - 人 间 - 天 孙 - 玉 露==乞 巧 筵 开 玉 露 秋	一 钩 凉 月 挂 西 楼	人 间 百 巧 方 无 奈	寄 语 天 孙 好 罢 休
千 株 - 长 乐 - 春 风 - 夜 深 - 千 株==压 沙 寺 後 千 株 雪	长 乐 坊 前 十 里 香	寄 语 春 风 莫 吹 尽	夜 深 留 与 雪 争 光
白 水 - 春 晴 - 飞 去 - 忘 机 - 白 水==白 水 满 塘 蒲 荇 青	野 凫 相 对 浴 春 晴	背 人 飞 去 犹 回 顾	我 已 忘 机 莫 浪 惊
一 望 - 断 碑 - 陈 迹 - 夜 夜 - 江 山==一 望 江 山 去 不 回	断 碑 荒 草 旧 宫 台	六 朝 陈 迹 皆 如 梦	夜 夜 寒 潮 送 月 来
一 川 - 荡 漾 - 知 几 - 九 成 - 扁 舟==一 川 风 月 下 扁 舟	荡 漾 金 波 泛 白 鸥	此 去 韶 江 知 几 里	九 成 缥 渺 在 云 头
玉 山 - 鹤 唳 - 游 人 - 白 云 - 玉 山==群 玉 山 前 隐 道 园	松 声 鹤 唳 隔 溪 闻	山 灵 似 识 游 人 意	要 看 青 林 映 白 云
梅 影 - 白 玉 - 官 家 - 黄 金 - 梅 影==月 笼 梅 影 夜 深 时	白 玉 排 箫 索 独 吹	传 得 官 家 暗 宣 赐	黄 金 约 臂 翠 花 枝
远 岫 - 夕 阳 - 叶 底 - 随 意 - 远 岫==老 眼 偏 明 远 岫 孤	夕 阳 故 遣 树 阴 疏	蝉 鸣 叶 底 无 寻 处	随 意 闲 行 偶 见 渠
故 乡 - 新 岁 - 烹 茶 - 沽 酒 - 故 乡==他 乡 故 乡 老 若 此	新 岁 旧 岁 穷 依 然	烹 茶 但 有 二 升 水	沽 酒 初 无 三 百 钱
飘 零 - 百 年 - 天 涯 - 沉 沉 - 白 发==白 发 飘 零 远 可 嗟	百 年 居 屋 在 京 华	海 涯 更 比 天 涯 远	星 斗 沉 沉 入 海 涯
南 浦 - 新 诗 - 粼 粼 - 鹅 黄 - 南 浦==南 浦 东 冈 二 月 时	物 华 撩 我 有 新 诗	含 风 鸭 绿 粼 粼 起	弄 日 鹅 黄 袅 袅 垂
残 日 - 一 片 - 春 水 - 花 梢 - 残 日==数 峰 残 日 紫 将 销	一 片 新 秧 绿 未 交	道 是 今 年 春 水 小	涨 痕 也 到 岸 花 梢
南 山 - 可 人 - 古 今 - 熙 客 - 南 山==有 缘 结 得 南 山 境	潇 洒 亭 高 最 可 人	此 景 古 今 吟 不 尽	熙 熙 客 里 且 行 春
力 微 - 夜 深 - 花 梢 - 东 风 - 力 微==脸 晕 轻 红 酒 力 微	真 妃 半 醉 夜 深 时	杜 鹃 叫 落 花 梢 月	独 倚 东 风 睡 不 足
问 津 - 杖 藜 - 欲 知 - 一 点 - 问 津==江 上 相 逢 试 问 津	杖 藜 来 作 化 灯 行	欲 知 照 破 无 明 窟	佛 殿 荧 荧 一 点 明
东 君 - 蜂 蝶 - 桃 李 - 杨 柳 - 东 君==东 君 留 恋 一 分 春	蜂 蝶 阑 珊 燕 子 新	桃 李 无 情 空 绿 径	市 桥 杨 柳 送 行 人
夏 又 - 闲 居 - 千 寻 - 檐 前 - 到 东==不 到 东 平 夏 又 秋	闲 居 身 尚 不 吾 由	可 怜 岩 上 千 寻 瀑	不 似 檐 前 一 派 流
画 船 - 杏 花 - 半 山 - 杜 鹃 - 杨 柳==杨 柳 垂 丝 拂 画 船	杏 花 零 落 断 桥 边	半 山 烟 雨 东 风 恶	更 向 西 亭 听 杜 鹃
清 明 - 春 寒 - 对 客 - 牡 丹 - 清 明==趁 得 清 明 几 日 闲	不 禁 连 雨 作 春 寒	小 窗 对 客 开 新 煮	艺 罢 沈 香 看 牡 丹
花 市 - 罗 绮 - 何 处 - 客 心 - 花 市==花 市 银 灯 夜 向 深	香 风 罗 绮 迥 沈 沈	不 知 何 处 笙 歌 起	传 得 新 愁 上 客 心
一 脉 - 骨 相 - 曲 肱 - 南 山 - 一 脉==日 饮 云 根 一 脉 泉	知 君 骨 相 自 应 仙	曲 肱 闲 卧 茅 檐 下	买 断 南 山 不 用 钱
稚 子 - 一 篙 - 把 作 - 中 流 - 稚 子==稚 子 如 何 济 急 流	一 篙 才 错 便 难 收	当 初 把 作 寻 常 看	岂 料 中 流 解 覆 舟
风 卷 - 寂 寂 - 暗 香 - 云 淡 - 池 面==池 面 轻 风 卷 碧 罗	残 英 寂 寂 委 微 波	暗 香 又 逐 落 英 去	奈 此 疏 云 淡 月 何
绝 壁 - 青 山 - 虚 明 - 江 南 - 绝 壁==绝 壁 藤 萝 喜 可 攀	更 无 平 地 只 青 山	路 回 亦 有 虚 明 处	江 北 江 南 指 掌 间
平 湖 - 儿 郎 - 万 雉 - 杨 柳 - 平 湖==圩 田 元 是 一 平 湖	凭 伏 儿 郎 筑 作 圩	万 雉 长 城 倩 谁 守	两 堤 杨 柳 当 防 夫
花 外 - 到 处 - 家 家 - 读 书 - 花 外==槛 边 花 外 尽 重 湖	到 处 怀 觞 兴 不 孤	安 得 家 家 寻 画 手	溪 堂 遍 写 读 书 图
长 歌 - 塞 北 - 孤 城 - 天 外 - 横 吹==横 吹 长 歌 千 万 骑	将 军 塞 北 立 功 回	边 人 争 出 孤 城 望	渐 见 族 旗 天 外 来
又 见 - 微 吟 - 春 风 - 柳 色 - 因 书==午 困 因 书 又 见 寻	自 添 茶 鼎 候 微 吟	病 身 未 觉 春 风 暖	柳 色 无 端 日 日 夜
田 舍 - 雨 浪 - 私 遗 - 欲 满 - 田 舍==蚕 老 麦 枯 田 舍 忙	谁 令 四 月 雨 浪 浪	未 容 乌 鸟 私 遗 粒	鸣 蚓 跳 蛙 欲 满 场
画 舫 - 行 脚 - 山 水 - 尽 在 - 画 舫==画 舫 篮 舆 不 许 前	白 头 行 脚 意 超 然	舜 江 禹 穴 千 山 水	尽 在 高 人 拄 杖 边
花 枝 - 芳 菲 - 梅 花 - 梅 满 - 花 枝==死 爱 花 枝 不 忍 吹	醉 来 恣 意 折 芳 菲	鬓 边 插 得 梅 花 满	更 捻 南 梅 满 把 皈
醉 眠 - 明 月 - 别 离 - 秋 风 - 醉 眠==东 越 相 逢 几 醉 眠	满 楼 明 月 镜 湖 边	别 离 吟 断 西 陵 渡	杨 柳 秋 风 两 岸 蝉
伤 心 - 怜 才 - 白 头 - 江 南 - 伤 心==故 国 伤 心 堕 劫 灰	流 离 北 土 却 怜 才	白 头 开 府 成 何 事	博 得 江 南 一 赋 哀
开 牖 - 春 长 - 种 豆 - 心 闲 - 云 开==凿 破 碧 云 开 牖 户	花 多 留 得 春 长 久	种 蔬 种 豆 了 生 涯	心 闲 只 与 琴 为 友
驼 峰 - 求 泉 - 江 水 - 蛟 龙 - 驼 峰==渴 乌 项 领 紫 驼 峰	跑 地 求 泉 鬣 上 冲	不 敢 牵 来 向 江 水	预 防 踊 跃 学 蛟 龙
岁 寒 - 西 风 - 多 少 - 烟 雨 - 岁 寒==天 上 飞 花 报 岁 寒	西 风 相 挟 引 栏 干	平 湖 不 认 花 多 少	只 作 寻 常 烟 雨 看
莲 塘 - 悠 悠 - 林 间 - 松 声 - 寂 寞==寂 寞 莲 塘 七 百 秋	溪 云 庭 月 两 悠 悠	我 来 欲 问 林 间 道	万 叠 松 声 自 唱 酬
依 依 - 青 丝 - 温 万 - 年 年 - 依 依==依 依 高 村 出 宫 墙	摇 曳 青 丝 百 尺 长	愿 与 宣 温 万 年 树	年 年 岁 岁 奉 君 王
鳞 鳞 - 出 没 - 客 船 - 落 日 - 鳞 鳞==沙 尾 鳞 鳞 水 退 潮	柳 行 出 没 见 渔 樵	客 船 自 载 钟 声 去	落 日 残 僧 立 寺 桥
聪 明 - 聪 明 - 惟 愿 - 公 卿 - 聪 明==人 皆 养 子 望 聪 明	我 被 聪 明 误 一 生	惟 愿 孩 儿 愚 且 鲁	无 灾 无 难 到 公 卿
方 寸 - 几 勋 - 丹 青 - 动 地 - 无 尘==方 寸 无 尘 眼 有 筋	如 他 图 了 几 勋 臣	更 烦 提 起 丹 青 手	写 出 惊 天 动 地 人
冬 冬 - 中 流 - 朝 日 - 春 山 - 冬 冬==急 鼓 冬 冬 下 泗 州	却 瞻 金 塔 在 中 流	帆 开 朝 日 初 生 处	船 转 春 山 欲 尽 头
游 人 - 楼 台 - 万 里 - 钱 塘 - 珍 重==珍 重 游 人 入 画 图	楼 台 绣 错 与 茵 铺	宋 家 万 里 中 原 土	博 得 钱 塘 十 顷 湖
何 处 - 雪 拥 - 数 回 - 西 风 - 何 处==未 知 何 处 是 真 梅	雪 拥 溪 桥 拨 不 开	莫 讶 行 人 数 回 首	西 风 十 里 送 香 来
葳 蕤 - 金 屋 - 传 来 - 主 家 - 葳 蕤==望 见 葳 蕤 举 翠 华	试 开 金 屋 扫 庭 花	须 臾 宫 女 传 来 信	言 幸 平 阳 公 主 家
世 味 - 到 头 - 和 羹 - 鼎 鼐 - 世 味==世 味 明 知 可 口 难	到 头 终 不 换 寒 酸	直 须 袖 却 和 羹 手	何 必 贪 居 鼎 鼐 间
日 影 - 小 窗 - 春 风 - 诗 思 - 日 影==饭 余 日 影 转 修 廊	欹 枕 桐 花 堕 小 窗	为 觅 春 风 洗 残 梦	要 令 诗 思 敌 澄 江
玉 簪 - 雪 月 - 一 醉 - 多 情 - 玉 簪==鲛 绡 剪 碎 玉 簪 轻	檀 晕 妆 成 雪 月 明	肯 伴 老 人 春 一 醉	悬 知 欲 落 更 多 情
双 凤 - 伤 心 - 花 暗 - 罗 裙 - 双 凤==压 髻 慵 簪 双 凤 钗	伤 心 羞 觑 合 欢 鞋	折 花 暗 卜 郎 音 信	旋 击 罗 裙 走 下 阶
松 风 - 铜 瓶 - 声 闻 - 春 雪 - 松 风==松 风 桧 雨 到 来 初	急 引 铜 瓶 离 竹 炉	待 得 声 闻 俱 寂 后	一 瓯 春 雪 胜 醍 醐
池 塘 - 杨 柳 - 春 风 - 看 花 - 池 塘==浅 碧 池 塘 连 路 口	淡 黄 杨 柳 护 檐 牙	旧 时 岁 岁 春 风 裹	长 见 君 王 出 看 花
孤 根 - 惜 花 - 清 绝 - 玉 更 - 孤 根==孤 根 应 得 暖 先 回	天 惜 花 房 遣 护 开	早 是 冰 肌 自 清 绝	却 因 冠 玉 更 奇 瑰
浮 萍 - 一 番 - 何 处 - 春 风 - 五 湖==踪 迹 浮 萍 落 五 湖	一 番 相 别 一 番 疏	不 知 此 去 从 何 处	还 许 春 风 得 见 无
江 城 - 西 风 - 声 远 - 秋 水 - 江 城==寂 寂 江 城 夜 向 阑	西 风 吹 雁 叫 云 端	一 声 远 过 南 楼 去	月 满 碧 天 秋 水 寒
薰 燃 - 粉 面 - 通 宵 - 露 滴 - 薰 燃==未 用 炉 薰 燃 笃 耨	何 须 粉 面 佐 娉 婷	通 宵 痛 饮 此 花 下	露 滴 杯 中 酒 更 醒
白 发 - 长 短 - 知 秋 - 寒 声 - 黄 花==黄 花 白 发 两 关 情	并 入 斋 房 长 短 更	久 客 自 知 秋 意 思	底 须 蛩 雨 做 寒 声
斜 阳 - 万 恨 - 头 抵 - 斜 阳 - 斜 阳==渠 与 斜 阳 有 底 雠	千 冤 万 恨 欣 清 秋	更 从 谁 子 做 头 抵	只 放 斜 阳 不 落 休
寻 芳 - 年 曾 - 狼 藉 - 绿 叶 - 寻 芳==自 恨 寻 芳 到 已 迟	往 年 曾 见 未 开 时	如 今 风 摆 花 狼 藉	绿 叶 成 阴 子 满 枝
黄 金 - 变 态 - 风 流 - 腊 后 - 白 璧==白 璧 黄 金 取 意 裁	极 知 变 态 自 江 梅	风 流 一 样 香 仍 好	共 趁 春 前 腊 后 开
三 月 - 不 知 - 杨 花 - 饶 轻 - 三 月==前 年 别 郎 三 月 暮	东 荡 西 飘 不 知 处	愿 弹 红 泪 湿 杨 花	总 饶 轻 荡 飞 难 去
荒 凉 - 夹 道 - 归 去 - 茅 檐 - 荒 凉==古 邑 荒 凉 但 有 松	浓 阴 夹 道 势 腾 空	行 人 破 暑 忙 归 去	未 必 茅 檐 有 此 风
寒 梅 - 深 红 - 道 人 - 花 开 - 寒 梅==东 群 意 浅 著 寒 梅	十 朵 深 红 未 暇 裁	安 得 道 人 殷 七 与	不 论 时 节 遣 花 开
清 明 - 春 事 - 梅 花 - 一 笛 - 寒 食==寒 食 清 明 数 日 中	西 园 春 事 又 忽 忽	梅 花 自 避 新 桃 李	不 为 高 楼 一 笛 风
春 雨 - 寒 生 - 纸 衾 - 山 城 - 雨 过==绿 树 阴 中 春 雨 过	乳 鸦 声 里 晓 寒 生	纸 衾 木 枕 清 如 水	暗 想 山 城 又 杀 更
有 无 - 烟 波 - 画 眉 - 春 山 - 诗 情==诗 情 画 意 有 无 间	如 此 烟 波 数 往 还	记 得 画 眉 声 里 过	一 船 青 载 富 春 山
幽 燕 - 此 时 - 今 朝 - 寒 衣 - 地 冷==幽 燕 地 冷 无 春 晖	此 时 道 归 郎 不 归	今 朝 朔 风 欺 远 客	又 还 无 处 寄 寒 衣
半 月 - 禁 烟 - 眯 目 - 名 花 - 半 月==谷 雨 赊 犹 半 月 期	禁 烟 花 事 已 纷 披	吏 尘 眯 目 春 余 几	却 被 名 花 唤 觅 诗
钓 竿 - 日 上 - 归 路 - 羊 裘 - 钓 竿==抛 却 渔 村 老 钓 竿	手 遮 西 日 上 长 安	青 衫 着 了 寻 归 路	莫 过 羊 裘 七 里 滩
生 还 - 北 海 - 神 仙 - 云 烟 - 生 还==汉 皇 亲 召 贾 生 还	京 路 争 看 北 海 贤	却 畏 神 仙 足 官 府	便 思 风 采 烁 云 烟
湖 上 - 美 人 - 浦 潮 - 淮 雪 - 湖 上==湖 上 轻 风 拂 柳 条	美 人 吹 笛 向 平 桥	欲 知 胥 浦 潮 初 退	正 是 秦 淮 雪 半 消
木 落 - 万 里 - 交 情 - 风 吹 - 落 雁==上 林 木 落 雁 南 飞	万 里 萧 条 使 节 归	犹 有 交 情 两 行 泪	西 风 吹 上 汉 臣 衣
白 浪 - 江 头 - 玉 京 - 杏 花 - 白 浪==白 浪 浮 江 打 白 沙	江 头 绿 竹 对 僧 家	春 风 也 似 玉 京 好	一 树 残 红 山 杏 花
神 女 - 青 山 - 云 雨 - 万 古 - 神 女==神 女 音 容 讵 可 求	青 山 回 抱 楚 宫 楼	朝 朝 暮 暮 空 云 雨	不 尽 襄 王 万 古 愁
麒 麟 - 富 贵 - 寒 食 - 骑 马 - 麒 麟==草 埋 苔 染 石 麒 麟	曾 是 何 年 富 贵 人	雨 打 梨 花 寒 食 近	王 孙 骑 马 自 游 春
珠 帘 - 云 开 - 东 君 - 日 照 - 珠 帘==风 卷 珠 帘 挂 玉 钩	采 云 开 处 望 仙 俦	妍 姿 不 逐 东 君 去	日 照 斜 晖 上 小 楼
五 重 - 今 朝 - 苏 杭 - 一 番 - 重 阳==算 来 七 十 五 重 阳	无 酒 今 朝 对 菊 黄	记 得 苏 杭 船 上 坐	一 番 醒 眼 咏 诗 章
公 卿 - 公 卿 - 争 利 - 醉 时 - 公 卿==宁 开 白 眼 视 公 卿	不 要 公 卿 眼 借 青	争 利 争 名 醒 处 看	读 诗 读 礼 醉 时 听
漫 漫 - 一 团 - 今 宵 - 凭 栏 - 漫 漫==年 头 半 月 雪 漫 漫	养 就 嫦 娥 玉 一 团	老 子 今 宵 奇 绝 处	西 陵 桥 上 独 凭 栏
消 息 - 寂 寥 - 角 巾 - 残 菊 - 兴 近==柳 吴 兴 近 无 消 息	张 长 公 贫 苦 寂 寥	唯 有 角 巾 沾 雨 至	手 持 残 菊 向 西 招
云 气 - 风 冷 - 青 山 - 幽 鸟 - 成 林==松 竹 成 林 云 气 深	洞 门 风 冷 绿 苔 阴	落 花 飞 尽 青 山 在	幽 鸟 声 中 野 客 心
天 晓 - 苍 苍 - 初 日 - 千 丈 - 朝 天==夜 上 朝 天 晓 不 极	举 头 唯 见 苍 苍 色	回 看 初 日 半 轮 明	下 视 嘉 陵 千 丈 黑
作 花 - 邯 郸 - 麈 尾 - 灯 光 - 作 花==槐 催 举 子 作 花 黄	来 食 邯 郸 道 上 粱	便 欲 扫 床 悬 麈 尾	正 愁 喘 月 似 灯 光
云 林 - 银 丝 - 浮 杯 - 棠 阴 - 云 林==石 休 久 矣 卧 云 林	六 十 银 丝 两 鬓 侵	海 上 浮 杯 心 已 息	掬 溪 容 我 窃 棠 阴
清 明 - 上 苑 - 纸 钱 - 又 随 - 清 明==长 春 门 里 清 明 日	上 苑 兰 风 花 鸟 繁	焚 却 纸 钱 啼 泣 罢	又 随 龙 辇 向 西 园
风 翻 - 舟 子 - 金 鳞 - 龙 门 - 北 风==北 风 翻 雪 鼓 雷 霆	舟 子 停 兰 亦 断 魂	看 我 金 鳞 三 十 六	为 君 一 跃 上 龙 门
遗 迹 - 满 县 - 居 显 - 甘 棠 - 遗 迹==江 东 遗 迹 在 钱 塘	手 植 庭 花 满 县 香	若 使 当 年 居 显 位	海 棠 今 日 是 甘 棠
江 南 - 空 庐 - 公 卿 - 衣 冠 - 江 南==江 南 浪 子 是 何 官	只 当 空 庐 杂 剧 看	拨 取 公 卿 如 粪 土	沐 猴 徒 自 辱 衣 冠
诗 人 - 东 风 - 山 水 - 甘 棠 - 诗 人==长 恨 诗 人 挽 不 来	东 风 无 赖 又 帆 开	城 南 城 北 佳 山 水	多 少 甘 棠 手 自 栽
乐 天 - 朱 弦 - 春 酒 - 啼 鸟 - 乐 天==老 去 风 情 似 乐 天	恨 无 张 态 抹 朱 弦	一 春 酒 病 稀 游 赏	啼 鸟 莺 花 共 怅 然
紫 芽 - 寻 芳 - 蜂 未 - 梅 花 - 紫 芽==紫 芽 红 甲 爆 春 枝	幽 步 寻 芳 款 款 移	蜂 未 出 房 寒 尚 在	梅 花 开 遍 不 曾 知
江 天 - 连 山 - 重 阳 - 一 枝 - 天 外==汉 江 天 外 东 流 去	巴 塞 连 山 万 里 秋	节 过 重 阳 人 病 起	一 枝 残 菊 不 胜 愁
绿 鬓 - 金 樽 - 日 对 - 春 愁 - 绿 鬓==华 省 当 时 绿 鬓 郎	金 樽 美 酒 醉 红 芳	今 日 对 花 不 成 饮	春 愁 已 与 草 俱 长
琢 玉 - 玲 珑 - 琢 成 - 声 闻 - 琢 玉==知 是 禅 师 琢 玉 工	玉 声 犹 作 水 玲 珑	琢 成 大 士 笑 无 语	只 在 声 闻 一 悟 中
金 天 - 纷 纷 - 纸 钱 - 恩 福 - 金 天==金 天 庙 下 西 京 道	巫 女 纷 纷 走 似 烟	手 把 纸 钱 迎 过 客	遣 求 恩 福 到 神 前
三 尺 - 诙 谐 - 明 月 - 一 笑 - 三 尺==三 尺 生 绡 作 戏 台	全 凭 十 指 逞 诙 谐	有 时 明 月 灯 窗 下	一 笑 还 从 掌 握 来
玉 兔 - 三 更 - 一 片 - 水 精 - 玉 兔==银 轮 玉 兔 向 东 流	莹 净 三 更 正 好 游	一 片 黑 云 何 处 起	皂 罗 笼 却 水 精 球
梧 桐 - 露 气 - 两 行 - 何 处 - 桐 叶==梧 桐 叶 底 见 银 河	露 气 当 窗 冷 碧 罗	四 壁 虫 声 两 行 雁	不 知 何 处 得 秋 多
一 声 - 万 里 - 马 上 - 琵 琶 - 一 声==一 声 望 帝 花 片 飞	万 里 明 妃 雪 打 围	马 上 胡 儿 那 解 听	琵 琶 应 道 不 如 归
古 今 - 松 下 - 蟠 桃 - 结 子 - 古 今==古 今 冠 佩 立 朝 人	多 作 北 山 松 下 尘	我 爱 蟠 桃 种 来 久	开 花 结 子 不 由 春
五 湖 - 小 乔 - 功 名 - 妖 娆 - 五 湖==五 湖 范 蠡 携 西 子	三 国 周 郎 嫁 小 乔	盖 世 功 名 聊 唾 手	何 妨 樽 酒 醉 妖 娆
秘 阁 - 露 华 - 绿 窗 - 第 一 - 秘 阁==清 晓 朝 回 秘 阁 中	坐 看 宫 树 露 华 浓	绿 窗 朱 户 图 书 满	人 在 蓬 莱 第 一 峰
篮 舆 - 危 峰 - 亭 前 - 天 上 - 屈 曲==篮 舆 屈 曲 上 中 岩	峻 壁 危 峰 面 面 山	心 月 亭 前 何 世 界	不 知 天 上 与 人 间
吹 雨 - 江 梅 - 山 石 - 冷 落 - 风 吹==朔 风 吹 雨 正 尘 埃	忽 见 江 梅 驿 使 来	忆 著 家 山 石 桥 畔	一 枝 冷 落 为 谁 开
小 楼 - 楼 中 - 青 竹 - 客 愁 - 西 风==淅 淅 西 风 入 小 楼	楼 中 听 彻 玉 笙 秋	不 妨 青 竹 摇 残 梦	甚 怯 新 凉 搅 客 愁
山 中 - 山 中 - 天 机 - 几 行 - 山 中==辜 负 山 中 月 与 风	心 无 城 市 亦 山 中	应 嫌 猿 鹤 天 机 浅	要 与 几 行 不 肯 同
盘 空 - 石 泉 - 江 上 - 水 云 - 盘 空==盘 空 势 险 露 岩 根	深 洞 声 寒 落 石 泉	好 是 雨 馀 江 上 见	水 云 僧 出 认 西 天
五 更 - 堂 前 - 鹦 鹉 - 牡 丹 - 五 更==五 更 窗 下 簇 妆 台	已 怕 堂 前 阿 母 催	满 鸭 香 薰 鹦 鹉 睡	隔 帘 灯 照 牡 丹 开
琅 函 - 飞 空 - 归 去 - 月 落 - 琅 函==丹 书 玉 札 隐 琅 函	云 几 飞 空 鹤 几 骖	告 别 门 人 归 去 后	夜 来 素 月 落 寒 潭
秋 思 - 清 声 - 无 人 - 高 低 - 秋 思==信 意 闲 弹 秋 思 时	调 清 声 直 韵 疏 迟	近 来 渐 喜 无 人 听	琴 格 高 低 心 自 知
画 角 - 霜 花 - 最 怜 - 第 一 - 画 角==画 角 声 中 放 早 牙	弓 开 弦 月 剑 霜 花	最 怜 怒 臂 岑 牟 吏	特 试 渔 阳 第 一 挝
碧 桃 - 绰 约 - 春 去 - 蓝 桥 - 小 寒==碧 桃 花 底 小 寒 轻	绰 约 仙 姿 格 外 清	锦 绣 卷 还 春 去 了	蓝 桥 风 露 放 云 英
酒 楼 - 一 曲 - 一 醉 - 谪 仙 - 酒 楼==长 安 酒 楼 歌 管 新	一 曲 乌 栖 泣 鬼 神	狂 客 解 龟 同 一 醉	人 人 知 是 谪 仙 人
杉 松 - 江 水 - 凭 阑 - 远 山 - 萧 飒==庙 里 杉 松 萧 飒 风	庙 前 江 水 碧 溶 溶	凭 阑 不 见 当 时 事	落 日 远 山 千 万 重
扬 州 - 按 剑 - 见 解 - 门 前 - 扬 州==扬 州 昨 夜 有 人 来	误 把 忠 良 按 剑 猜	怪 道 使 君 无 见 解	城 门 前 日 不 应 开
杨 花 - 闻 道 - 明 月 - 随 风 - 花 落==杨 花 落 尽 子 规 啼	闻 道 龙 标 过 五 溪	我 寄 愁 心 与 明 月	随 风 直 到 夜 郎 西
瞿 塘 - 连 云 - 相 连 - 乡 信 - 瞿 塘==瞿 塘 三 峡 山 波 险	栈 阁 连 云 行 路 难	烽 众 相 连 兵 刃 接	一 封 乡 信 报 平 安
春 阴 - 禽 语 - 一 缕 - 深 院 - 春 阴==春 阴 只 与 睡 相 宜	卧 听 鸣 禽 语 复 飞	一 缕 断 香 浮 不 散	何 人 深 院 昼 熏 衣
绿 阴 - 历 历 - 千 古 - 憔 悴 - 清 韵==绿 阴 清 韵 竹 萧 然	历 历 当 年 泣 泪 痕	千 古 舜 妃 湘 水 底	必 应 憔 悴 有 惭 魂
何 处 - 一 杯 - 不 语 - 零 落 - 春 光==春 光 冉 冉 归 何 处	更 向 花 前 把 一 杯	尽 日 问 花 花 不 语	为 谁 零 落 为 谁 开
春 寒 - 东 风 - 梅 花 - 诗 情 - 春 寒==小 院 春 寒 闭 寂 寥	东 风 吹 雪 未 全 消	山 茶 谢 了 梅 花 落	移 得 诗 情 上 柳 条
照 水 - 泽 国 - 朱 颜 - 昨 夜 - 枝 枝==照 水 枝 枝 蜀 锦 囊	年 年 泽 国 为 谁 芳	朱 颜 自 得 西 风 意	不 管 清 秋 昨 夜 霜
意 凄 - 梦 断 - 彩 旗 - 秋 千 - 看 镜==北 窗 看 镜 意 凄 然	梦 断 梁 州 已 七 年	猎 猎 彩 旗 春 日 晚	不 堪 花 外 见 秋 千
物 华 - 风 前 - 残 红 - 万 家 - 物 华==投 老 殷 勤 向 物 华	风 前 犹 欲 拾 余 花	更 将 梦 逐 残 红 去	遍 入 长 安 百 万 家
州 博 - 乘 槎 - 玉 骨 - 马 乳 - 州 博==凉 州 博 酒 不 胜 痴	银 汉 乘 槎 领 得 归	玉 骨 瘦 来 无 一 把	向 来 马 乳 太 轻 肥
承 恩 - 为 怜 - 书 名 - 近 御 - 承 恩==一 自 承 恩 入 建 章	为 怜 妾 貌 侍 君 王	殿 头 自 此 书 名 字	日 日 联 班 近 御 床
功 名 - 通 津 - 一 枝 - 英 雄 - 功 名==三 十 功 名 志 未 伸	初 将 文 字 竞 通 津	春 风 漫 折 一 枝 桂	烟 阁 英 雄 笑 杀 人
浪 翻 - 武 陵 - 归 来 - 残 花 - 万 点==万 点 红 随 雪 浪 翻	恍 疑 身 到 武 陵 源	归 来 上 界 多 官 府	人 与 残 花 两 不 言
南 柯 - 东 陵 - 今 朝 - 酒 楼 - 南 柯==梦 里 曾 作 南 柯 守	少 时 元 是 东 陵 侯	今 朝 半 醉 归 草 市	指 点 青 帘 上 酒 楼
中 秋 - 清 光 - 枕 上 - 强 作 - 中 秋==中 秋 有 约 醉 南 湖	料 此 清 光 已 不 孤	枕 上 不 堪 良 夜 永	起 来 犹 强 作 伊 吾
四 海 - 森 森 - 悲 风 - 世 中 - 四 海==四 海 瞻 依 一 伟 人	丘 封 页 页 木 森 森	仰 天 恸 哭 悲 风 起	举 世 中 和 孰 嗣 音
月 色 - 有 无 - 春 光 - 不 恨 - 月 色==素 艳 遥 怜 月 色 同	暗 香 披 拂 有 无 中	一 枝 已 觉 春 光 破	不 恨 南 邻 笛 里 风
傍 山 - 令 威 - 多 少 - 诗 成 - 傍 山==竹 映 高 墙 似 傍 山	邹 阳 归 后 令 威 还	君 看 将 相 才 多 少	两 首 诗 成 七 步 间
致 仕 - 出 家 - 沧 海 - 一 杯 - 致 仕==我 致 仕 年 死 期 近	汝 出 家 时 生 理 难	沧 海 桑 田 何 可 料	一 杯 别 酒 莫 留 残
客 路 - 发 春 - 月 底 - 烟 霞 - 客 路==厌 余 客 路 忽 思 家	鬓 发 春 饶 尽 雪 华	月 底 路 歧 通 著 脚	归 心 未 稳 隔 烟 霞
明 珠 - 一 家 - 山 纵 - 双 飞 - 明 珠==何 必 明 珠 十 斛 偿	一 家 八 口 托 檀 郎	唐 山 纵 有 西 归 日	不 肯 双 飞 过 墨 洋
秋 风 - 数 声 - 残 暑 - 瑶 池 - 秋 风==一 宿 秋 风 未 觉 凉	数 声 宫 漏 日 犹 长	林 泉 无 计 消 残 暑	虚 向 瑶 池 费 稻 梁
何 代 - 细 髯 - 乾 雾 - 风 雨 - 何 代==何 代 奇 工 碾 玉 英	细 髯 纤 角 尽 雕 成	烟 乾 雾 悄 君 心 苦	风 雨 长 随 一 掷 声
十 年 - 风 烟 - 今 朝 - 落 木 - 十 年==别 却 铜 山 三 十 年	因 师 长 忆 旧 风 烟	今 朝 忽 送 东 归 客	正 是 秋 江 落 木 前
野 店 - 典 衣 - 杨 花 - 随 风 - 野 店==山 桥 野 店 酒 盈 卮	拄 杖 无 钱 欲 典 衣	日 暮 杨 花 太 无 绪	随 风 却 自 渡 江 飞
堂 堂 - 无 人 - 云 破 - 万 丈 - 堂 堂==有 客 堂 堂 空 两 手	无 人 为 借 太 阿 来	与 君 上 抉 浮 云 破	放 出 阳 光 万 丈 开
红 衣 - 折 来 - 零 落 - 秋 风 - 绿 房==落 尽 红 衣 见 绿 房	折 来 犹 带 水 云 香	柔 丝 零 落 芳 心 苦	未 及 秋 风 已 断 肠
窗 外 - 看 书 - 茅 店 - 御 寒 - 窗 外==风 号 窗 外 独 株 松	想 汝 看 书 趁 晓 钟	是 我 起 行 茅 店 月	御 寒 还 觉 欠 茏 茸
高 低 - 无 心 - 处 相 - 危 栏 - 高 低==舒 卷 高 低 晴 复 阴	澹 然 无 滓 亦 无 心	不 知 底 处 相 齐 得	且 倚 危 栏 一 散 襟
憔 悴 - 力 微 - 落 花 - 催 归 - 憔 悴==佳 人 憔 悴 怯 春 衣	日 暮 楼 高 酒 力 微	流 水 落 花 无 限 恨	一 声 杜 宇 又 催 归
疏 雨 - 舟 子 - 青 青 - 江 上 - 孤 蓬==萧 萧 疏 雨 点 孤 蓬	舟 子 招 呼 语 顺 风	小 麦 青 青 春 恰 半	一 犁 江 上 看 田 翁
宝 攒 - 昆 池 - 珊 瑚 - 珠 玑 - 山 夜==环 宝 攒 山 夜 陆 离	主 家 新 凿 定 昆 池	珊 瑚 未 大 诸 韦 死	多 少 珠 玑 向 月 悲
繁 华 - 垂 老 - 檀 板 - 一 曲 - 繁 华==辇 毂 繁 华 事 可 伤	师 师 垂 老 过 湖 湘	缕 衣 檀 板 无 颜 色	一 曲 当 时 动 帝 王
暮 云 - 乔 木 - 去 路 - 画 船 - 暮 云==层 峦 稍 稍 暮 云 归	乔 木 森 森 众 鸟 依	再 踏 石 花 寻 去 路	画 船 十 只 带 斜 晖
桃 李 - 江 山 - 看 花 - 看 花 - 高 低==几 家 桃 李 高 低 树	一 望 江 山 表 里 春	寂 寞 无 心 看 花 去	悬 知 自 有 看 花 人
沦 落 - 得 一 - 岭 头 - 他 谁 - 沦 落==江 西 诗 社 久 沦 落	晚 得 一 人 刘 改 之	不 向 岭 头 拈 取 去	此 衣 此 钵 付 他 谁
着 物 - 花 梢 - 春 思 - 一 枝 - 无 私==东 风 着 物 本 无 私	红 入 花 梢 特 地 奇	想 得 霜 台 春 思 满	一 枝 聊 遣 博 新 诗
十 月 - 微 阳 - 溪 上 - 娇 愁 - 牡 丹==牡 丹 十 月 发 春 丛	半 倚 微 阳 半 怯 风	浑 似 若 耶 溪 上 女	娇 愁 初 入 馆 娃 宫
饮 马 - 仙 姿 - 金 经 - 未 数 - 饮 马==饮 马 池 边 号 浴 仙	仙 姿 化 鹤 古 今 传	金 经 尤 有 延 年 诀	未 数 庄 椿 寿 八 千
气 寒 - 独 坐 - 淋 漓 - 英 雄 - 气 寒==霜 白 天 空 夜 气 寒	灯 残 独 坐 检 书 看	淋 漓 读 到 淮 阴 传	却 笑 英 雄 一 饭 难
烟 树 - 我 来 - 九 曲 - 年 年 - 烟 树==花 满 晴 烟 树 满 云	我 来 宁 是 学 仙 人	愿 将 九 曲 溪 头 水	散 作 年 年 百 里 春
千 顷 - 沧 江 - 羽 翼 - 沙 鸟 - 千 顷==乱 山 千 顷 翠 相 围	衮 衮 沧 江 去 复 归	安 得 病 身 生 羽 翼	长 随 沙 鸟 自 由 飞
潇 湘 - 飘 零 - 幽 寂 - 闭 户 - 潇 湘==我 住 潇 湘 狱 自 清	囚 衫 虫 蠹 雨 飘 零	如 今 三 院 更 幽 寂	闭 户 勘 书 花 满 厅
东 君 - 一 梦 - 梅 子 - 送 春 - 东 君==东 君 不 解 惜 芳 菲	料 峭 寒 中 一 梦 非	剪 尽 牡 丹 梅 子 绽	何 须 风 雨 送 春 归
花 开 - 绿 苔 - 有 香 - 明 年 - 花 开==雪 中 独 爱 此 花 开	莫 笑 花 飞 委 绿 苔	骨 里 有 香 吹 不 散	明 年 依 旧 领 春 回
龙 媒 - 能 空 - 神 骏 - 青 云 - 龙 媒==龙 媒 要 是 龙 眠 笑	意 在 能 空 冀 并 群	老 我 惟 知 赏 神 骏	何 时 变 化 上 青 云
雪 月 - 谈 锋 - 犹 言 - 何 处 - 雪 月==溪 山 雪 月 两 佳 哉	宾 主 谈 锋 夜 转 雷	犹 言 不 见 戴 安 道	为 问 适 从 何 处 来
雁 塔 - 名 誉 - 归 来 - 未 见 - 蟾 宫==雁 塔 蟾 宫 尽 假 途	要 须 行 实 副 名 誉	六 经 堂 上 归 来 日	饱 读 平 生 未 见 书
菜 花 - 日 长 - 犬 吠 - 有 行 - 蝴 蝶==蝴 蝶 双 双 入 菜 花	日 长 无 客 到 田 家	鸡 飞 过 篱 犬 吠 窦	知 有 行 商 来 买 茶
长 江 - 中 流 - 直 下 - 起 风 - 万 里==长 江 万 里 涌 金 鳌	屹 立 中 流 气 势 豪	直 下 放 教 根 脚 稳	任 教 八 面 起 风 涛
弱 柳 - 江 南 - 风 日 - 新 诗 - 溪 头==溪 头 弱 柳 已 丝 垂	那 得 江 南 尚 好 枝	从 此 春 风 日 亡 赖	与 须 排 写 付 新 诗
成 群 - 湖 分 - 江 南 - 人 生 - 成 群==山 从 天 目 成 群 出	水 傍 太 湖 分 港 流	行 遍 江 南 清 丽 地	人 生 只 合 住 湖 州
鬓 霜 - 浊 酒 - 步 步 - 归 家 - 鬓 霜==田 库 翁 翁 两 鬓 霜	苦 贫 浊 酒 弄 觥 觞	儿 孙 步 步 相 随 逐	扶 得 归 家 又 发 狂
雨 洗 - 凌 波 - 相 倚 - 一 人 - 雨 洗==雨 洗 风 梳 两 斗 新	凌 波 微 步 袜 生 尘	真 成 红 玉 娇 相 倚	不 减 昭 阳 第 一 人
悠 悠 - 参 差 - 秋 风 - 蜘 蛛 - 悠 悠==万 事 悠 悠 心 自 知	强 颜 於 世 转 参 差	移 床 独 卧 秋 风 里	静 看 蜘 蛛 结 网 丝
数 声 - 月 满 - 胡 床 - 花 阴 - 一 声==一 声 远 笛 数 声 砧	月 满 江 城 夜 正 深	坐 据 胡 床 爱 凉 思	空 阶 移 尽 桂 花 阴
月 满 - 梦 回 - 鸡 犬 - 谁 家 - 月 满==露 气 侵 衣 月 满 船	梦 回 依 约 五 更 天	枕 间 听 得 鸣 鸡 犬	知 在 谁 家 村 上 眠
松 竹 - 一 声 - 道 人 - 清 风 - 松 竹==松 竹 回 环 十 里 阴	一 声 啼 鸟 觉 山 深	道 人 睡 足 北 窗 下	一 榻 清 风 直 万 金
甘 棠 - 泊 无 - 太 守 - 霜 威 - 甘 棠==自 惭 政 迹 少 甘 棠	澹 泊 无 为 耻 见 长	寄 语 东 宁 贤 太 守	霜 威 到 底 逊 春 阳
刹 土 - 无 量 - 一 身 - 体 合 - 一 尘==一 尘 具 无 量 刹 土	一 念 超 无 量 劫 数	一 身 现 无 量 众 生	一 体 合 无 量 诸 佛
短 长 - 竹 绝 - 秋 色 - 万 亩 - 短 长==三 向 稚 松 争 短 长	西 偏 老 竹 绝 炎 凉	千 寻 以 上 有 秋 色	万 亩 之 间 无 夕 阳
孤 城 - 居 人 - 蜂 游 - 夜 长 - 面 面==江 上 孤 城 面 面 山	居 人 也 自 不 曾 闲	蜂 游 蚁 聚 知 何 事	日 夜 长 桥 南 北 间
青 崖 - 交 加 - 阶 砌 - 风 雨 - 亭 前==小 亭 前 面 接 青 崖	白 石 交 加 衬 绿 苔	日 暮 松 声 满 阶 砌	不 关 风 雨 鹤 归 来
故 人 - 垂 老 - 白 发 - 青 山 - 故 人==时 时 闻 说 故 人 死	日 日 自 悲 垂 老 身	白 发 不 生 应 不 得	青 山 长 在 属 何 人
扬 州 - 渡 江 - 长 沙 - 隋 堤 - 扬 州==莫 问 扬 州 桃 叶 生	渡 江 今 日 得 风 晴	长 沙 子 弟 更 相 笑	上 到 隋 堤 便 住 营
阶 前 - 龙 孙 - 烟 梢 - 畏 风 - 阶 前==阶 前 紫 玉 似 人 长	可 怪 龙 孙 久 未 骧	第 放 烟 梢 出 檐 去	此 君 初 不 畏 风 霜
更 阑 - 金 钿 - 丝 眠 - 悲 笳 - 更 阑==更 阑 炙 烛 绣 檐 遮	卸 却 金 钿 与 翠 花	心 似 乱 丝 眠 不 得	江 楼 中 夜 咽 悲 笳
归 来 - 杖 藜 - 数 点 - 烂 熳 - 客 路==客 路 归 来 芳 节 阑	杖 藜 随 处 小 盘 桓	危 红 数 点 藏 深 绿	须 作 春 风 烂 熳 看
闲 云 - 登 临 - 一 声 - 满 地 - 闲 云==天 约 闲 云 结 嫩 阴	苦 无 诗 酒 懒 登 临	一 声 鸡 唱 日 初 午	满 地 花 寒 秋 已 深
火 齐 - 流 涎 - 三 年 - 披 云 - 火 齐==火 齐 无 光 荔 实 圆	未 觉 先 说 齿 流 涎	唤 回 天 竺 三 年 梦	参 透 披 云 一 味 禅
天 涯 - 金 粟 - 兰 亭 - 谁 家 - 天 涯==昭 陵 玉 匣 走 天 涯	金 粟 堆 前 几 吠 鸦	水 到 兰 亭 转 鸣 咽	不 知 真 帖 落 谁 家
酒 旗 - 桃 花 - 浮 沉 - 无 家 - 山 行==山 行 喜 遇 酒 旗 斜	无 限 桃 花 续 杏 花	与 世 浮 沉 真 避 世	将 家 漂 荡 似 无 家
空 虚 - 幽 人 - 幽 人 - 承 露 - 净 室==窗 明 几 净 室 空 虚	尽 道 幽 人 一 事 无	莫 道 幽 人 无 一 事	汲 泉 承 露 养 菖 蒲
花 萼 - 千 秋 - 倾 城 - 解 愁 - 花 萼==八 月 平 时 花 萼 楼	万 方 同 乐 奏 千 秋	倾 城 人 看 长 竿 出	一 伎 初 成 赵 解 愁
玉 人 - 茅 结 - 山 川 - 分 未 - 玉 人==龙 瑞 宫 中 种 玉 人	诛 茅 结 室 傍 秋 云	自 言 洞 里 山 川 别	此 处 千 分 未 一 分
龙 文 - 挥 毫 - 三 千 - 诗 坛 - 龙 文==百 斛 龙 文 鼎 可 扛	挥 毫 曾 寄 碧 油 幢	酒 兵 若 有 三 千 崎	肯 向 诗 坛 筑 受 降
无 价 - 平 池 - 客 帆 - 花 村 - 无 价==雨 开 繁 菊 金 无 价	风 皱 平 池 鉴 有 痕	日 暮 客 帆 何 处 落	柿 林 西 畔 荻 花 村
壮 心 - 云 深 - 因 风 - 英 雄 - 壮 心==兵 甲 初 消 老 壮 心	草 堂 孤 坐 水 云 深	忽 因 风 木 萧 萧 起	翻 有 英 雄 泪 满 襟
争 放 - 影 清 - 公 子 - 人 同 - 争 放==金 飚 争 放 木 夫 容	蘸 影 清 波 分 外 红	玉 立 前 庭 一 公 子	丰 禁 不 与 欲 人 同
对 酒 - 喜 荐 - 诗 思 - 江 头 - 对 酒==对 酒 应 从 暮 吹 号	酒 行 还 喜 荐 溪 毛	若 将 物 象 评 诗 思	须 向 江 头 看 怒 涛
孤 芳 - 东 风 - 蝶 乱 - 春 寒 - 孤 芳==孤 芳 未 分 落 人 间	故 向 东 风 小 作 难	眼 底 莫 容 蜂 蝶 乱	好 留 明 月 趁 春 寒
东 西 - 烹 茶 - 二 百 - 摩 挲 - 东 西==听 钟 吃 饭 东 西 寺	就 水 烹 茶 上 下 池	二 百 年 来 陈 迹 在	摩 挲 苔 藓 日 西 时
四 围 - 一 枕 - 雨 过 - 瀑 声 - 四 围==四 围 绿 树 岩 藏 屋	一 枕 清 风 竹 满 轩	醉 里 不 知 山 雨 过	醒 来 惟 怪 瀑 声 喧
乐 天 - 云 川 - 天 高 - 百 年 - 乐 天==忧 世 心 衰 且 乐 天	不 妨 飞 咏 此 云 川	天 高 地 下 有 千 载	物 换 人 非 无 百 年
龙 盘 - 从 龙 - 雨 须 - 膏 雨 - 龙 盘==龙 盘 往 昔 名 钟 山	云 起 从 龙 意 自 闲	肤 雨 须 臾 成 戴 帽	坐 看 膏 雨 满 人 间
扁 舟 - 孤 帆 - 一 雨 - 山 中 - 西 东==扁 舟 拍 浪 信 西 东	何 处 孤 帆 万 里 风	一 雨 快 晴 云 放 树	两 山 中 断 水 粘 空
花 开 - 醉 客 - 夜 深 - 断 肠 - 花 开==秋 风 里 许 杏 花 开	杏 树 傍 边 醉 客 来	共 待 夜 深 听 一 曲	醒 人 骑 马 断 肠 回
洛 阳 - 门 前 - 逢 树 - 年 此 - 洛 阳==洛 阳 堰 上 新 晴 日	长 夏 门 前 欲 暮 春	遇 酒 即 沽 逢 树 歇	七 年 此 地 作 闲 人
雨 过 - 风 吹 - 寂 寞 - 楚 水 - 楼 台==雨 过 楼 台 已 禁 烟	野 风 吹 絮 满 长 安	夜 来 寂 寞 沙 汀 下	楚 水 吴 云 一 样 看
琼 楼 - 家 比 - 落 日 - 荷 花 - 琼 楼==琼 楼 金 屋 映 丹 霞	只 把 仙 家 比 内 家	落 日 美 人 秋 水 上	红 妆 一 面 乱 荷 花
江 城 - 春 风 - 梅 花 - 朱 栏 - 衣 单==江 城 二 月 客 衣 单	况 是 春 风 十 日 寒	东 国 梅 花 吹 欲 尽	不 须 横 笛 倚 朱 栏
东 山 - 飞 仙 - 春 昼 - 韩 子 - 东 山==泸 江 东 山 山 更 奇	骑 鲸 飞 仙 归 未 归	桃 花 千 树 烂 春 昼	莫 作 韩 子 荒 唐 讥
撩 乱 - 恨 别 - 明 月 - 断 肠 - 燕 歌==燕 歌 撩 乱 夜 弦 鸣	诉 尽 青 楼 恨 别 情	四 十 年 前 明 月 夜	梦 回 曾 听 断 肠 声
一 字 - 到 处 - 石 上 - 面 壁 - 岭 初==葱 岭 初 无 一 字 传	名 山 到 处 即 为 禅	只 今 石 上 留 公 案	面 壁 何 须 更 九 年
太 守 - 阳 春 - 樽 前 - 雕 琢 - 太 守==要 知 太 守 怜 孤 客	不 惜 阳 春 和 俚 歌	坐 睡 樽 前 呼 不 应	为 公 雕 琢 损 天 和
攻 击 - 手 谈 - 风 味 - 笑 语 - 攻 击==攻 击 愁 城 从 事 里	消 磨 日 月 手 谈 中	不 缘 我 辈 真 风 味	安 得 尊 前 笑 语 同
不 言 - 富 贵 - 天 下 - 鱼 矶 - 不 言==古 风 萧 索 不 言 归	贫 贱 交 情 富 贵 非	世 祖 本 无 天 下 量	子 陵 何 慕 钓 鱼 矶
春 风 - 百 花 - 塍 晓 - 处 处 - 春 风==今 岁 春 风 特 地 寒	百 花 无 赖 已 摧 残	马 塍 晓 雨 如 尘 细	处 处 筠 篮 卖 牡 丹
径 斜 - 烟 霞 - 流 水 - 丁 和 - 石 径==步 入 罗 湖 石 径 斜	阴 阴 乔 木 锁 烟 霞	小 桥 流 水 君 须 记	便 是 丁 和 处 士 家
今 朝 - 消 息 - 衲 益 - 畔 出 - 今 朝==今 朝 又 是 四 月 一	那 事 全 然 没 消 息	衲 益 皮 草 久 不 乾	且 喜 日 头 东 畔 出
春 山 - 芳 草 - 离 愁 - 相 思 - 春 山==悠 悠 信 马 春 山 曲	芳 草 和 烟 铺 嫩 绿	正 被 离 愁 着 莫 人	那 堪 更 过 相 思 谷
春 睡 - 叶 底 - 朱 栏 - 风 帘 - 春 睡==春 力 着 人 春 睡 重	叶 底 黄 鹂 鸣 自 送	绿 暮 朱 栏 日 观 明	回 廊 侧 户 风 帘 动
苔 痕 - 觥 筹 - 太 史 - 鸥 闽 - 苔 痕==联 翩 屐 齿 破 苔 痕	醉 裹 觥 筹 不 计 陈	来 日 不 须 关 太 史	五 星 今 返 聚 鸥 闽
去 时 - 残 花 - 情 深 - 莫 相 - 芍 药==去 时 芍 药 才 堪 赠	看 却 残 花 已 度 春	只 为 情 深 偏 怆 别	等 闲 相 见 莫 相 亲
剪 裁 - 楚 帆 - 清 江 - 县 令 - 剪 裁==花 落 春 衫 试 剪 裁	石 头 城 下 楚 帆 开	凭 谁 为 报 清 江 吏	麦 雉 鸣 时 县 令 来
碧 落 - 月 光 - 一 群 - 石 坛 - 碧 落==紫 府 空 歌 碧 落 寒	晓 星 寥 亮 月 光 残	一 群 白 鹤 高 飞 上	唯 有 松 风 吹 石 坛
阁 上 - 荷 叶 - 风 生 - 芙 蓉 - 阁 上==高 池 高 阁 上 连 起	荷 叶 团 团 盖 秋 水	主 人 已 远 凉 风 生	旧 客 不 来 芙 蓉 死
杳 杳 - 夕 阳 - 纷 纷 - 竹 叶 - 羊 车==杳 杳 羊 车 转 掖 庭	夕 阳 亭 上 北 风 腥	纷 纷 羔 膻 趋 河 洛	为 见 深 宫 竹 叶 青
花 繁 - 余 香 - 数 声 - 半 山 - 桑 条==桑 条 索 漠 栋 花 繁	风 敛 余 香 暗 度 垣	黄 鸟 数 声 残 午 梦	尚 疑 身 属 半 山 园
百 年 - 晓 来 - 庭 前 - 十 行 - 百 年==千 百 年 来 汉 老 郎	晓 来 灯 火 晚 来 香	庭 前 不 用 寻 碑 记	已 载 班 书 数 十 行
绝 代 - 倾 国 - 冰 雪 - 朱 粉 - 绝 代==西 北 佳 人 绝 代 姿	倾 城 倾 国 未 为 奇	自 然 冰 雪 生 颜 色	不 用 人 间 朱 粉 施
叠 嶂 - 王 姓 - 两 奇 - 玉 堂 - 叠 嶂==烟 江 叠 嶂 子 能 学	都 尉 后 身 王 姓 同	诗 画 惊 逢 两 奇 丽	赏 音 吾 愧 玉 堂 翁
垂 柳 - 柳 外 - 山 色 - 开 轩 - 垂 柳==阴 阴 垂 柳 乱 蝉 嘶	柳 外 娇 莺 自 在 啼	心 事 太 平 山 色 好	开 轩 坐 到 日 沈 西
积 雪 - 水 滨 - 带 月 - 千 片 - 积 雪==春 回 积 雪 殊 冰 里	香 动 荒 山 野 水 滨	带 月 一 枝 斜 弄 影	背 风 千 片 远 随 人
丝 纶 - 宰 相 - 明 日 - 室 有 - 丝 纶==掷 毫 不 肯 草 丝 纶	宰 相 难 巡 命 别 人	明 日 执 迥 卢 杞 制	始 知 唐 室 有 忠 臣
风 细 - 青 骢 - 笑 语 - 醉 人 - 午 阴==日 迟 风 细 午 阴 微	柳 外 青 骢 去 若 飞	过 得 水 村 闻 笑 语	几 家 扶 得 醉 人 归
风 吹 - 分 袂 - 阳 风 - 雁 归 - 东 风==忆 昨 东 风 吹 马 蹄	瓦 关 分 袂 涕 交 挥	淮 阳 风 物 应 如 旧	独 在 柯 山 送 雁 归
如 云 - 在 天 - 风 雷 - 数 点 - 如 云==万 骑 如 云 下 太 清	至 尊 亲 享 在 天 灵	才 闻 初 献 风 雷 息	皎 皎 凉 蟾 数 点 星
梅 花 - 绿 华 - 琼 瑶 - 蜡 蒂 - 梅 花==花 中 淡 伫 只 梅 花	未 见 梅 中 萼 绿 华	一 色 琼 瑶 裾 织 翠	尚 嫌 红 蜡 蒂 村 些
春 蝶 - 饮 露 - 蜻 蜓 - 照 水 - 春 蝶==饵 花 春 蝶 即 花 仙	饮 露 秋 蝉 怕 露 寒	只 道 蜻 蜓 解 餐 水	元 来 照 水 不 曾 餐
柳 外 - 和 月 - 山 下 - 梅 花 - 戍 楼==柳 外 官 桥 出 戍 楼	和 霜 和 月 按 梁 州	吹 时 莫 近 孤 山 下	千 树 梅 花 不 识 愁
夜 诵 - 江 月 - 朝 宗 - 风 帆 - 夜 诵==夜 诵 都 忘 浪 枕 喧	尔 家 江 月 旧 楼 存	新 来 转 使 朝 宗 近	目 送 风 帆 到 海 门
清 冷 - 长 生 - 归 来 - 白 云 - 清 冷==一 饮 清 冷 体 便 轻	绝 知 真 液 是 长 生	归 来 世 事 都 忘 尽	惟 记 白 云 堆 里 行
囊 新 - 竹 叶 - 传 杯 - 傅 说 - 锦 囊==锦 囊 新 句 忽 传 来	字 字 清 如 竹 叶 杯	要 须 莫 放 传 杯 手	看 即 归 调 傅 说 梅
离 离 - 高 飞 - 扁 舟 - 常 载 - 离 离==红 树 离 离 映 夕 晖	水 天 空 阔 雁 高 飞	扁 舟 一 个 轻 如 叶	常 载 先 生 半 醉 归
浅 绿 - 倚 风 - 来 仪 - 想 像 - 深 红==谁 把 深 红 浅 绿 蟠	羽 毛 飞 动 倚 风 阑	时 人 不 识 来 仪 瑞	只 向 花 前 想 像 看
檐 花 - 有 更 - 人 迹 - 枕 簟 - 檐 花==旋 落 檐 花 夜 正 喧	参 横 斗 转 有 更 传	了 无 人 迹 妨 真 梦	枕 簟 同 参 一 味 禅
花 梢 - 吹 嘘 - 城 边 - 杖 履 - 花 梢==春 到 花 梢 一 点 红	吹 嘘 应 谢 晓 来 风	南 国 缭 绕 城 边 路	无 限 诗 情 杖 履 中
成 愁 - 一 曲 - 翘 足 - 梦 魂 - 文 彩==满 身 文 彩 漫 成 愁	一 曲 清 池 强 滞 留	翘 足 有 时 双 睡 去	梦 魂 依 旧 绕 沧 洲
盘 龙 - 楼 阁 - 避 暑 - 风 月 - 盘 龙==金 作 盘 龙 绣 作 鳞	壶 冰 楼 阁 禁 中 春	君 王 避 暑 来 游 幸	风 月 横 秋 气 象 新
凄 凉 - 好 景 - 无 穷 - 从 今 - 凄 凉==金 牛 去 后 久 凄 凉	好 景 乾 坤 亦 祠 藏	沧 海 无 穷 月 无 尽	从 今 收 拾 入 诗 囊
寒 食 - 九 日 - 有 燕 - 无 人 - 寒 食==寒 食 少 逢 天 气 佳	十 朝 九 日 雨 如 麻	新 巢 唯 有 燕 生 子	小 巷 已 无 人 卖 花
心 清 - 更 长 - 庭 前 - 梅 花 - 妙 香==会 到 心 清 有 妙 香	蒲 团 纸 帐 任 更 长	闭 门 不 受 庭 前 月	分 付 梅 花 自 主 张
父 母 - 精 神 - 出 云 - 常 在 - 父 母==父 母 育 我 田 使 君	精 神 为 人 上 天 闻	田 中 致 雨 山 出 云	但 愿 常 在 不 患 贫
狨 鞍 - 游 山 - 草 木 - 玉 节 - 懒 跨==懒 跨 狨 鞍 趁 晓 班	却 空 蜡 屐 小 游 山	山 头 草 木 生 光 彩	玉 节 曾 行 紫 翠 间
春 雨 - 名 花 - 画 屏 - 故 宫 - 洛 阳==绿 芜 春 雨 洛 阳 城	不 见 名 花 国 已 倾	影 落 画 屏 何 处 物	断 金 残 粉 故 宫 情
行 乐 - 青 鬓 - 淡 薄 - 十 年 - 行 乐==春 天 行 乐 若 为 伤	青 鬓 吹 蓬 半 染 霜	莫 道 一 生 甘 淡 薄	十 年 前 亦 为 春 狂
西 东 - 解 组 - 腊 尽 - 春 风 - 西 东==年 来 飘 泊 任 西 东	解 组 论 文 意 自 雄	腊 尽 竺 溪 渔 唱 晚	杏 花 溪 上 又 春 风
霜 秋 - 饱 无 - 去 去 - 要 经 - 霜 秋==荒 畦 草 棘 暗 霜 秋	菜 饱 无 期 那 不 愁	去 去 携 蓝 问 灵 照	此 间 熟 处 要 经 由
人 稀 - 昏 一 - 开 门 - 江 南 - 人 稀==孤 市 人 稀 冷 欲 冰	昏 昏 一 盏 店 家 灯	开 门 拂 榻 便 酣 寝	我 是 江 南 行 脚 僧
林 中 - 小 径 - 斜 日 - 秋 风 - 林 中==偶 同 禅 友 到 林 中	竹 院 深 深 小 径 通	斜 日 在 山 人 散 后	乱 蝉 疏 柳 自 秋 风
岁 月 - 迎 春 - 新 意 - 日 新 - 岁 月==岁 月 新 更 又 一 春	迎 春 还 是 旧 年 人	愿 除 旧 妄 生 新 意	端 与 新 年 日 日 新
荡 漾 - 春 草 - 渔 翁 - 蓑 笠 - 荡 漾==春 波 荡 漾 满 方 塘	春 草 无 名 各 自 长	沙 际 渔 翁 偏 自 在	醉 抛 蓑 笠 卧 斜 阳
荒 山 - 月 窟 - 持 节 - 乘 槎 - 荒 山==夷 界 荒 山 几 万 重	西 穷 月 窟 与 天 通	何 时 汉 使 还 持 节	从 此 乘 槎 上 碧 空
洛 阳 - 谁 家 - 名 花 - 鬓 霜 - 洛 阳==市 上 芳 菲 小 洛 阳	谁 家 细 马 走 红 妆	名 花 未 恨 东 风 老	只 恨 先 生 两 鬓 霜
月 上 - 玉 人 - 胜 游 - 倚 马 - 月 上==金 鹊 香 销 月 上 迟	玉 人 扶 醉 写 新 词	胜 游 不 记 归 来 夜	春 梦 楼 前 倚 马 时
林 泉 - 村 居 - 辛 勤 - 曲 折 - 林 泉==有 小 林 泉 傍 隐 庐	无 闲 宾 客 访 村 居	辛 勤 辟 地 添 支 径	曲 折 通 溪 入 浅 渠
号 令 - 山 河 - 归 时 - 涧 底 - 号 令==藩 镇 各 传 新 号 令	山 河 那 复 旧 提 封	归 时 剩 语 骑 鲸 老	坚 卧 无 如 涧 底 松
桃 李 - 杏 化 - 佳 实 - 牡 丹 - 桃 李==南 人 误 种 桃 李 栏	北 人 疑 作 杏 化 看	更 须 结 子 成 佳 实	留 到 清 和 伴 牡 丹
孤 峰 - 珍 重 - 游 人 - 涧 底 - 孤 峰==危 根 瘦 尽 耸 孤 峰	珍 重 江 僧 好 笔 踪	得 向 游 人 多 处 画	却 胜 涧 底 作 真 松
春 发 - 秋 深 - 菊 残 - 洛 阳 - 春 发==香 包 已 向 青 春 发	又 见 秋 深 特 地 开	应 笑 菊 残 无 意 思	不 能 邀 赋 洛 阳 才
鲸 波 - 处 处 - 行 乐 - 憔 悴 - 渔 火==蛮 烟 渔 火 接 鲸 波	树 树 花 枝 处 处 歌	况 是 天 涯 好 行 乐	莫 教 憔 悴 鬓 霜 多
香 山 - 日 往 - 红 袖 - 芙 蓉 - 香 山==馆 娃 南 面 即 香 山	画 舸 争 浮 日 往 还	翠 盖 风 翻 红 袖 影	芙 蓉 一 路 照 波 间
风 雨 - 摇 落 - 暗 香 - 淡 淡 - 春 风==依 倚 春 风 雨 净 瓶	暮 林 摇 落 避 真 清	暗 香 似 与 常 娥 约	来 借 黄 昏 淡 淡 明
雪 里 - 鹅 黄 - 蔷 薇 - 雨 洗 - 雪 里==雪 里 何 人 作 道 装	冰 绡 重 叠 色 鹅 黄	染 时 定 著 蔷 薇 露	雨 洗 风 吹 故 自 香
春 愁 - 沉 沉 - 东 风 - 深 绿 - 春 愁==满 抱 春 愁 独 拥 衣	雨 声 入 夜 更 沉 沉	风 流 欲 会 东 风 面	趁 取 径 深 绿 未 深
风 光 - 新 香 - 晴 日 - 玉 骨 - 风 光==末 上 风 光 惊 老 眼	斩 新 香 韵 恼 骚 人	霜 晴 日 淡 虚 庭 裹	玉 骨 幽 贞 不 嫁 春
黯 淡 - 江 头 - 蓬 窗 - 声 声 - 天 寒==彤 云 黯 淡 酿 天 寒	却 向 江 头 理 钓 船	雪 打 蓬 窗 眠 不 着	声 声 时 送 到 吟 边
九 州 - 何 处 - 鸟 语 - 映 日 - 风 吹==莽 莽 暄 风 吹 九 州	春 来 何 处 不 消 忧	林 间 鸟 语 随 时 好	花 里 风 光 映 日 流
百 尺 - 三 径 - 雨 后 - 应 一 - 百 尺==故 里 青 松 百 尺 强	亭 亭 三 径 全 成 行	东 离 雨 后 无 人 葺	旧 菊 多 应 一 半 荒
故 园 - 寒 食 - 相 思 - 白 头 - 千 里==梦 入 故 园 千 里 远	觉 来 寒 食 在 并 州	垂 杨 不 是 相 思 树	那 得 花 开 便 白 头
春 水 - 数 尺 - 风 云 - 波 涛 - 春 水==一 池 春 水 应 江 潮	中 起 沙 鸥 数 尺 高	谁 谓 风 云 远 朝 市	乱 山 深 处 亦 波 涛
南 北 - 千 里 - 六 朝 - 一 樽 - 南 北==江 南 北 苑 出 奇 才	千 里 溪 出 笔 底 回	不 管 六 朝 兴 废 事	一 樽 且 向 画 图 开
隙 地 - 参 天 - 堵 人 - 卿 相 - 隙 地==自 古 别 都 多 隙 地	参 天 乔 木 乱 昏 鸦	荒 垣 壤 堵 人 耕 处	半 是 前 朝 卿 相 家
绿 窗 - 离 徊 - 深 山 - 延 行 - 绿 窗==绿 窗 深 情 不 忍 离	去 离 徊 徨 意 转 迷	久 拟 深 山 学 修 法	又 延 行 程 到 后 期
深 红 - 芳 丛 - 春 去 - 红 醉 - 深 红==指 点 深 红 与 昔 同	更 无 夭 艳 在 芳 丛	南 泉 笑 里 移 春 去	留 得 残 红 醉 密 蜂
天 淡 - 关 情 - 桑 麻 - 万 里 - 天 淡==河 白 如 银 天 淡 青	角 声 中 有 玉 关 情	早 知 送 老 桑 麻 野	悔 失 安 西 万 里 行
扶 疏 - 满 庭 - 破 土 - 河 决 - 扶 疏==蒲 萄 新 条 易 扶 疏	椿 花 锁 碎 满 庭 除	旱 干 只 喜 雨 破 土	潦 润 不 忧 河 决 渠
扁 舟 - 无 人 - 天 外 - 鱼 龙 - 扁 舟==扁 舟 触 热 下 涪 忠	肩 耸 无 人 肯 拍 洪	诗 送 凉 风 天 外 至	鱼 龙 起 舞 浪 化 中
号 令 - 羯 鼓 - 一 曲 - 莺 声 - 号 令==有 道 君 王 传 号 令	频 催 羯 鼓 要 花 开	眼 头 一 曲 风 光 好	日 暖 莺 声 出 谷 来
章 甫 - 江 边 - 共 游 - 乔 木 - 章 甫==象 环 章 甫 古 冠 衣	解 佩 江 边 结 伴 嬉	应 共 游 童 春 浴 罢	咏 歌 乔 木 错 薪 辞
千 年 - 太 乙 - 悲 风 - 金 盘 - 千 年==千 年 回 磴 绝 鸣 銮	太 乙 祈 灵 有 汉 坛	一 夜 悲 风 铜 柱 折	仙 人 垂 泪 下 金 盘
拂 云 - 万 里 - 扁 舟 - 江 上 - 拂 云==拂 云 高 雁 倚 风 抟	下 视 平 湖 万 里 宽	搔 首 扁 舟 又 东 去	钱 塘 江 上 看 波 澜
风 烟 - 百 花 - 相 思 - 一 人 - 风 烟==南 国 风 烟 暗 客 尘	凤 凰 山 上 百 花 春	烦 君 话 我 相 思 苦	十 载 西 湖 欠 一 人
行 行 - 碧 嶂 - 归 下 - 寒 泉 - 行 行==行 行 抚 事 念 前 贤	修 竹 祠 西 碧 嶂 前	不 复 船 归 下 双 鹤	空 缘 酒 渴 酌 寒 泉
望 中 - 往 事 - 百 年 - 太 无 - 目 断==欲 望 中 原 双 目 断	听 谈 往 事 几 心 酸	百 年 故 家 好 人 物	尘 沙 流 落 太 无 端
分 明 - 指 天 - 成 群 - 脑 门 - 分 明==开 口 分 明 便 垛 根	指 天 指 地 独 称 尊	成 群 作 队 随 他 转	几 个 男 儿 有 脑 门
沧 海 - 泰 山 - 憔 悴 - 黄 卷 - 夜 光==沧 海 枯 来 失 夜 光	泰 山 走 去 误 朝 阳	可 怜 憔 悴 苍 颜 客	曾 是 呻 吟 黄 卷 郎
白 玉 - 雪 色 - 横 枝 - 第 一 - 玉 堂==阿 母 亲 栽 白 玉 堂	分 明 雪 色 变 青 黄	不 须 徙 倚 横 枝 看	留 作 江 南 第 一 香
香 烟 - 道 士 - 月 上 - 清 梦 - 香 烟==柏 香 烟 裹 沦 山 茶	穷 似 烧 丹 道 士 家	窗 纸 渐 明 寒 月 上	一 肱 清 梦 入 梅 花
晴 岚 - 山 光 - 草 履 - 寻 荔 - 晴 岚==晚 凉 树 树 落 晴 岚	满 郭 山 光 海 气 含	草 履 葛 衫 葵 叶 扇	为 寻 荔 子 过 城 南
千 仞 - 烟 丛 - 香 消 - 疏 枝 - 千 仞==曳 履 来 登 千 仞 峰	路 分 溪 石 夹 烟 丛	晚 香 消 歇 无 寻 处	尽 在 疏 枝 冷 蕊 中
湛 湛 - 波 心 - 荷 叶 - 夜 深 - 湛 湛==澄 波 湛 湛 接 新 秋	月 子 波 心 印 一 钩	荷 叶 乱 花 看 不 见	夜 深 时 有 小 龙 游
一 朵 - 翠 云 - 清 浅 - 游 人 - 一 朵==一 朵 蓬 莱 在 世 间	梵 王 宫 阙 翠 云 间	近 南 溪 水 更 清 浅	闻 道 游 人 未 忍 还
文 章 - 一 纸 - 旗 鼓 - 草 长 - 文 章==文 章 妙 绝 有 邱 迟	一 纸 书 中 百 首 诗	正 在 将 军 旗 鼓 处	忽 然 花 杂 草 长 时
兰 若 - 月 明 - 门 清 - 莲 花 - 深 山==云 公 兰 若 深 山 里	月 明 松 殿 微 风 起	试 问 空 门 清 净 心	莲 花 不 著 秋 潭 水
平 沙 - 斜 日 - 凭 谁 - 水 墨 - 平 沙==雁 落 平 沙 一 雨 收	淡 烟 斜 日 荻 花 洲	凭 谁 与 作 王 摩 诘	为 写 江 南 水 墨 秋
含 章 - 造 化 - 意 足 - 相 马 - 春 风==含 章 檐 下 春 风 面	造 化 功 成 秋 兔 毫	意 足 不 求 颜 色 似	前 身 相 马 九 方 皋
江 山 - 古 木 - 台 城 - 六 朝 - 江 山==江 山 不 逐 寒 潮 晚	陵 墓 犹 含 古 木 春	君 入 台 城 须 访 问	个 中 定 有 六 朝 人
小 院 - 星 河 - 离 思 - 眉 青 - 小 院==天 葩 小 院 敞 云 屏	鹊 散 星 河 逗 客 星	欲 识 别 来 离 思 苦	晚 峰 长 学 黛 眉 青
柳 外 - 惠 风 - 终 朝 - 得 邻 - 柳 外==柳 外 飞 飞 峡 蝶 儿	惠 风 心 性 彩 云 姿	终 朝 守 定 墙 头 舞	不 得 邻 家 一 句 诗
花 开 - 裁 成 - 春 色 - 白 衣 - 花 开==天 平 山 木 似 花 开	青 女 裁 成 锦 绣 堆	暂 借 秋 光 作 春 色	白 衣 解 遣 麴 生 来
成 行 - 芦 花 - 夜 深 - 居 处 - 草 树==草 树 成 行 整 复 斜	江 头 白 处 定 芦 花	夜 深 更 着 无 边 月	好 个 楼 居 处 士 家
崔 嵬 - 一 笑 - 谪 仙 - 归 来 - 崔 嵬==偶 寻 流 水 上 崔 嵬	五 老 苍 颜 一 笑 开	若 见 谪 仙 烦 寄 语	匡 山 头 白 早 归 来
长 江 - 烟 笼 - 吟 怀 - 斜 阳 - 长 江==万 里 长 江 浸 碧 流	烟 笼 细 草 满 孤 洲	吟 怀 到 此 难 排 遣	独 立 斜 阳 古 渡 头
鹭 鸶 - 碧 天 - 雨 后 - 饭 鱼 - 苍 茫==苍 茫 沙 嘴 鹭 鸶 眠	片 水 无 痕 浸 碧 天	最 爱 芦 花 经 雨 后	一 篷 烟 火 饭 鱼 舡
有 泪 - 雨 后 - 秋 声 - 对 床 - 有 泪==忆 君 我 有 泪 淋 漓	正 似 湘 江 雨 后 枝	记 得 秋 声 夜 同 听	萧 闲 馆 里 对 床 时
秀 色 - 雨 浥 - 倒 影 - 烂 熳 - 秀 色==出 肋 梅 花 秀 色 新	不 堪 寒 雨 浥 清 尘	故 应 倒 影 澄 澜 碧	湿 玉 吹 香 烂 熳 春
雨 湿 - 闲 行 - 烟 波 - 荷 花 - 雨 湿==雨 湿 云 容 廓 太 清	池 边 向 晚 喜 闲 行	回 溪 曲 港 烟 波 绿	已 有 荷 花 照 眼 明
水 云 - 夜 休 - 英 雄 - 大 江 - 水 云==沙 寒 日 薄 水 云 愁	贼 魏 王 吴 一 夜 休	自 是 英 雄 元 不 死	至 今 犹 占 大 江 流
织 女 - 长 庚 - 无 人 - 梅 花 - 织 女==织 女 斜 河 漏 已 残	长 庚 配 月 夜 将 阑	小 桥 幽 径 无 人 见	折 得 梅 花 伴 晓 寒
经 年 - 江 山 - 计 相 - 一 纸 - 溪 翁==经 年 不 见 玉 溪 翁	百 里 江 山 万 里 同	无 计 相 从 话 心 曲	时 挥 一 纸 寄 西 风
画 舫 - 槛 外 - 扬 州 - 夜 窗 - 画 舫==吟 院 虚 明 如 画 舫	想 成 槛 外 是 长 江	杜 郎 忽 作 扬 州 梦	雨 带 风 沙 打 夜 窗
石 门 - 苍 苔 - 悬 崖 - 出 云 - 石 门==石 门 空 虚 谁 凿 辟	薜 荔 挂 影 苍 苔 积	悬 崖 偃 树 鹘 栖 巢	古 洞 出 云 龙 启 蛰
光 辉 - 同 心 - 教 尘 - 长 照 - 光 辉==团 圆 今 夕 色 光 辉	结 了 同 心 翠 带 垂	此 后 莫 教 尘 点 染	他 年 长 照 岁 寒 姿
千 古 - 身 轻 - 门 下 - 峥 嵘 - 千 古==名 与 山 高 千 古 重	恩 如 海 阔 一 身 轻	门 下 少 年 初 幕 府	梦 随 诸 吏 上 峥 嵘
月 朵 - 雪 月 - 春 头 - 风 光 - 月 朵==月 朵 千 痕 雪 半 梢	便 无 雪 月 更 飘 萧	不 应 腊 尾 春 头 里	两 岁 风 光 一 并 饶
千 林 - 风 骨 - 教 群 - 一 幅 - 千 林==独 立 千 林 压 众 葩	正 由 风 骨 傲 烟 霞	谁 教 群 玉 峰 头 客	也 染 红 裙 一 幅 纱
月 斜 - 清 秋 - 络 纬 - 江 南 - 月 斜==月 斜 东 壁 影 虚 龛	枕 簟 清 秋 梦 正 酣	一 样 梦 醒 听 络 纬	今 宵 江 北 昨 江 南
榴 花 - 繁 阴 - 图 画 - 入 帘 - 榴 花==几 岁 榴 花 蔽 曲 隈	繁 阴 初 逼 坐 中 来	西 邻 小 槛 如 图 画	偷 入 帘 帷 次 第 开
岭 头 - 玉 堂 - 昨 夜 - 天 明 - 岭 头==大 庾 岭 头 春 似 海	不 是 寻 常 白 玉 堂	昨 夜 护 龙 河 上 看	一 天 明 月 四 檐 霜
峥 嵘 - 霞 觞 - 看 山 - 山 色 - 峥 嵘==小 阁 峥 嵘 山 四 傍	清 溪 来 作 九 霞 觞	我 来 细 酌 看 山 色	山 色 长 佳 为 不 忙
层 层 - 烟 雨 - 前 村 - 花 香 - 翠 微==雁 岭 层 层 拥 翠 微	一 空 烟 雨 漫 山 飞	前 村 踏 到 园 林 外	湿 透 花 香 近 竹 扉
风 凄 - 峰 森 - 离 思 - 五 更 - 凄 凄==林 皋 叶 脱 风 凄 凄	远 峰 森 立 寒 云 齐	满 船 离 思 半 江 月	未 到 五 更 鸡 乱 啼
秋 来 - 阶 前 - 王 宠 - 惟 顾 - 秋 来==长 信 秋 来 月 自 圆	夜 香 独 拜 玉 阶 前	妾 吟 不 顾 君 王 宠	惟 顾 君 王 寿 万 年
翠 竹 - 江 南 - 花 光 - 数 声 - 鱼 矶==白 沙 翠 竹 钓 鱼 矶	家 住 江 南 未 得 归	最 恨 花 光 山 下 路	数 声 杜 宇 背 人 飞
涧 底 - 石 桥 - 何 暮 - 昨 夜 - 长 松==谷 口 长 松 涧 底 藤	石 桥 山 路 晚 登 登	囊 琴 斗 酒 来 何 暮	空 负 寒 斋 昨 夜 镫
侵 汉 - 低 枝 - 年 来 - 晚 潮 - 侵 汉==未 必 树 皆 侵 汉 者	低 枝 亦 可 挂 吾 瓢	年 来 饭 后 无 余 事	且 立 松 门 看 晚 潮
看 来 - 看 时 - 在 楚 - 归 期 - 花 开==花 开 只 恐 看 来 迟	及 到 愁 如 未 看 时	家 在 楚 乡 身 在 蜀	一 年 春 色 负 归 期
膏 泽 - 去 程 - 夜 雨 - 人 情 - 春 耕==农 忻 膏 泽 了 春 耕	客 免 深 泥 阻 去 程	日 里 放 晴 终 夜 雨	天 公 两 下 做 人 情
赏 心 - 烂 漫 - 独 酌 - 一 日 - 良 辰==寒 食 良 辰 无 赏 心	杂 花 烂 漫 柳 成 阴	若 非 独 酌 酬 佳 景	一 日 风 光 直 万 金
指 顾 - 春 风 - 江 南 - 千 里 - 指 顾==京 口 瓜 州 指 顾 间	春 风 几 度 到 钟 山	迷 离 绿 遍 江 南 地	千 里 怀 人 去 不 还
水 石 - 秀 色 - 兰 亭 - 金 字 - 水 石==水 石 相 迎 击 目 新	两 峰 秀 色 引 朱 轮	使 君 自 比 兰 亭 后	金 字 磨 崖 更 几 人
春 寒 - 午 梦 - 高 楼 - 天 涯 - 春 寒==檐 头 燕 子 说 春 寒	蝴 蝶 悠 悠 午 梦 残	睡 起 高 楼 多 少 恨	天 涯 小 雨 怯 阑 干
汉 柱 - 盍 簪 - 十 年 - 万 里 - 汉 柱==摩 挲 汉 柱 怆 分 襟	邂 逅 吴 船 喜 盍 簪	别 久 十 年 知 几 梦	情 亲 万 里 只 初 心
西 湖 - 插 花 - 春 风 - 谁 家 - 笙 歌==西 湖 二 月 好 笙 歌	游 女 游 郎 半 插 花	忽 对 春 风 怀 故 国	不 知 新 燕 入 谁 家
古 今 - 惜 别 - 一 家 - 断 肠 - 古 今==远 人 羁 客 古 今 悲	昔 日 慵 看 惜 别 诗	六 口 一 家 分 五 处	争 教 不 作 断 肠 词
忘 机 - 高 情 - 严 陵 - 鲈 鱼 - 忘 机==立 意 忘 机 机 已 生	可 能 朝 市 污 高 情	时 人 未 会 严 陵 志	不 钓 鲈 鱼 只 钓 名
凄 凄 - 风 冷 - 跳 跃 - 遮 日 - 凄 凄==醉 魂 吟 魄 共 凄 凄	檐 溜 窗 风 冷 切 肌	阶 下 怒 蛙 休 跳 跃	浮 云 遮 日 不 多 时
碧 波 - 隔 岸 - 桃 花 - 武 陵 - 碧 波==乱 山 深 处 碧 波 流	隔 岸 垂 杨 击 小 舟	无 数 桃 花 伴 春 梦	梦 中 还 作 武 陵 游
孤 云 - 物 外 - 老 柏 - 寒 花 - 孤 云==孤 云 欲 作 人 间 雨	流 水 空 传 物 外 声	老 柏 倚 岩 高 转 瘦	寒 花 著 雨 坠 还 生
黄 花 - 冷 蝶 - 东 篱 - 风 霜 - 黄 花==黄 花 狼 籍 晚 犹 香	冷 蝶 频 来 著 意 忙	不 见 东 篱 千 载 士	自 应 埋 没 老 风 霜
铜 瓶 - 惜 花 - 白 发 - 故 人 - 铜 瓶==妆 点 铜 瓶 分 外 春	惜 花 尤 见 主 翁 仁	自 怜 白 发 衰 如 许	空 对 花 前 忆 故 人
昼 眠 - 酿 愁 - 南 柯 - 绿 阴 - 青 奴==拂 拭 青 奴 供 昼 眠	半 晴 半 雨 酿 愁 天	梦 回 不 到 南 柯 境	风 过 绿 阴 号 晚 蝉
寂 寥 - 云 山 - 载 酒 - 残 编 - 寂 寂==寂 寂 寥 寥 扬 子 居	云 山 相 对 一 床 书	无 人 载 酒 问 奇 字	自 把 残 编 时 卷 编
凄 凉 - 倚 槛 - 山 腰 - 白 云 - 凄 凉==凄 凉 一 阁 睨 高 空	倚 槛 幽 奇 景 莫 穷	好 是 山 腰 抱 松 桧	一 屏 玉 琢 白 云 中
疏 花 - 西 湖 - 零 落 - 阑 干 - 疏 花==疏 花 纤 月 斗 清 寒	曾 向 西 湖 雪 后 看	零 落 断 香 三 十 载	几 家 风 笛 倚 阑 干
鸾 鹤 - 笙 歌 - 龙 头 - 虚 空 - 松 下==鸾 鹤 每 于 松 下 见	笙 歌 常 向 坐 中 闻	手 持 十 节 龙 头 杖	不 指 虚 空 即 指 云
轻 黄 - 漠 漠 - 风 吹 - 鸳 鸯 - 轻 黄==柳 着 轻 黄 欲 染 衣	汀 沙 漠 漠 草 菲 菲	晓 风 吹 断 寒 烟 碧	无 数 鸳 鸯 溪 上 飞
故 人 - 更 长 - 经 岁 - 递 相 - 江 乡==故 人 漂 泊 客 江 乡	夜 雨 相 思 夜 更 长	经 岁 不 来 来 又 去	端 如 鸿 燕 递 相 望
栽 竹 - 读 书 - 直 尝 - 唯 候 - 栽 竹==等 闲 田 地 多 栽 竹	是 处 人 家 爱 读 书	饮 宴 直 尝 千 户 酒	盘 餐 唯 候 两 潮 鱼
弄 影 - 浪 翻 - 无 人 - 晓 风 - 弄 影==小 白 山 头 花 弄 影	潮 音 洞 口 浪 翻 空	圆 通 门 启 无 人 入	闲 把 轮 珠 立 晓 风
西 河 - 使 经 - 仙 山 - 千 年 - 西 河==昔 时 训 子 西 河 上	汉 使 经 过 问 妾 缘	自 到 仙 山 不 知 老	凡 间 唤 作 几 千 年
东 风 - 万 家 - 桃 花 - 明 月 - 杨 柳==阊 阖 东 风 杨 柳 柔	万 家 弦 吹 水 西 楼	兰 桡 夜 逐 桃 花 浪	明 月 歌 残 下 武 丘
霜 毛 - 一 年 - 山 窗 - 梅 花 - 霜 毛==不 管 霜 毛 不 贷 人	一 年 旧 了 一 年 新	山 窗 未 晓 闻 山 乐	可 是 梅 花 漏 泄 春
江 亭 - 雨 余 - 西 风 - 入 画 - 江 亭==不 上 江 亭 数 日 间	雨 余 山 色 带 清 寒	西 风 峭 湛 休 围 却	要 放 秋 光 入 画 阑
桃 李 - 红 杏 - 重 重 - 后 开 - 桃 李==花 事 先 从 桃 李 来	海 棠 红 杏 即 相 催	化 工 节 度 重 重 好	护 得 山 丹 最 后 开
湘 水 - 孤 舟 - 杨 柳 - 白 头 - 湘 水==长 沙 城 西 湘 水 流	客 来 城 下 系 孤 舟	隔 江 几 树 残 杨 柳	留 与 啼 乌 伴 白 头
赤 日 - 巷 南 - 荷 风 - 月 筛 - 火 云==赤 日 才 低 又 火 云	巷 南 街 北 断 知 闻	荷 风 拂 簟 昭 苏 我	竹 月 筛 窗 慰 藉 君
拂 地 - 一 丝 - 秋 风 - 黄 梅 - 拂 地==无 赖 阴 云 拂 地 垂	客 愁 如 绪 一 丝 丝	那 堪 更 向 秋 风 里	卧 听 黄 梅 细 雨 时
霜 寒 - 流 丹 - 雪 冷 - 渔 翁 - 水 落==霜 寒 水 落 响 天 风	烟 叶 流 丹 几 树 枫	雪 冷 石 梁 人 影 绝	蓑 衣 独 钓 一 渔 翁
银 河 - 翠 罗 - 沧 海 - 白 云 - 银 河==红 栏 六 曲 压 银 河	瑞 雾 霏 霏 湿 翠 罗	明 月 不 知 沧 海 暮	九 疑 山 下 白 云 多
有 无 - 夕 阳 - 小 桥 - 画 图 - 烟 林==绕 岸 烟 林 半 有 无	夕 阳 人 散 钓 船 孤	小 桥 独 倚 红 阑 上	不 觉 闲 身 在 画 图
英 灵 - 落 笔 - 百 年 - 挑 灯 - 英 灵==志 乘 英 灵 琐 屑 求	岂 其 落 笔 定 阳 秋	百 年 子 姓 殷 勤 意	忍 说 挑 灯 为 应 酬
平 津 - 万 重 - 七 星 - 神 剑 - 平 津==延 平 津 路 水 溶 溶	峭 壁 巍 岑 一 万 重	昨 夜 七 星 潭 底 见	分 明 神 剑 化 为 龙
映 雪 - 引 锥 - 狼 藉 - 陵 瞌 - 映 雪==映 雪 工 夫 久 已 无	引 锥 自 刺 一 何 愚	青 灯 一 盏 书 狼 藉	画 作 金 陵 瞌 睡 图
衣 襟 - 竹 间 - 邮 亭 - 白 头 - 衣 襟==翠 湿 衣 襟 山 满 楼	竹 间 溪 水 绕 床 流	行 人 莫 羡 邮 亭 吏	生 向 此 中 今 白 头
窗 寒 - 云 母 - 宝 篆 - 红 雨 - 窗 寒==月 奁 金 镜 绮 窗 寒	云 母 屏 开 五 色 鸾	宝 篆 有 香 椒 壁 静	一 帘 红 雨 杏 花 残
槎 牙 - 寒 窗 - 赢 得 - 桃 李 - 槎 牙==槎 牙 此 老 是 枯 松	衲 破 寒 窗 百 病 攻	赢 得 雪 霜 皮 骨 在	几 看 桃 李 谢 春 风
黄 尘 - 归 来 - 人 立 - 飞 鸿 - 黄 尘==黄 尘 逆 帽 马 辟 易	归 来 下 帘 卧 书 空	不 知 绣 鞍 万 人 立	何 如 卢 郎 驾 飞 鸿
玉 叶 - 金 波 - 海 面 - 鹏 翼 - 连 天==无 端 玉 叶 连 天 起	不 放 金 波 到 晓 流	暗 惜 蚌 胎 沉 海 面	仰 思 鹏 翼 破 风 头
昏 钟 - 烛 影 - 飞 霜 - 今 夜 - 人 上==宫 人 上 临 候 昏 钟	帘 外 香 烟 烛 影 红	庭 柏 飞 霜 陵 漏 永	可 怜 今 夜 月 明 中
萧 然 - 夕 阳 - 许 坐 - 鸾 凰 - 萧 然==萧 然 寒 圃 有 残 芳	吟 遍 朱 栏 向 夕 阳	既 许 坐 陪 公 衮 贵	却 惭 蒿 羽 接 鸾 凰
潺 潺 - 苍 藤 - 道 人 - 白 首 - 流 水==长 溪 流 水 碧 潺 潺	古 木 苍 藤 暗 两 山	把 臂 道 人 今 在 否	长 官 白 首 尚 人 间
春 风 - 青 青 - 桃 李 - 人 伴 - 春 风==强 半 春 风 掩 户 庭	出 门 唯 见 麦 青 青	从 来 赤 白 歌 桃 李	曾 与 何 人 伴 醉 酲
万 里 - 高 楼 - 蛾 眉 - 春 风 - 万 里==万 里 因 人 作 还 游	眼 明 西 北 有 高 楼	蛾 眉 嫁 晚 贞 心 在	间 倚 春 风 唱 石 州
秋 天 - 书 斋 - 风 光 - 一 杯 - 秋 天==秋 天 睛 日 菊 还 香	独 坐 书 斋 思 已 长	无 奈 风 光 易 流 转	强 须 倾 酒 一 杯 觞
台 星 - 第 一 - 语 邦 - 门 卧 - 台 星==文 星 渐 见 射 台 星	仙 籍 高 标 第 一 名	为 语 邦 人 休 眷 恋	北 门 卧 护 要 耆 英
日 月 - 青 鬓 - 流 年 - 溪 头 - 日 月==老 去 惟 思 日 月 迟	更 堪 青 鬓 总 成 丝	无 端 催 取 流 年 去	最 恨 溪 头 布 谷 儿
冥 冥 - 万 木 - 似 雪 - 属 遗 - 冥 冥==两 山 南 北 雨 冥 冥	四 牖 东 西 万 木 青	面 似 骷 髅 头 似 雪	后 生 谁 与 属 遗 经
焚 香 - 金 莲 - 夜 深 - 月 上 - 焚 香==茶 罢 焚 香 独 坐 时	金 莲 水 滴 漏 声 迟	夜 深 欲 睡 问 童 子	月 上 梅 花 第 几 枝
天 香 - 猿 鹤 - 神 仙 - 晴 云 - 天 香==袖 惹 天 香 隐 故 庐	一 山 猿 鹤 伴 清 虚	有 人 来 叩 神 仙 诀	就 剪 晴 云 问 起 居
阑 干 - 枕 石 - 一 身 - 潇 潇 - 阑 干==月 横 鹤 膝 影 阑 干	枕 石 眠 云 几 岁 寒	宇 宙 一 身 今 老 矣	潇 潇 风 雪 拥 袁 安
日 边 - 清 香 - 摇 落 - 憔 悴 - 日 边==主 人 今 向 日 边 归	犹 有 清 香 满 谢 池	为 嘱 西 风 莫 摇 落	不 禁 憔 悴 夕 阳 时
垂 金 - 狂 风 - 天 工 - 亏 盈 - 垂 金==垂 垂 金 颖 贺 秋 成	去 逐 狂 风 一 羽 轻	何 事 天 工 恶 戏 剧	眼 前 翻 覆 见 亏 盈
鸣 钟 - 欹 枕 - 寂 寞 - 春 风 - 鸣 钟==中 禁 鸣 钟 日 欲 高	北 窗 欹 枕 望 频 搔	相 思 寂 寞 青 苔 合	唯 有 春 风 啼 伯 劳
玉 蕊 - 江 南 - 发 天 - 年 年 - 玉 蕊==莫 欺 玉 蕊 瘦 栾 栾	中 有 江 南 长 恨 端	白 发 天 涯 归 未 得	年 年 老 眼 泪 中 看
白 云 - 无 心 - 知 人 - 满 溪 - 寂 寂==白 云 寂 寂 水 潺 潺	云 出 无 心 水 自 闲	云 水 不 知 人 换 世	至 今 依 旧 满 溪 山
出 家 - 乞 食 - 长 沙 - 绛 老 - 出 家==童 子 出 家 无 第 行	随 师 乞 食 遣 称 名	长 沙 岂 敢 论 年 几	绛 老 惟 知 甲 子 生
天 台 - 白 云 - 诗 人 - 看 山 - 天 台==久 别 天 台 路 已 迷	眼 前 尚 觉 白 云 低	诗 人 用 笔 求 逋 峭	何 不 看 山 到 浙 西
束 缚 - 生 抵 - 坐 钓 - 千 古 - 功 名==功 名 束 缚 几 英 豪	无 怪 先 生 抵 死 逃	坐 钓 桐 江 一 派 水	清 风 千 古 与 台 高
青 山 - 绝 顶 - 下 榻 - 折 券 - 青 山==欲 买 青 山 贷 寓 居	时 临 绝 顶 瞰 平 湖	已 容 下 榻 烦 重 问	肯 念 吾 贫 折 券 无
重 阳 - 黄 花 - 时 态 - 幽 香 - 重 阳==可 惜 重 阳 已 过 期	黄 花 无 灵 绕 山 篱	政 缘 懒 作 趋 时 态	多 少 幽 香 人 不 知
山 村 - 家 家 - 此 时 - 不 须 - 山 村==山 村 处 处 晴 收 麦	邻 曲 家 家 什 晒 丝	正 用 此 时 身 得 谢	十 分 寿 酒 不 须 辞
破 腊 - 年 光 - 篱 落 - 半 面 - 破 腊==一 段 幽 奇 破 腊 忙	只 将 迟 暮 了 年 光	从 教 篱 落 飘 零 尽	也 胜 房 栊 半 面 妆
新 年 - 自 由 - 人 情 - 转 船 - 新 年==新 年 殊 未 有 吟 搜	美 酒 醺 人 不 自 由	多 谢 主 人 情 意 厚	玉 舟 三 度 转 船 头
柴 门 - 香 远 - 解 语 - 郎 君 - 一 树==严 恨 柴 门 一 树 花	便 随 香 远 逐 香 车	花 如 解 语 还 应 道	欺 我 郎 君 不 在 家
千 尺 - 峥 嵘 - 风 卷 - 喷 玉 - 千 尺==千 尺 崖 头 一 派 清	古 今 不 绝 坠 峥 嵘	长 风 卷 起 散 岩 壑	此 日 蚊 知 喷 玉 名
出 城 - 行 南 - 斜 阳 - 故 乡 - 出 城==送 客 出 城 秋 已 凉	太 行 南 上 楚 天 长	顺 承 门 外 斜 阳 里	荞 麦 花 开 似 故 乡
时 和 - 雪 中 - 园 林 - 水 晶 - 时 和==时 和 岁 稔 似 熙 丰	腊 月 仙 京 大 雪 中	殿 阁 园 林 都 莹 彻	云 河 不 是 水 晶 宫
江 水 - 江 风 - 江 花 - 江 流 - 江 水==日 暮 嘉 陵 江 水 东	梨 花 万 片 逐 江 风	江 花 何 处 最 肠 断	半 落 江 流 半 在 空
一 点 - 风 吹 - 倚 杖 - 溪 边 - 千 丈==千 丈 岩 头 一 点 红	春 风 吹 落 浅 莎 中	山 僧 倚 杖 移 时 去	说 似 溪 边 采 药 翁
成 林 - 富 贵 - 一 灯 - 夜 堂 - 成 林==海 棠 初 绽 锦 成 林	多 少 人 间 富 贵 心	隽 永 一 灯 论 语 课	萧 萧 风 雨 夜 堂 深
踏 青 - 百 回 - 杨 花 - 春 光 - 三 月==三 月 踏 青 能 几 日	百 回 添 酒 莫 辞 频	看 君 倒 卧 杨 花 里	始 觉 春 光 为 醉 人
九 州 - 功 裘 - 满 地 - 百 斛 - 黄 叶==黄 叶 委 庭 观 九 州	小 虫 催 女 献 功 裘	金 钱 满 地 无 人 费	百 斛 明 珠 薏 苡 秋
夜 堂 - 不 眠 - 静 坐 - 一 灯 - 夜 堂==残 僧 入 定 夜 堂 寂	独 客 不 眠 山 月 高	静 坐 了 无 尘 俗 态	一 灯 窗 下 读 离 骚
人 烟 - 桑 柘 - 银 泥 - 春 雨 - 水 云==水 云 深 处 见 人 烟	桑 柘 鸣 鸠 似 可 怜	却 怪 银 泥 环 四 壁	由 来 春 雨 上 蜗 涎
碧 树 - 惊 飞 - 蜂 蝶 - 花 房 - 碧 树==才 转 歌 喉 碧 树 枝	惊 飞 还 避 巧 丸 儿	可 怜 蜂 蝶 无 言 语	入 遍 花 房 人 未 知
窗 外 - 蝉 鸣 - 多 情 - 解 作 - 窗 外==窗 外 时 闻 一 叶 落	槐 阴 惊 起 几 蝉 鸣	秋 风 定 是 多 情 物	解 作 离 肠 欲 断 声
六 月 - 清 凉 - 行 客 - 潺 潺 - 六 月==征 舆 六 月 度 梅 关	大 地 清 凉 树 影 班	行 客 不 须 梅 止 渴	流 泉 到 耳 冷 潺 潺
庐 山 - 白 鹤 - 声 人 - 流 水 - 庐 山==坡 老 独 往 到 庐 山	白 鹤 观 中 俱 昼 眠	只 有 棋 声 人 不 见	寂 然 流 水 古 松 间
西 溪 - 苦 吟 - 黄 扉 - 山 林 - 风 月==西 溪 风 月 宜 真 赏	东 岭 烟 霞 称 苦 吟	他 日 黄 扉 勤 论 道	秋 风 一 梦 到 山 林
清 歌 - 玉 殿 - 顺 郎 - 九 重 - 清 歌==清 歌 不 是 世 间 音	玉 殿 尝 闻 称 主 心	唯 有 顺 郎 全 学 得	一 声 飞 出 九 重 深
五 岁 - 扁 舟 - 垂 柳 - 故 人 - 五 岁==五 岁 淮 山 一 梦 新	扁 舟 曾 系 市 桥 春	津 亭 石 磴 双 垂 柳	见 我 依 依 似 故 人
村 落 - 亦 自 - 春 山 - 繁 声 - 村 落==村 落 寻 花 特 地 无	有 花 亦 自 只 愁 予	不 如 卧 听 春 山 雨	一 阵 繁 声 一 阵 疏
重 阳 - 黄 花 - 歌 吹 - 我 狂 - 重 阳==京 兆 重 阳 大 尹 家	翠 微 楼 上 赏 黄 花	秦 娥 应 怪 停 歌 吹	看 我 狂 诗 到 日 斜
一 径 - 前 林 - 看 山 - 兴 亡 - 一 径==门 掩 松 萝 一 径 深	偶 携 藜 杖 出 前 林	谁 知 尽 日 看 山 坐	万 古 兴 亡 总 在 心
风 烟 - 沧 浪 - 青 山 - 永 日 - 风 烟==割 取 风 烟 归 此 堂	尘 缨 更 好 濯 沧 浪	青 山 屋 上 下 流 水	永 日 翻 书 乐 未 央
经 年 - 壁 依 - 舟 相 - 玉 堂 - 经 年==先 生 仙 去 几 经 年	赤 壁 依 然 浪 接 天	去 棹 来 舟 相 指 示	曾 游 元 佑 玉 堂 贤
梅 花 - 可 人 - 样 好 - 赏 雪 - 梅 花==梅 花 时 节 屡 开 樽	欲 赠 梅 花 欠 可 人	令 日 有 人 梅 样 好	迟 君 同 赏 雪 中 春
惊 鹤 - 龙 蟠 - 流 水 - 白 云 - 惊 鹤==猿 惊 鹤 怨 不 知 处	虎 据 龙 蟠 空 见 山	芳 草 路 随 流 水 远	老 僧 心 共 白 云 闲
白 发 - 征 帆 - 凭 阑 - 悲 不 - 白 发==不 嗟 白 发 曾 游 此	不 叹 征 帆 无 了 期	尽 日 凭 阑 谁 会 我	只 悲 不 见 韩 垂 诗
幽 居 - 柴 门 - 啼 鸟 - 小 窗 - 幽 居==幽 居 无 事 属 山 家	闭 却 柴 门 日 未 斜	啼 鸟 一 声 惊 梦 觉	小 窗 闲 坐 听 蜂 衙
雪 丝 - 归 时 - 沙 鸥 - 钓 矶 - 雪 丝==去 日 春 蚕 吐 雪 丝	归 时 霜 菊 剥 金 衣	沙 鸥 不 入 鸳 鸿 侣	依 旧 沧 浪 绕 钓 矶
鹤 骨 - 九 天 - 作 诗 - 梅 花 - 万 里==万 里 烟 霞 侵 鹤 骨	九 天 风 露 注 蝉 尸	君 看 个 人 作 诗 苦	梅 花 细 嚼 当 晨 炊
重 阳 - 谁 家 - 江 南 - 寒 烟 - 重 阳==满 城 风 雨 近 重 阳	城 脚 谁 家 菊 自 黄	又 是 江 南 离 别 处	寒 烟 吹 雁 不 成 行
岑 寂 - 殷 勤 - 落 英 - 博 山 - 岑 寂==天 公 怜 我 太 岑 寂	每 岁 殷 勤 两 度 开	收 拾 落 英 将 底 用	博 山 香 裹 荐 清 杯
红 霞 - 绛 节 - 林 下 - 白 云 - 红 霞==红 霞 紫 气 昼 氲 氲	绛 节 青 幢 迎 少 君	忽 从 林 下 升 天 去	空 使 时 人 礼 白 云
日 落 - 天 际 - 数 声 - 何 处 - 日 落==日 落 潮 生 水 气 昏	回 头 天 际 月 如 痕	数 声 寥 落 渔 家 笛	吹 入 蒹 葭 何 处 村
梦 思 - 阴 寒 - 笔 把 - 过 花 - 览 慰==梦 思 游 览 慰 衰 迟	起 耐 阴 寒 不 自 持	捉 笔 把 杯 吾 技 痒	可 堪 袖 手 过 花 时
秋 来 - 看 山 - 秋 色 - 风 吹 - 秋 来==秋 来 客 思 渺 烟 波	湖 上 看 山 秋 更 多	只 恐 佳 人 怨 秋 色	晚 风 吹 断 采 菱 歌
月 中 - 断 肠 - 花 品 - 姚 黄 - 雪 中==月 中 疏 影 雪 中 香	只 为 无 言 更 断 肠	曾 与 诗 翁 定 花 品	一 丘 一 壑 过 姚 黄
风 吹 - 玉 京 - 春 酒 - 泉 声 - 风 吹==朔 风 吹 雪 满 都 城	晓 踏 骅 骝 访 玉 京	相 引 槽 头 看 春 酒	细 流 三 峡 夜 泉 声
凄 凉 - 无 心 - 风 味 - 梅 花 - 凄 凉==凄 凉 池 馆 欲 栖 鸦	采 笔 无 心 赋 落 霞	惆 怅 后 庭 风 味 薄	自 锄 明 月 种 梅 花
竹 外 - 粼 粼 - 垂 钓 - 石 上 - 竹 外==竹 里 茅 茨 竹 外 溪	粼 粼 白 石 护 渔 矶	想 应 日 日 来 垂 钓	石 上 蓑 衣 不 带 归
乌 府 - 林 中 - 水 亭 - 时 染 - 乌 府==鹤 色 纱 蒙 乌 府 寄	裁 衣 不 称 著 林 中	水 亭 君 有 亲 题 处	留 待 他 时 染 碧 笼
五 花 - 水 村 - 调 羹 - 山 林 - 五 花==傲 雪 含 芳 破 五 花	水 村 山 郭 傍 诗 家	本 为 金 鼎 调 羹 物	寥 落 山 林 老 岁 华
沧 海 - 白 玉 - 垂 虹 - 阑 干 - 沧 海==卷 来 沧 海 黄 银 浪	飞 出 层 云 白 玉 团	千 古 垂 虹 奇 绝 处	独 凭 三 百 赤 阑 干
白 日 - 玉 壶 - 草 堂 - 竹 风 - 白 日==白 日 未 中 气 色 明	玉 壶 兴 入 西 源 行	草 堂 羡 我 不 共 往	竹 风 为 汝 致 幽 清
万 壑 - 横 空 - 拿 云 - 石 桥 - 万 壑==万 壑 云 霾 凝 不 消	横 空 突 起 老 龙 腰	虚 皇 未 放 拿 云 去	留 与 金 仙 作 石 桥
今 宵 - 今 宵 - 寂 寞 - 月 色 - 佳 辰==佳 辰 三 五 是 今 宵	恰 则 今 宵 细 雨 飘	天 念 孤 舟 人 寂 寞	不 教 月 色 故 相 撩
鲜 明 - 春 深 - 敌 国 - 倾 城 - 雨 余==雨 余 花 色 倍 鲜 明	最 是 春 深 多 晚 晴	美 酒 壮 人 如 敌 国	千 金 一 笑 买 倾 城
半 面 - 人 诗 - 千 岩 - 芒 鞋 - 半 面==元 自 与 山 无 半 面	昔 人 诗 裹 旧 相 知	西 风 吹 上 千 岩 顶	竹 杖 芒 鞋 住 几 时
缕 缕 - 憔 悴 - 江 上 - 垂 杨 - 缕 缕==缕 缕 柔 条 不 奈 春	为 谁 憔 悴 把 眉 颦	年 来 江 上 多 离 别	不 信 垂 杨 管 得 人
龙 鳞 - 黄 鹤 - 羌 笛 - 倚 栏 - 长 天==长 天 云 扫 碧 龙 鳞	黄 鹤 楼 前 白 玉 轮	秋 意 正 随 羌 笛 怨	夜 深 愁 杀 倚 栏 人
幽 花 - 光 辉 - 荒 草 - 叩 扉 - 花 明==独 树 幽 花 明 屋 角	顿 惊 门 户 有 光 辉	向 来 荒 草 几 埋 径	今 日 行 人 欲 叩 扉
夜 窗 - 数 竿 - 今 朝 - 秋 声 - 昨 夜==昨 夜 窗 前 风 月 时	数 竿 疏 影 响 书 帏	今 朝 拓 向 溪 藤 上	犹 觉 秋 声 笔 底 飞
行 色 - 吹 笛 - 濯 足 - 白 云 - 荡 漾==秋 光 荡 漾 满 行 色	邻 舟 吹 笛 不 堪 闻	洞 庭 濯 足 一 樽 酒	夫 君 不 来 空 白 云
舞 风 - 玉 色 - 三 白 - 新 诗 - 舞 风==无 数 天 花 斗 舞 风	迷 离 玉 色 映 寒 空	共 夸 破 腊 逾 三 白	更 喜 新 诗 报 屡 丰
望 海 - 重 重 - 人 相 - 信 通 - 望 海==五 髻 峰 头 望 海 东	烟 重 重 又 水 重 重	同 人 相 见 论 心 事	又 得 西 来 一 信 通
江 水 - 枫 叶 - 溶 溶 - 袅 袅 - 江 水==我 画 蓝 江 水 悠 悠	爱 晚 亭 上 枫 叶 愁	秋 月 溶 溶 照 佛 寺	香 烟 袅 袅 绕 经 楼
宫 阙 - 海 市 - 纸 钱 - 风 阵 - 宫 阙==宫 阙 金 银 火 化 时	蜃 楼 海 市 望 迷 离	纸 钱 也 要 飘 洋 用	惑 得 台 风 阵 阵 吹
猗 猗 - 幽 香 - 丹 青 - 写 照 - 水 滨==袅 袅 猗 猗 绿 水 滨	幽 香 孤 节 自 相 亲	世 间 尽 有 丹 青 手	写 照 端 须 似 此 人
荒 村 - 声 声 - 柴 扉 - 青 山 - 荒 村==夜 宿 荒 村 曰 范 田	声 声 频 滴 屋 檐 前	朝 来 揭 起 柴 扉 看	满 目 青 山 白 玉 巅
七 宝 - 高 低 - 十 年 - 树 间 - 七 宝==邓 尉 山 边 七 宝 滩	高 低 如 画 好 溪 山	十 年 游 赏 经 行 遍	多 少 名 题 竹 树 间
相 随 - 经 春 - 车 辙 - 寂 寞 - 病 身==形 影 相 随 一 病 身	穷 愁 忽 忽 又 经 春	为 传 车 辙 来 何 自	知 是 君 存 寂 寞 滨
红 紫 - 春 风 - 征 人 - 枝 头 - 故 园==故 园 红 紫 自 芳 菲	不 在 春 风 著 意 只	待 得 征 人 重 回 首	枝 头 香 雪 已 纷 披
观 月 - 石 桥 - 与 今 - 清 光 - 东 海==常 观 月 从 东 海 出	想 照 石 桥 旁 畔 人	试 问 当 年 与 今 日	清 光 不 改 只 如 新
漫 漫 - 蓑 笠 - 披 图 - 风 随 - 漫 漫==四 山 飞 雪 正 漫 漫	蓑 笠 何 人 把 钓 竿	六 月 披 图 方 执 热	风 随 玉 麈 不 胜 寒
狂 歌 - 南 山 - 胸 次 - 万 里 - 狂 歌==小 市 狂 歌 醉 堕 冠	南 山 山 色 跨 牛 看	放 翁 胸 次 谁 能 测	万 里 秋 空 未 是 宽
中 天 - 春 日 - 杯 盘 - 醉 颜 - 山 河==中 天 未 复 旧 山 河	春 日 同 民 强 一 过	草 草 杯 盘 等 闲 置	愁 多 易 觉 醉 颜 酡
流 泉 - 田 头 - 春 来 - 犁 锄 - 流 泉==竹 外 流 泉 绕 屋 鸣	田 头 有 水 不 忧 晴	春 来 岂 问 芳 菲 事	只 办 犁 锄 要 早 耕
雨 过 - 西 风 - 事 凭 - 愁 入 - 山 城==雨 过 山 城 日 又 西	西 风 一 阵 木 犀 开	莫 将 心 事 凭 秋 雁	恐 带 边 愁 入 梦 来
九 州 - 零 落 - 松 叶 - 上 冢 - 九 州==气 概 堂 堂 压 九 州	谁 知 零 落 此 荒 丘	却 烦 野 老 编 松 叶	怕 有 牛 羊 上 冢 头
千 玑 - 斜 风 - 安 贫 - 缘 阶 - 千 玑==千 玑 万 绯 照 庭 除	细 雨 斜 风 拂 座 隅	莫 道 长 安 贫 似 磬	缘 阶 绕 砌 尽 真 珠
如 冰 - 光 华 - 今 夕 - 何 处 - 如 冰==幽 人 门 巷 冷 如 冰	使 节 光 华 肯 再 登	今 夕 青 灯 话 三 馆	明 年 何 处 说 庐 陵
百 年 - 三 舍 - 看 花 - 采 芹 - 百 年==百 年 亭 子 一 朝 新	三 舍 先 生 遇 拂 尘	城 里 看 花 多 处 所	此 中 只 待 采 芹 人
清 风 - 十 年 - 太 平 - 人 间 - 清 风==东 南 官 吏 欠 清 风	五 十 年 来 世 道 穷	须 信 太 平 在 今 日	人 间 又 有 杜 祁 公
无 始 - 动 地 - 静 坐 - 独 步 - 伎 俩==伎 俩 全 无 始 解 空	雨 花 动 地 泄 机 锋	欲 求 静 坐 无 方 所	独 步 寥 寥 宇 宙 中
雪 花 - 夹 道 - 佳 句 - 彩 毫 - 雪 花==云 阴 低 重 雪 花 繁	夹 道 欢 谣 引 使 轩	何 处 邮 亭 链 佳 句	彩 毫 挥 罢 索 清 樽
孤 云 - 深 宫 - 旌 旗 - 白 云 - 独 鹤==孤 云 独 鹤 共 悠 悠	别 作 深 宫 一 段 愁	万 乘 旌 旗 何 处 在	白 云 犹 似 汉 时 秋
暮 色 - 我 舟 - 谁 家 - 水 鸟 - 暮 色==暮 色 苍 然 遂 不 开	我 舟 亦 欲 傍 崖 隈	不 唯 帆 过 谁 家 宿	水 鸟 林 栖 亦 并 来
知 几 - 桃 李 - 天 工 - 桂 花 - 金 谷==金 谷 园 林 知 几 家	竞 栽 桃 李 作 春 华	无 人 得 似 天 工 巧	明 月 中 间 种 桂 花
秋 光 - 推 迁 - 杨 柳 - 芙 蓉 - 秋 光==检 点 秋 光 莫 问 天	只 从 鸿 雁 见 推 迁	未 霜 杨 柳 老 多 病	既 雨 芙 蓉 美 少 年
幽 怀 - 高 黄 - 书 几 - 千 年 - 幽 怀==幽 怀 赋 好 欧 公 赏	实 录 文 高 黄 子 称	复 性 一 书 几 有 道	千 年 真 可 续 韩 灯
灵 池 - 凄 凉 - 云 车 - 弦 管 - 灵 池==奉 灵 池 馆 锁 幽 深	遗 迹 凄 凉 故 老 心	维 岳 云 车 时 一 下	直 疑 弦 管 有 来 音
龙 鳞 - 孤 臣 - 方 寸 - 惟 有 - 龙 鳞==屡 批 龙 鳞 眷 未 衰	孤 臣 万 死 负 恩 私	玉 阶 方 寸 从 容 语	惟 有 天 知 与 上 知
万 壑 - 着 雨 - 中 大 - 云 阴 - 摇 风==老 桧 摇 风 万 壑 声	梨 花 着 雨 四 山 明	龛 中 大 士 好 看 客	排 遣 云 阴 作 晚 晴
欲 满 - 携 持 - 凌 波 - 赋 诗 - 欲 满==红 紫 商 量 欲 满 枝	持 春 觞 豆 好 携 持	便 须 载 酒 凌 波 去	底 事 黄 堂 独 赋 诗
西 风 - 沧 洲 - 芙 蓉 - 树 头 - 西 风==一 处 西 风 一 处 愁	又 逢 鸣 雁 在 沧 洲	芙 蓉 不 分 秋 萧 索	斗 拆 繁 红 满 树 头
高 低 - 薜 荔 - 岩 下 - 忘 归 - 高 低==翠 屏 青 紫 互 高 低	清 净 仙 人 薜 荔 衣	正 好 观 心 坐 岩 下	忘 归 却 是 不 忘 归
轻 舟 - 阴 凝 - 阡 陌 - 教 一 - 轻 舟==已 办 轻 舟 著 脚 登	笑 渠 河 伯 故 阴 凝	征 车 政 欲 周 阡 陌	赢 得 天 教 一 夜 冰
一 曲 - 断 流 - 夹 岸 - 小 桥 - 一 曲==清 溪 一 曲 绕 朱 楼	荷 密 风 稠 咽 断 流	夹 岸 垂 杨 烟 细 细	小 桥 流 水 即 沧 洲
红 尾 - 晚 烟 - 香 好 - 开 媚 - 疏 红==山 末 疏 红 尾 尾 霞	晚 烟 丛 薄 是 人 家	移 船 更 喜 吹 香 好	枸 橘 药 开 媚 浅 沙
寄 书 - 羽 葆 - 俱 不 - 如 烟 - 寄 书==康 成 迹 寄 书 带 草	玄 德 祥 标 羽 葆 桑	名 与 此 山 俱 不 朽	何 如 烟 杪 郁 苍 苍
金 徽 - 清 音 - 无 生 - 露 滴 - 金 徽==月 作 金 徽 风 作 弦	清 音 不 在 指 端 传	有 时 弹 罢 无 生 曲	露 滴 松 梢 鹤 未 眠
风 前 - 玉 容 - 残 雪 - 异 香 - 风 前==风 前 笑 颊 轻 桃 艳	雨 带 啼 痕 白 玉 容	蝶 舞 只 疑 残 雪 压	月 明 惟 觉 异 香 浓
苍 鹰 - 岩 下 - 愁 胡 - 寒 梢 - 苍 鹰==苍 鹰 俊 翼 倦 摩 霄	岩 下 深 云 稳 寄 巢	且 放 愁 胡 双 眼 闭	恐 惊 群 鹭 宿 寒 梢
三 秋 - 楼 台 - 杵 臼 - 知 更 - 三 秋==三 秋 桂 子 玉 舒 花	天 上 楼 台 出 帝 家	只 许 阿 兔 操 杵 臼	不 知 更 有 玉 虾 蟆
更 莫 - 本 自 - 途 中 - 桃 摘 - 空 更==念 念 皆 空 更 莫 疑	心 王 本 自 绝 多 知	艰 勤 长 向 途 中 觅	掉 却 甜 桃 摘 醋 梨
逸 兴 - 声 和 - 飞 凫 - 门 前 - 逸 兴==斗 酒 双 柑 逸 兴 多	春 风 惯 听 鸟 声 和	自 嗤 叶 令 飞 凫 后	只 有 门 前 雀 可 罗
岁 月 - 夕 阳 - 知 秋 - 短 篱 - 岁 月==匆 匆 岁 月 为 谁 忙	静 倚 梅 窗 到 夕 阳	老 菊 不 知 秋 已 去	晚 风 时 送 短 篱 香
梅 花 - 流 东 - 新 年 - 笑 语 - 梅 花==平 旦 梅 花 契 冷 红	越 香 何 限 水 流 东	陈 年 翠 袖 新 年 恨	尽 在 吹 香 笑 语 中
江 南 - 归 时 - 忠 义 - 七 日 - 江 南==江 南 二 月 草 青 青	送 子 归 时 已 满 汀	谁 信 而 今 有 忠 义	只 知 七 日 哭 秦 庭
道 士 - 散 发 - 月 上 - 竹 间 - 道 士==洞 元 道 士 酒 中 仙	散 发 人 间 五 十 年	醉 后 不 知 山 月 上	竹 间 横 枕 一 琴 眠
伴 月 - 芦 花 - 薜 荔 - 林 泉 - 娟 娟==一 纶 长 伴 月 娟 娟	满 岸 芦 花 入 短 舷	薜 荔 未 堪 华 衮 用	此 身 甘 作 老 林 泉
尘 埃 - 风 月 - 碧 树 - 红 莲 - 两 岸==两 岸 尘 埃 终 不 到	四 檐 风 月 冷 无 声	路 从 碧 树 阴 中 断	人 向 红 莲 影 里 行
疏 疏 - 蒲 团 - 似 秋 - 跳 珠 - 疏 疏==四 檐 密 密 又 疏 疏	声 到 蒲 团 醉 梦 苏	恰 似 秋 眠 天 竺 寺	东 轩 窗 外 听 跳 珠
带 雨 - 围 山 - 黄 梅 - 人 烟 - 带 雨==絮 帽 曳 丝 云 带 雨	琼 梳 环 髻 水 围 山	江 村 五 月 黄 梅 过	十 里 人 烟 渺 莽 间
落 英 - 逐 风 - 夕 阳 - 月 明 - 落 英==上 有 繁 葩 下 落 英	红 波 动 荡 逐 风 行	夕 阳 开 处 犹 光 艳	何 况 今 农 值 月 明
江 山 - 渔 父 - 些 堪 - 诗 人 - 精 神==江 山 梅 竹 好 精 神	渔 父 畦 丁 也 带 真	终 是 有 些 堪 恨 处	画 中 更 欠 著 诗 人
稀 星 - 吹 角 - 五 更 - 一 曲 - 稀 星==寒 耿 稀 星 照 碧 霄	月 楼 吹 角 夜 江 遥	五 更 人 起 烟 霜 静	一 曲 残 声 遍 落 潮
翠 崖 - 烟 霞 - 半 天 - 雪 花 - 翠 崖==谁 挽 天 河 泻 翠 崖	一 条 飞 瀑 界 烟 霞	只 愁 风 力 半 天 劲	吹 向 人 间 作 雪 花
傍 山 - 碎 玉 - 道 人 - 新 月 - 傍 山==僧 庵 恰 好 傍 山 坳	门 外 幽 泉 碎 玉 敲	棋 罢 道 人 心 似 水	一 钩 新 月 挂 松 梢
菰 叶 - 莲 子 - 江 水 - 凤 凰 - 菰 叶==茨 菰 叶 烂 别 西 湾	莲 子 花 开 犹 未 还	妾 梦 不 离 江 水 上	人 传 郎 在 凤 凰 山
莲 花 - 香 尘 - 看 花 - 来 唤 - 莲 花==十 里 莲 花 过 眼 新	水 风 犹 自 起 香 尘	明 年 还 约 看 花 侣	来 唤 湖 边 雪 藕 人
禾 黍 - 一 片 - 明 月 - 夜 深 - 千 年==六 宫 禾 黍 千 年 恨	一 片 江 山 万 古 情	明 月 不 关 兴 废 事	夜 深 还 照 石 头 城
蛾 眉 - 按 剑 - 沧 浪 - 取 当 - 蛾 眉==自 古 蛾 眉 嫉 者 多	须 防 按 剑 向 随 和	此 身 更 似 沧 浪 水	听 取 当 年 孺 子 歌
西 山 - 寂 寥 - 沧 洲 - 疏 钟 - 西 山==日 堕 西 山 烟 水 昏	寂 寥 鸡 犬 数 家 村	沧 洲 归 鹭 客 停 棹	古 寺 疏 钟 人 掩 门
春 风 - 窗 前 - 园 丁 - 清 声 - 春 风==好 是 春 风 长 育 天	阑 干 低 护 晓 窗 前	园 丁 未 必 知 吾 事	补 阙 清 声 四 百 年
江 南 - 石 上 - 知 更 - 香 烟 - 江 南==江 南 风 致 说 僧 家	石 上 清 香 竹 里 茶	法 藏 名 僧 知 更 好	香 烟 茶 晕 满 袈 裟
天 台 - 扰 扰 - 师 去 - 清 风 - 天 台==天 台 深 隐 许 谁 同	扰 扰 浮 世 万 事 空	终 约 携 瓶 访 师 去	水 边 松 下 啸 清 风
花 落 - 随 风 - 重 阳 - 酒 盏 - 花 落==曾 见 春 花 落 万 红	不 然 随 雨 即 随 风	如 何 得 到 重 阳 日	浮 在 陶 家 酒 盏 中
曲 折 - 疏 松 - 席 地 - 风 送 - 曲 折==蛇 行 曲 折 度 平 冈	乱 竹 疏 松 荫 佛 场	乞 得 曲 肱 方 席 地	秋 风 送 我 上 羲 皇
客 路 - 蝶 梦 - 啼 鹃 - 一 声 - 客 路==奔 趋 客 路 困 尘 泥	蚁 梦 方 酣 蝶 梦 飞	赖 有 啼 鹃 知 此 意	一 声 声 劝 不 如 归
长 滩 - 水 深 - 如 烟 - 漠 漠 - 长 滩==鹭 立 长 滩 本 为 饥	水 深 鱼 没 定 奚 为	何 如 烟 雨 青 林 畔	漠 漠 冥 冥 纵 所 之
龙 门 - 玉 宇 - 异 书 - 光 彩 - 龙 门==升 龙 门 内 屋 千 楹	玉 宇 金 题 映 紫 庭	卷 帙 异 书 三 十 万	至 今 光 彩 动 奎 星
有 情 - 随 波 - 照 水 - 春 归 - 有 情==凫 鹜 迎 船 似 有 情	随 波 故 起 绿 粼 粼	野 花 照 水 开 无 主	谁 信 春 归 已 两 旬
萧 萧 - 山 家 - 东 篱 - 未 见 - 白 发==白 发 萧 萧 映 帽 纱	相 扶 访 菊 到 山 家	搀 先 一 日 东 篱 醉	要 见 人 间 未 见 花
元 正 - 佳 辰 - 柳 色 - 梅 花 - 元 正==昨 日 元 正 今 日 春	佳 辰 并 作 一 翻 新	试 看 柳 色 遽 如 许	无 耐 梅 花 憔 悴 人
万 里 - 泪 痕 - 何 当 - 一 曲 - 千 里==千 里 万 里 西 复 东	山 川 长 在 泪 痕 中	何 当 共 剪 西 窗 烛	一 曲 琵 琶 酒 一 锺
归 来 - 汀 洲 - 荧 荧 - 结 网 - 归 来==艇 子 归 来 月 未 升	汀 洲 宛 转 夕 烟 凝	荧 荧 一 点 垂 杨 下	知 是 渔 人 结 网 灯
渺 渺 - 草 茸 - 柳 花 - 城 头 - 渺 渺==春 江 渺 渺 抱 墙 流	烟 草 茸 茸 一 片 愁	吹 尽 柳 花 人 不 见	青 旗 催 日 下 城 头
入 枕 - 棱 棱 - 梅 花 - 明 月 - 初 晴==远 钟 入 枕 雪 初 晴	衾 铁 棱 棱 梦 不 成	起 傍 梅 花 读 周 易	一 窗 明 月 四 檐 声
镞 三 - 休 拈 - 龙 舟 - 锦 标 - 三 关==一 镞 三 关 俱 透 脱	从 前 汗 马 休 拈 掇	须 知 旧 阁 快 龙 舟	当 年 曾 把 锦 标 夺
虞 皇 - 彤 墀 - 玉 色 - 归 来 - 获 面==六 年 不 获 面 虞 皇	重 对 彤 墀 昼 漏 长	玉 色 粹 温 天 一 笑	归 来 满 袖 有 浓 香
东 湖 - 陈 迹 - 殷 勤 - 诗 情 - 东 湖==君 忆 东 湖 不 久 归	我 思 陈 迹 恍 难 追	殷 勤 为 报 莺 花 说	止 有 诗 情 似 旧 时
诗 成 - 归 心 - 轻 薄 - 井 底 - 诗 成==百 首 诗 成 遇 赏 音	云 何 容 易 动 归 心	少 陵 不 具 为 轻 薄	笑 杀 王 杨 井 底 沈
山 郭 - 提 壶 - 林 中 - 思 归 - 山 郭==雪 泥 滑 滑 到 山 郭	提 壶 劝 沽 亦 不 恶	林 中 解 道 不 如 归	家 人 应 念 思 归 乐
杨 柳 - 松 枝 - 湘 江 - 无 言 - 杨 柳==杨 柳 青 青 满 路 垂	赠 行 惟 折 古 松 枝	停 舟 一 对 湘 江 哭	哭 罢 无 言 君 自 知
腊 日 - 僧 窗 - 思 归 - 道 人 - 腊 日==去 年 腊 日 访 孤 山	曾 借 僧 窗 半 日 闲	不 为 思 归 对 妻 子	道 人 有 约 径 须 还
花 雨 - 丛 桂 - 仙 骨 - 八 公 - 送 春==淮 南 花 雨 送 春 还	丛 桂 阴 阴 郡 阁 闲	自 是 刘 安 有 仙 骨	谪 居 犹 近 八 公 山
院 落 - 错 莫 - 蜜 房 - 重 阳 - 秋 深==院 落 秋 深 数 菊 丛	缘 花 错 莫 两 三 蜂	蜜 房 岁 晚 能 多 少	酒 盏 重 阳 自 不 供
啼 鸟 - 香 重 - 东 风 - 杨 花 - 梦 回==啼 鸟 声 中 午 梦 回	篆 香 重 拨 已 成 灰	东 风 似 恨 春 归 去	吹 送 杨 花 入 户 来
蔓 草 - 夕 阳 - 树 老 - 菊 花 - 蔓 草==城 头 蔓 草 受 新 霜	天 外 孤 鸿 叫 夕 阳	送 客 情 怀 枫 树 老	着 人 襟 袖 菊 花 香
锦 城 - 山 阴 - 飞 花 - 东 郭 - 锦 城==锦 城 一 别 鬓 成 丝	今 日 山 阴 送 杰 师	乱 絮 飞 花 扑 行 路	正 如 东 郭 放 船 时
浪 花 - 船 尾 - 一 水 - 流 东 - 浪 花==船 头 触 处 浪 花 生	船 尾 随 人 山 影 行	一 水 到 家 能 几 许	顺 流 东 下 片 时 程
梅 花 - 梅 花 - 江 天 - 故 人 - 梅 花==羞 见 梅 花 照 客 身	梅 花 长 好 客 长 贫	江 天 摇 落 年 华 晚	何 处 青 山 有 故 人
春 来 - 黄 花 - 重 阳 - 一 日 - 和 气==午 风 和 气 借 春 来	雨 足 黄 花 越 节 开	要 识 重 阳 真 富 贵	弟 兄 一 日 历 三 台
十 年 - 白 发 - 诗 情 - 一 曲 - 十 年==三 十 年 前 梦 里 过	重 将 白 发 对 青 蛾	只 应 酒 量 诗 情 在	消 得 筵 前 一 曲 歌
氤 氲 - 天 香 - 一 枝 - 胸 中 - 氤 氲==七 月 浊 暑 气 氤 氲	天 香 忽 堕 明 月 轮	一 枝 先 入 西 风 手	洗 我 三 伏 胸 中 尘
五 更 - 梅 影 - 嬉 游 - 梅 花 - 五 更==一 觉 悠 然 已 五 更	窗 横 梅 影 月 偏 明	年 时 记 得 嬉 游 罢	犹 为 梅 花 梦 不 成
羊 裘 - 星 辰 - 洛 阳 - 鱼 矶 - 羊 裘==羊 裘 老 人 只 念 归	安 用 星 辰 动 紫 微	洛 阳 城 中 市 儿 眼	情 知 不 识 钓 鱼 矶
随 风 - 桃 李 - 名 驹 - 倚 栏 - 随 风==堕 絮 随 风 花 作 尘	黄 楼 桃 李 不 成 春	只 今 容 有 名 驹 子	困 倚 栏 干 一 欠 伸
柳 桥 - 雄 豪 - 道 路 - 阳 益 - 早 岁==早 岁 无 知 到 柳 桥	黄 流 澎 湃 客 雄 豪	自 从 道 路 无 形 势	今 日 睢 阳 益 谩 劳
窥 人 - 趁 蝶 - 宜 男 - 远 游 - 窥 人==秦 女 窥 人 不 解 羞	攀 花 趁 蝶 出 墙 头	胸 前 空 带 宜 男 草	嫁 得 萧 郎 爱 远 游
下 乐 - 宣 室 - 来 往 - 归 来 - 乐 生==聊 城 欲 下 乐 生 去	宣 室 厘 成 贾 传 归	来 往 炎 荒 六 千 里	归 来 却 得 及 春 菲
日 永 - 铿 金 - 酣 山 - 吟 诗 - 日 永==圆 玉 响 中 销 日 永	铿 金 徽 外 作 风 悲	万 蚁 战 酣 山 雨 至	饥 肠 雷 动 且 吟 诗
思 亲 - 自 由 - 子 送 - 来 无 - 思 亲==日 日 思 亲 未 拜 亲	何 时 乞 我 自 由 身	同 来 客 子 送 归 尽	更 送 後 来 无 数 人
玉 勒 - 十 年 - 中 流 - 有 深 - 玉 勒==玉 勒 金 台 逐 去 尘	十 年 多 少 渡 江 民	中 流 试 扣 金 山 老	曾 有 深 衣 过 鲁 人
山 已 - 名 园 - 青 山 - 心 清 - 已 作==近 山 已 作 岩 壑 想	道 边 名 园 堪 税 鞅	谁 家 屋 上 无 青 山	惟 有 心 清 见 山 爽
柳 丝 - 罗 绮 - 冶 亦 - 鸥 眠 - 炊 烟==柳 丝 舞 困 起 炊 烟	罗 绮 相 催 欲 上 船	贵 冶 亦 知 春 有 夜	暖 沙 还 付 白 鸥 眠
秋 风 - 把 酒 - 江 鸥 - 三 三 - 江 上==江 上 秋 风 吹 客 衣	江 边 把 酒 对 斜 晖	江 鸥 不 解 离 人 意	故 作 三 三 两 两 飞
远 水 - 天 光 - 雁 过 - 孤 影 - 远 水==云 连 天 远 水 连 云	一 片 天 光 欲 半 昏	新 月 似 怜 新 雁 过	伴 他 孤 影 落 前 村
名 花 - 层 层 - 春 色 - 牡 丹 - 名 花==禁 围 处 处 锁 名 花	步 障 层 层 簇 绛 纱	斟 酌 君 恩 似 春 色	牡 丹 枝 上 独 繁 华
凤 辇 - 宫 莺 - 落 花 - 阳 作 - 长 门==春 尽 长 门 凤 辇 稀	宫 莺 百 啭 绕 蔷 薇	落 花 千 片 如 红 雪	飞 入 昭 阳 作 燕 泥
一 株 - 红 锦 - 团 栾 - 明 年 - 一 株==东 园 一 株 千 叶 茶	阿 翁 手 栽 红 锦 花	今 年 团 栾 且 同 看	明 年 大 哥 天 一 涯
去 终 - 南 来 - 卧 龙 - 古 今 - 孔 明==孔 明 西 去 终 扶 汉	散 骑 南 来 莫 拯 唐	同 时 卧 龙 殊 用 舍	古 今 易 地 两 南 阳
彤 闱 - 薄 晚 - 清 光 - 楼 台 - 彤 闱==彤 闱 晓 辟 万 鞍 回	玉 辂 春 游 薄 晚 开	渭 北 清 光 摇 草 树	州 南 嘉 景 入 楼 台
对 镜 - 春 寒 - 珊 瑚 - 春 风 - 对 镜==懒 向 妆 台 对 镜 鸾	罗 衣 怯 薄 正 春 寒	黄 金 络 索 珊 瑚 坠	独 立 春 风 看 牡 丹
宛 转 - 采 莲 - 前 溪 - 莲 花 - 宛 转==棹 讴 宛 转 发 中 川	队 队 红 妆 竞 采 莲	欲 就 前 溪 问 名 姓	莲 花 当 住 木 兰 船
南 山 - 风 迟 - 有 象 - 春 色 - 晓 云==南 山 迎 座 晓 云 开	阊 阖 风 迟 绝 点 埃	受 职 百 神 知 有 象	会 稽 春 色 过 江 来
重 阳 - 菊 花 - 约 能 - 张 罗 - 重 阳==忽 忽 重 阳 今 一 月	菊 花 数 朵 见 城 根	前 诗 有 约 能 从 否	不 厌 张 罗 幸 过 门
江 南 - 凤 鸣 - 十 月 - 千 秋 - 江 南==楼 船 载 日 下 江 南	吹 凤 鸣 鼍 御 酒 酣	吴 花 十 月 迎 黄 幄	隋 柳 千 秋 映 锦 帆
刺 史 - 假 平 - 遗 臭 - 万 古 - 刺 史==不 识 康 庐 真 刺 史	可 怜 德 佑 假 平 章	木 绵 老 鬼 死 遗 臭	万 古 秋 崖 姓 字 香
绰 约 - 碧 玉 - 身 轻 - 罗 袜 - 美 人==美 人 绰 约 万 花 西	宝 马 横 翻 碧 玉 蹄	总 是 身 轻 如 燕 子	落 来 罗 袜 不 沾 泥
野 梅 - 清 香 - 一 尖 - 悬 针 - 野 梅==东 风 微 破 野 梅 心	著 骨 清 香 已 不 禁	绿 剌 一 尖 双 菡 子	错 书 小 字 带 悬 针
丽 句 - 座 主 - 禅 心 - 馀 霞 - 丽 句==姓 白 使 君 无 丽 句	名 休 座 主 有 新 文	禅 心 不 合 生 分 别	莫 爱 馀 霞 嫌 碧 云
万 重 - 前 村 - 风 吹 - 七 斤 - 黯 黯==海 天 黯 黯 万 重 云	欲 到 前 村 路 不 分	烈 风 吹 雪 深 一 丈	大 布 缝 衫 重 七 斤
霜 叶 - 年 不 - 间 书 - 何 处 - 霜 叶==莫 笑 青 衫 霜 叶 枯	六 年 不 改 旧 称 呼	人 间 书 疏 非 吾 事	菜 缕 春 盘 何 处 无
远 水 - 西 风 - 一 片 - 扬 州 - 远 水==远 水 疏 星 影 动 摇	西 风 落 木 景 萧 条	伤 心 一 片 船 头 月	犹 照 扬 州 廿 四 桥
层 峦 - 清 凉 - 石 头 - 兴 亡 - 耸 翠==耸 翠 层 峦 接 碧 空	清 凉 襟 袖 拂 天 风	石 头 城 一 西 临 望	千 古 兴 亡 慨 叹 中
如 神 - 松 竹 - 皆 面 - 岁 寒 - 如 神==梅 花 屡 见 笔 如 神	松 竹 宁 知 更 逼 真	百 卉 千 华 皆 面 友	岁 寒 只 见 此 三 人
一 行 - 云 程 - 时 却 - 梅 花 - 一 行==欲 寿 吾 前 酒 一 行	走 三 百 里 火 云 程	热 时 却 有 寒 时 节	汝 母 梅 花 腊 底 生
千 株 - 天 影 - 月 中 - 故 园 - 千 株==桂 林 须 产 千 株 桂	未 解 当 天 影 日 开	我 到 月 中 收 得 种	为 君 移 向 故 园 栽
望 远 - 暖 风 - 江 流 - 春 愁 - 望 远==小 阁 开 帘 望 远 岑	暖 风 晴 日 啭 幽 禽	胥 江 流 水 清 无 底	较 比 春 愁 一 样 深
潇 洒 - 一 幅 - 烹 茶 - 汲 水 - 潇 洒==潇 洒 精 庐 此 吒 家	暑 风 一 幅 岩 乌 纱	客 来 祗 可 烹 茶 待	旋 督 山 童 汲 水 花
玉 女 - 曲 水 - 梦 断 - 逐 人 - 玉 女==谁 将 玉 女 对 妆 台	曲 水 分 明 一 鉴 开	铁 石 肺 肠 尘 梦 断	任 他 云 雨 逐 人 来
如 拳 - 带 叶 - 山 家 - 江 天 - 如 拳==开 皱 紫 栗 如 拳 大	带 叶 黄 柑 染 袖 香	天 与 山 家 讲 邻 好	江 天 昨 夜 有 新 霜
芭 蕉 - 帘 幕 - 画 栏 - 花 梢 - 风 猎==晓 风 猎 猎 卷 芭 蕉	帘 幕 深 深 燕 子 巢	十 二 画 栏 都 倚 遍	一 双 蝴 蝶 上 花 梢
吟 诗 - 思 归 - 三 年 - 携 琴 - 吟 诗==朝 客 吟 诗 送 羽 衣	应 知 彭 泽 久 思 归	三 年 官 满 谁 留 得	领 鹤 携 琴 赋 式 微
闲 行 - 芊 芊 - 归 去 - 杜 鹃 - 闲 行==骢 骑 闲 行 不 用 鞭	绿 阴 原 上 草 芊 芊	是 谁 催 促 春 归 去	却 把 金 丸 打 杜 鹃
芳 草 - 清 波 - 独 坐 - 凉 天 - 芳 草==因 随 芳 草 行 来 远	为 爱 清 波 归 去 迟	独 步 独 吟 仍 独 坐	初 凉 天 气 未 寒 时
临 水 - 潇 潇 - 荷 叶 - 五 更 - 临 水==结 亭 临 水 似 舟 中	夜 雨 潇 潇 乱 打 篷	荷 叶 晓 看 元 不 湿	却 疑 误 听 五 更 风
古 殿 - 千 古 - 尘 土 - 欲 飞 - 古 殿==嵯 峨 古 殿 记 飞 来	千 古 传 闻 亦 怪 哉	龙 象 渐 随 尘 土 化	却 疑 神 物 欲 飞 回
野 色 - 御 沟 - 无 人 - 牡 丹 - 野 色==野 色 晴 宜 上 阁 看	树 阴 遥 映 御 沟 寒	豪 家 旧 宅 无 人 住	空 见 朱 门 锁 牡 丹
春 雪 - 暮 霞 - 斜 风 - 窗 前 - 春 雪==屋 头 积 雨 涨 春 雪	舍 北 夭 桃 堆 暮 霞	细 雨 斜 风 妨 病 起	窗 前 把 玩 数 枝 花
辅 臣 - 麒 麟 - 如 画 - 云 台 - 辅 臣==妪 貌 何 妨 至 辅 臣	猴 形 亦 有 上 麒 麟	伏 波 眉 目 空 如 画	不 是 云 台 剑 佩 人
岑 寂 - 衡 门 - 风 雨 - 萧 条 - 岑 寂==荒 山 岑 寂 晚 鸡 号	独 闭 衡 门 守 一 瓢	风 雨 似 秋 君 莫 怪	容 愁 逢 处 易 萧 条
园 林 - 玉 簪 - 红 丝 - 蜂 采 - 园 林==海 客 园 林 珠 树 木	水 仙 宾 从 玉 簪 裳	锦 桃 每 用 红 丝 楼	蜂 采 须 成 白 蜜 房
峥 嵘 - 寂 寞 - 垂 杨 - 临 水 - 峥 嵘==峥 嵘 岁 事 春 将 至	寂 寞 梅 花 雪 失 期	独 有 垂 杨 伴 幽 怨	岂 堪 临 水 折 长 枝
风 弄 - 户 穿 - 拘 束 - 去 酬 - 风 弄==随 风 弄 日 碎 春 云	扑 户 穿 帷 恼 杀 人	底 事 飘 扬 少 拘 束	爱 将 豪 纵 去 酬 春
凄 凉 - 忍 归 - 山 月 - 惊 鹤 - 凄 凉==凄 凉 风 露 湿 人 衣	犹 自 踟 躇 未 忍 归	树 影 忽 来 山 月 转	误 惊 鹤 翅 似 轮 飞
丰 年 - 胜 事 - 桑 麻 - 鱼 蟹 - 太 平==太 平 时 世 屡 丰 年	胜 事 空 闻 父 老 传	郭 外 桑 麻 如 几 顷	船 头 鱼 蟹 不 论 钱
万 仞 - 霏 霏 - 白 练 - 六 花 - 万 仞==苍 岷 万 仞 起 岩 峦	潺 瀑 霏 霏 尽 日 寒	倒 泻 银 河 拖 白 练	人 间 应 作 六 花 看
诗 思 - 看 经 - 秋 晴 - 浓 时 - 诗 思==上 人 梦 里 营 诗 思	比 似 看 经 僧 更 忙	包 山 寺 里 秋 晴 后	霜 未 浓 时 橘 正 香
春 回 - 阴 阴 - 无 心 - 烟 柳 - 春 回==西 园 作 戏 唤 春 回	桃 李 阴 阴 三 万 栽	不 是 无 心 看 开 遍	锦 江 烟 柳 待 归 来
如 霜 - 酒 杯 - 西 风 - 清 商 - 如 水==甲 光 如 水 戟 如 霜	御 酒 杯 浮 菊 半 黄	东 日 西 风 满 天 仗	萧 韶 一 部 奏 清 商
楼 阁 - 柳 丝 - 满 地 - 百 花 - 楼 阁==玲 珑 楼 阁 江 城 晚	杨 柳 丝 丝 凝 碧 烟	飞 燕 不 归 春 满 地	百 花 香 里 听 啼 鹃
翠 叠 - 秋 水 - 晚 晴 - 叶 落 - 翠 叠==远 山 凝 翠 叠 青 螺	秋 水 芙 蓉 映 碧 波	门 外 晚 晴 无 限 意	梧 桐 叶 落 已 无 多
无 人 - 野 花 - 东 风 - 蝴 蝶 - 野 径==野 径 无 人 芳 草 春	无 情 独 对 野 花 新	老 夫 自 爱 东 风 立	蝴 蝶 娇 痴 不 畏 人
鸿 雁 - 清 游 - 千 里 - 梅 花 - 鸿 雁==仰 看 鸿 雁 思 吾 弟	连 日 清 游 只 欠 渠	不 知 千 里 江 南 路	亦 有 梅 花 似 此 无
六 飞 - 画 龙 - 星 河 - 仗 归 - 六 飞==钟 鼓 旌 旗 引 六 飞	玉 皇 初 著 画 龙 衣	泰 坛 烟 尽 星 河 晓	万 国 心 随 彩 仗 归
老 火 - 提 携 - 千 头 - 三 藏 - 老 火==老 火 丹 田 热 欲 吹	不 妨 水 雪 重 提 携	金 多 不 用 千 头 橘	刀 害 无 嫌 三 藏 梨
湖 上 - 花 落 - 真 乐 - 闲 云 - 湖 上==春 朝 湖 上 风 兼 雨	世 事 如 花 落 又 开	退 省 闭 门 真 乐 处	闲 云 终 日 去 还 来
晴 色 - 初 晴 - 江 上 - 绿 条 - 阑 干==东 风 晴 色 挂 阑 干	眉 叶 初 晴 畏 晓 寒	江 上 别 筵 终 日 有	绿 条 春 在 长 应 难
功 名 - 天 高 - 无 人 - 白 云 - 功 名==社 稷 功 名 出 隐 沦	天 高 听 远 亦 应 闻	庞 眉 一 去 无 人 间	七 里 商 山 但 白 云
细 雨 - 杏 花 - 春 色 - 清 明 - 细 雨==细 雨 斜 风 拂 面 吹	杏 花 欲 谢 柳 新 垂	此 行 不 为 怜 春 色	也 学 清 明 上 冢 儿
六 出 - 江 湖 - 无 人 - 为 谁 - 六 出==台 省 诸 公 六 出 奇	江 湖 狂 客 一 生 痴	无 人 为 问 净 光 老	抚 掌 掀 髯 端 为 谁
羽 葆 - 不 厌 - 良 辰 - 满 头 - 羽 葆==羽 葆 层 层 间 彩 金	醉 来 不 厌 绕 丛 吟	满 头 且 应 良 辰 插	不 插 满 头 辜 此 心
功 名 - 白 发 - 花 心 - 归 与 - 有 意==壮 时 尝 有 意 功 名	不 觉 星 星 白 发 生	眼 亦 渐 花 心 更 短	归 与 犹 可 事 农 耕
炎 蒸 - 照 眼 - 旧 约 - 秋 声 - 一 雨==晚 来 一 雨 破 炎 蒸	蕉 叶 葵 花 照 眼 明	稍 与 灯 花 寻 旧 约	却 嫌 庭 树 作 秋 声
流 霞 - 翠 袖 - 萧 然 - 客 思 - 流 霞==霓 裳 舞 罢 醉 流 霞	翠 袖 频 揎 眼 欲 花	丈 室 萧 然 那 用 此	春 深 料 得 客 思 家
云 间 - 缥 缈 - 画 角 - 沧 洲 - 云 间==云 间 铁 瓮 近 青 天	缥 缈 飞 甍 百 尺 连	几 番 画 角 催 红 日	无 事 沧 洲 起 白 烟
春 风 - 红 红 - 垂 杨 - 袅 袅 - 春 风==春 风 十 九 归 桃 李	白 白 红 红 得 最 多	未 抵 垂 杨 春 最 惜	娇 娇 袅 袅 奈 渠 何
寒 泉 - 棹 歌 - 白 苹 - 湖 光 - 寒 泉==月 浸 寒 泉 凝 不 流	棹 歌 何 处 泛 归 舟	白 苹 红 蓼 西 风 裹	一 色 湖 光 万 顷 秋
草 上 - 衣 著 - 无 人 - 倚 栏 - 草 上==记 得 当 年 草 上 飞	铁 衣 著 尽 著 僧 衣	天 津 桥 上 无 人 识	独 倚 栏 干 看 落 晖
天 迥 - 残 照 - 寒 鸦 - 一 树 - 天 迥==天 迥 孤 帆 隐 约 归	茫 茫 残 照 欲 沉 西	寒 鸦 散 乱 知 多 少	飞 向 江 头 一 树 栖
归 来 - 嵯 峨 - 富 贵 - 千 载 - 海 外==海 外 归 来 衰 鬓 皤	浩 然 之 气 笔 嵯 峨	富 贵 不 淫 贫 贱 乐	万 年 千 载 一 东 坡
山 势 - 江 水 - 在 东 - 画 图 - 山 势==锦 屏 山 势 舞 双 鸾	影 入 嘉 陵 江 水 寒	人 在 东 南 归 未 得	时 时 独 展 画 图 看
霜 重 - 今 朝 - 放 闸 - 一 丝 - 霜 重==起 来 霜 重 满 淮 船	更 觉 今 朝 分 外 寒	放 闸 老 兵 殊 耐 冷	一 丝 不 挂 下 冰 滩
陌 上 - 足 波 - 何 处 - 笙 歌 - 陌 上==洛 阳 陌 上 多 离 别	蓬 莱 山 下 足 波 潮	碧 海 桑 田 何 处 在	笙 歌 一 听 一 遥 遥
淡 烟 - 叠 叠 - 一 年 - 沽 酒 - 淡 烟==淡 烟 孤 榜 系 村 桥	叠 叠 沙 痕 印 落 潮	最 是 一 年 秋 好 处	踏 泥 沽 酒 不 辞 遥
纱 笼 - 怕 逢 - 雨 洒 - 方 池 - 纱 笼==纱 笼 解 散 坐 门 畿	生 怕 逢 人 索 接 篱	朝 雨 洒 来 山 更 净	舂 锄 恰 好 到 方 池
水 云 - 风 味 - 一 枝 - 何 处 - 水 云==丛 林 荒 落 水 云 寒	风 味 辛 酸 话 转 难	隐 隐 一 枝 一 外 去	不 知 何 处 择 人 安
绿 阴 - 迟 日 - 百 花 - 石 榴 - 绿 阴==浓 绿 阴 中 黄 栗 留	醉 乡 迟 日 厌 鸣 鸠	青 春 去 後 百 花 歇	赖 有 枝 头 安 石 榴
黄 叶 - 千 峰 - 夜 半 - 溪 头 - 风 扫==朔 风 扫 地 卷 黄 叶	门 外 千 峰 凛 寒 色	夜 半 乌 龟 带 雪 飞	石 女 溪 头 皱 两 眉
扶 疏 - 疾 驱 - 辞 儿 - 风 味 - 扶 疏==梦 随 清 浅 看 扶 疏	军 将 敲 门 报 疾 驱	此 解 可 辞 儿 女 笑	使 君 风 味 似 寒 儒
谈 兵 - 东 风 - 三 江 - 曹 瞒 - 谈 兵==杜 牧 谈 兵 语 未 公	都 将 事 业 付 东 风	三 江 不 见 刘 玄 德	已 觉 曹 瞒 在 掌 中
风 卷 - 晓 来 - 登 临 - 清 明 - 风 卷==风 卷 冈 头 似 怒 雷	晓 来 驱 我 上 崔 嵬	斗 牛 尽 是 登 临 处	到 得 清 明 却 不 来
黄 昏 - 江 头 - 归 去 - 儿 童 - 黄 昏==前 村 笑 语 近 黄 昏	独 向 江 头 望 故 园	漂 泊 每 怜 归 去 晚	儿 童 各 自 解 方 言
载 青 - 归 休 - 梦 回 - 风 雨 - 载 青==十 载 青 春 伴 旅 游	无 田 安 敢 羡 归 休	梦 回 读 罢 凄 然 句	正 似 彭 城 风 雨 秋
澄 清 - 激 谁 - 母 子 - 孝 在 - 揽 辔==慨 然 揽 辔 志 澄 清	一 激 谁 知 党 祸 成	母 子 可 怜 终 死 别	庶 几 广 孝 在 扬 名
园 林 - 春 归 - 殷 红 - 叶 底 - 园 林==翠 润 园 林 草 木 长	春 归 积 雨 满 芳 塘	更 无 一 点 殷 红 色	叶 底 青 梅 已 可 尝
黄 金 - 玉 枝 - 山 水 - 南 山 - 金 蕊==细 看 秋 露 黄 金 蕊	不 减 春 风 白 玉 枝	人 道 江 南 富 山 水	江 南 山 水 富 于 斯
阴 阴 - 日 长 - 风 味 - 南 内 - 阴 阴==竹 殿 阴 阴 间 绿 槐	日 长 棋 罢 看 流 杯	北 窗 风 味 沈 沈 静	南 内 时 新 节 节 来
春 光 - 杏 花 - 时 心 - 百 尺 - 日 光==日 日 春 光 斗 日 光	山 城 斜 路 杏 花 香	几 时 心 绪 浑 无 事	得 及 游 丝 百 尺 长
古 道 - 揽 衣 - 自 酌 - 夜 凉 - 歌 声==睡 觉 歌 声 古 道 傍	有 人 中 夜 揽 衣 裳	床 头 斗 酒 聊 自 酌	不 为 书 窗 一 夜 凉
雪 飞 - 贪 诗 - 尽 囊 - 梅 花 - 雪 飞==风 雨 萧 萧 搅 雪 飞	一 寒 如 此 只 贪 诗	酒 瓢 倾 尽 囊 金 少	恐 被 梅 花 笑 不 知
寒 花 - 流 光 - 东 风 - 断 肠 - 寒 花==春 到 天 寒 花 未 芳	老 人 寸 寸 惜 流 光	攀 条 先 试 东 风 手	蜂 蝶 如 知 合 断 肠
有 神 - 避 地 - 银 河 - 万 古 - 笔 下==笔 下 文 章 信 有 神	西 来 避 地 不 无 因	要 看 银 河 从 大 落	一 洗 人 间 万 古 尘
东 风 - 一 片 - 杜 鹃 - 夕 阳 - 无 语==晚 来 无 语 立 东 风	一 片 闲 情 在 碧 空	人 老 杜 鹃 浑 不 管	柳 桦 飞 尽 夕 阳 红
绿 阴 - 入 林 - 粉 面 - 岁 寒 - 绿 阴==老 梅 临 沼 绿 阴 阴	一 朵 荷 花 透 入 林	不 比 世 间 红 粉 面	结 交 真 有 岁 寒 心
诗 酒 - 薄 与 - 洛 阳 - 不 眠 - 诗 酒==年 来 诗 酒 最 关 身	满 酌 休 论 薄 与 醇	愁 见 洛 阳 秋 夜 月	无 情 偏 照 不 眠 人
清 幽 - 今 朝 - 花 谢 - 凉 风 - 清 幽==水 殿 清 幽 歌 管 余	今 朝 化 作 梵 王 居	后 庭 花 谢 胭 脂 冷	犹 自 凉 风 薄 绮 疏
春 韭 - 绿 葵 - 龙 盘 - 猿 惊 - 春 韭==春 韭 夏 菘 谁 复 种	绿 葵 红 蓼 尚 堪 羹	山 存 虎 踞 龙 盘 势	谷 隐 猿 惊 鹤 怨 名
洞 庭 - 连 云 - 寂 寞 - 渔 歌 - 洞 庭==湘 山 木 落 洞 庭 波	湘 水 连 云 秋 雁 多	寂 寞 舟 中 谁 借 问	月 明 只 自 听 渔 歌
秋 声 - 征 人 - 自 笑 - 谈 兵 - 夹 道==白 杨 夹 道 起 秋 声	要 使 征 人 恨 不 平	自 笑 一 生 成 底 事	元 常 笔 秃 却 谈 兵
龙 种 - 成 花 - 瑶 池 - 丹 青 - 龙 种==龙 种 天 驹 产 渥 洼	五 云 毛 色 散 成 花	瑶 池 一 去 无 消 息	只 许 丹 青 纸 上 夸
第 一 - 当 头 - 风 云 - 九 重 - 第 一==世 出 世 间 称 第 一	谁 敢 当 头 正 眼 观	今 日 风 云 欣 庆 会	九 重 深 处 现 龙 颜
清 风 - 更 在 - 眼 界 - 古 木 - 清 风==草 庵 何 似 清 风 楼	更 在 空 中 最 上 头	眼 界 豁 开 无 畛 域	枯 藤 古 木 暮 烟 浮
暖 幕 - 缥 缈 - 寒 食 - 东 风 - 晴 帘==晴 帘 暖 幕 笑 如 烘	春 事 还 归 缥 缈 中	红 药 一 枝 寒 食 过	东 风 万 点 海 棠 空
夜 雨 - 啼 鸟 - 松 阴 - 日 长 - 东 风==昨 夜 东 风 夜 雨 凉	满 山 啼 鸟 自 宫 商	松 阴 覆 地 苔 华 湿	坐 对 炉 烟 白 日 长
月 满 - 玉 壶 - 荷 香 - 一 叶 - 月 满==小 醉 初 醒 月 满 床	玉 壶 银 阙 不 胜 凉	天 风 忽 送 荷 香 过	一 叶 飘 然 忆 故 乡
花 明 - 风 光 - 江 上 - 故 乡 - 花 明==草 烟 低 重 水 花 明	从 道 风 光 似 帝 京	其 奈 山 猿 江 上 叫	故 乡 无 此 断 肠 声
复 问 - 琥 珀 - 时 还 - 安 排 - 宁 复==滑 泥 宁 复 问 怀 沙	且 醉 杯 中 琥 珀 霞	触 事 背 时 还 独 笑	安 排 明 日 取 虾 蟆
云 山 - 尘 埃 - 十 年 - 地 角 - 云 山==每 忆 云 山 养 短 才	悔 缘 名 利 入 尘 埃	十 年 马 足 行 多 少	两 度 天 涯 地 角 来
四 面 - 宿 天 - 须 归 - 新 年 - 四 面==四 面 星 辰 著 地 明	散 烧 烟 火 宿 天 兵	不 关 破 贼 须 归 奏	自 趁 新 年 贺 太 平
数 枝 - 家 劝 - 堂 前 - 出 玉 - 数 枝==古 瓶 斜 插 数 枝 春	此 即 君 家 劝 酒 人	移 取 堂 前 双 蜡 烛	花 边 照 出 玉 精 神
风 烟 - 落 日 - 参 差 - 江 州 - 风 烟==塞 外 风 烟 能 记 否	天 涯 落 日 自 心 知	眼 中 景 物 参 差 是	只 欠 江 州 司 马 诗
风 光 - 泉 声 - 洗 尘 - 柳 条 - 风 光==风 光 犹 未 老 於 人	兽 口 泉 声 泻 碧 津	一 洗 尘 襟 无 俗 虑	柳 条 开 眼 共 看 春
缭 绕 - 映 苑 - 白 雪 - 凄 凉 - 缭 绕==杏 堂 缭 绕 过 梅 堂	小 竹 高 松 映 苑 墙	白 雪 飞 残 红 雾 密	乘 舆 不 到 却 凄 凉
秋 千 - 园 林 - 春 寒 - 夜 雨 - 残 红==残 红 新 绿 间 秋 千	寒 食 园 林 人 意 阑	一 阵 春 寒 花 上 起	画 廊 连 夜 雨 珊 珊
戴 星 - 鬓 霜 - 灯 前 - 屠 苏 - 戴 星==戴 星 先 捧 祝 尧 觞	镜 里 堪 惊 两 鬓 霜	好 是 灯 前 偷 失 笑	屠 苏 应 不 得 先 尝
虚 空 - 混 沌 - 辛 勤 - 团 圆 - 虚 空==大 虚 空 重 片 光 悬	何 异 初 开 混 沌 天	能 办 辛 勤 磨 玉 斧	不 愁 缺 月 不 团 圆
一 年 - 看 花 - 儿 孙 - 裙 当 - 一 年==蚕 绩 桑 空 又 一 年	村 姑 携 手 看 花 园	冬 来 保 得 儿 孙 暖	自 解 麻 裙 当 酒 尊
春 山 - 秋 来 - 天 明 - 风 吹 - 春 山==屏 掩 春 山 夜 渐 长	秋 来 处 处 有 新 凉	一 天 明 月 星 河 澹	满 殿 风 吹 茉 莉 香
霜 风 - 招 蜂 - 松 竹 - 四 友 - 霜 风==不 畏 霜 风 质 自 殊	不 招 蜂 蝶 艳 何 孤	梅 花 松 竹 如 相 见	便 合 添 为 四 友 呼
风 烟 - 春 晓 - 濯 枝 - 江 南 - 风 烟==京 尘 行 处 是 风 烟	春 晓 常 疑 欲 暮 天	惟 有 濯 枝 新 雨 后	江 南 无 梦 也 泠 然
新 诗 - 松 涛 - 自 觉 - 每 见 - 新 诗==寄 我 新 诗 富 且 优	松 涛 二 十 里 飕 飕	老 来 自 觉 舌 头 短	每 见 长 篇 不 敢 酬
潇 洒 - 开 门 - 青 青 - 一 毫 - 潇 潇==潇 潇 洒 洒 屋 三 间	日 日 开 门 见 好 山	但 使 青 青 长 在 眼	一 毫 尘 俗 莫 相 干
莽 莽 - 飞 仙 - 江 天 - 蛟 龙 - 莽 莽==古 愁 莽 莽 不 可 说	化 作 飞 仙 忽 奇 阔	江 天 如 墨 我 飞 还	折 梅 不 畏 蛟 龙 夺
来 往 - 征 鞍 - 千 山 - 胸 中 - 来 往==来 往 人 传 客 寝 安	问 渠 何 事 驻 征 鞍	只 应 门 外 千 山 好	能 使 胸 中 百 念 宽
一 脉 - 人 情 - 稚 子 - 向 外 - 一 脉==一 脉 阳 从 地 底 回	人 情 物 意 便 春 台	鲜 衣 稚 子 面 红 醉	知 向 外 家 参 节 来
坐 忘 - 归 来 - 无 人 - 藤 床 - 坐 忘==莫 把 坐 忘 成 坐 驰	归 来 须 是 识 真 归	壶 筹 投 尽 无 人 拾	澹 坐 藤 床 风 掩 扉
上 苑 - 竹 杖 - 累 累 - 化 鹤 - 上 苑==霞 服 云 冠 游 上 苑	芒 鞋 竹 杖 过 幽 扉	故 山 青 草 累 累 冢	羞 见 先 生 化 鹤 归
蟠 根 - 步 折 - 辛 勤 - 簪 花 - 月 窟==仙 李 蟠 根 连 月 窟	桂 枝 平 步 折 天 津	雪 窗 莫 忘 辛 勤 日	省 酒 簪 花 曲 水 滨
寒 灯 - 征 雁 - 言 事 - 解 语 - 客 梦==独 对 寒 灯 客 梦 孤	数 声 征 雁 下 平 芜	古 今 多 少 难 言 事	笑 指 梅 花 解 语 无
江 上 - 西 风 - 西 风 - 江 水 - 江 上==前 年 送 君 空 江 上	张 帆 正 值 西 风 起	今 日 西 风 君 未 归	茫 茫 祇 见 空 江 水
画 梁 - 梨 花 - 春 风 - 白 发 - 画 梁==粉 围 香 阵 画 梁 尘	几 梦 梨 花 漠 漠 云	一 夜 春 风 忽 吹 醒	镜 中 白 发 不 须 耘
炎 蒸 - 竹 窗 - 睡 美 - 风 雨 - 清 凉==炎 蒸 谁 解 换 清 凉	扇 扇 摇 摇 上 竹 窗	准 拟 小 轩 添 睡 美	梦 成 风 雨 夜 翻 江
风 流 - 白 马 - 春 光 - 牡 丹 - 风 流==年 少 风 流 七 品 官	朱 衣 白 马 冶 游 盘	负 心 不 报 春 光 主	几 处 偷 看 红 牡 丹
出 岭 - 氛 犹 - 江 南 - 万 里 - 今 日==今 日 平 安 出 岭 时	瘴 氛 犹 觉 润 征 衣	一 条 路 入 江 南 去	万 里 人 从 海 上 归
生 花 - 迢 迢 - 何 处 - 醉 眠 - 水 生==红 猊 消 尽 水 生 花	消 夜 迢 迢 玉 漏 赊	环 佩 不 知 何 处 去	醉 眠 应 是 小 卿 家
沉 沉 - 一 片 - 画 栏 - 穿 针 - 沉 沉==彩 楼 帘 影 夜 沉 沉	一 片 筛 凉 月 似 金	倚 得 画 栏 和 袖 暖	看 人 儿 女 学 穿 针
千 载 - 霜 叶 - 坤 一 - 春 风 - 骚 人==千 载 骚 人 沉 骨 冷	冰 霜 叶 底 见 幽 香	乾 坤 一 种 忠 良 气	弹 压 春 风 众 草 芳
水 深 - 天 倾 - 琉 璃 - 白 玉 - 水 深==壕 水 深 清 一 镜 如	天 倾 瑶 屑 打 成 酥	琉 璃 缸 面 熬 琼 粥	酿 出 珠 宫 白 玉 腴
篮 舆 - 岚 光 - 青 嶂 - 白 云 - 篮 舆==整 促 篮 舆 破 晓 晴	岚 光 滴 翠 夹 衣 轻	日 窥 青 嶂 坳 中 出	身 在 白 云 深 处 行
星 稀 - 微 凉 - 落 月 - 摇 动 - 星 稀==银 河 垂 角 斗 星 稀	晓 簟 微 凉 梦 破 迟	落 月 半 庭 人 未 起	好 风 摇 动 碧 桐 枝
梅 坞 - 携 酒 - 彭 泽 - 树 下 - 梅 坞==舍 人 梅 坞 无 关 锁	携 酒 俗 人 来 未 曾	旧 时 爱 菊 陶 彭 泽	今 作 梅 花 树 下 僧
雨 过 - 趁 晴 - 田 家 - 有 秋 - 雨 过==雨 过 儿 童 饱 饭 牛	趁 晴 耕 垦 种 来 牟	田 家 作 苦 无 储 蓄	待 哺 全 须 麦 有 秋
清 明 - 飞 雪 - 莺 燕 - 杜 鹃 - 艳 冶==过 却 清 明 艳 冶 天	梨 花 飞 雪 柳 森 烟	欲 凭 莺 燕 留 春 住	无 奈 东 风 信 杜 鹃
云 华 - 便 是 - 俗 骨 - 丹 砂 - 云 华==洞 天 东 去 号 云 华	便 是 仙 人 旧 隐 家	堪 笑 伪 刘 真 俗 骨	却 将 泥 土 葬 丹 砂
春 光 - 东 风 - 相 映 - 翠 微 - 春 光==白 昼 春 光 绿 染 衣	东 风 千 里 挂 帆 归	竹 篱 红 白 花 相 映	只 听 鸡 声 在 翠 微
巉 岩 - 来 住 - 独 坐 - 梦 魂 - 巉 岩==天 然 云 骨 老 巉 岩	疑 是 飞 来 住 此 间	独 坐 小 窗 听 夜 雨	梦 魂 应 不 到 康 山
连 云 - 带 月 - 数 点 - 一 声 - 连 云==山 前 抹 出 连 云 树	窗 外 施 来 带 月 枝	数 点 塞 鸿 相 伴 好	一 声 羌 笛 不 须 吹
风 流 - 黄 钟 - 舞 腰 - 一 钟 - 风 流==吹 尽 风 流 大 石 调	唱 出 富 贵 黄 钟 宫	舞 腰 催 拍 月 当 晓	更 进 蒲 萄 酒 一 钟
蝶 梦 - 三 眠 - 花 柳 - 有 情 - 蝶 梦==花 半 睡 时 分 蝶 梦	柳 三 眠 处 足 莺 声	谁 知 花 柳 无 情 物	添 个 蝶 莺 便 有 情
酒 醒 - 藕 花 - 游 人 - 一 片 - 酒 醒==酒 醒 湖 光 生 嫩 凉	卧 船 吹 笛 藕 花 香	游 人 尽 逐 莺 花 去	一 片 闲 情 在 夕 阳
白 雪 - 姮 娥 - 清 绝 - 争 妍 - 翠 云==翠 云 白 雪 两 仙 容	末 怯 姮 娥 傍 月 宫	若 把 佳 人 较 清 绝	争 妍 应 愧 伯 夷 风
春 雨 - 洞 天 - 尘 踪 - 云 间 - 翠 微==春 雨 新 晴 上 翠 微	三 年 两 过 洞 天 扉	尘 踪 不 得 多 时 住	又 向 云 间 一 宿 归
夜 长 - 杨 柳 - 云 雨 - 秋 声 - 梧 桐==只 为 梧 桐 怨 夜 长	不 知 杨 柳 老 年 芳	林 梢 一 片 过 云 雨	便 作 秋 声 占 取 凉
悠 悠 - 白 头 - 知 人 - 江 水 - 江 边==江 边 身 世 两 悠 悠	久 与 沧 波 共 白 头	造 物 亦 知 人 易 老	故 教 江 水 向 西 流
溪 雨 - 倾 银 - 风 吹 - 处 处 - 溪 雨==连 朝 溪 雨 溢 荷 塘	流 水 倾 银 万 叶 香	不 是 风 吹 乱 花 侧	那 知 处 处 著 鸳 鸯
神 仙 - 岁 月 - 高 深 - 九 重 - 神 仙==神 仙 洞 府 好 逍 遥	不 似 人 间 岁 月 销	海 岳 高 深 谁 可 测	九 重 天 上 自 相 邀
风 光 - 白 玉 - 梦 断 - 含 章 - 风 光==粗 桃 俗 李 要 风 光	番 雨 危 君 白 玉 堂	回 首 南 枝 春 梦 断	芒 心 犹 忆 古 含 章
虚 檐 - 风 帘 - 绿 阴 - 梅 黄 - 虚 檐==燕 入 虚 檐 教 子 飞	风 帘 不 卷 和 新 诗	绿 阴 满 迳 晴 蜓 小	正 是 梅 黄 欲 雨 时
春 日 - 无 涯 - 平 岸 - 西 风 - 春 日==春 日 归 舟 五 十 诗	人 间 此 乐 尽 无 涯	永 平 岸 口 匆 匆 别	又 见 西 风 上 桂 枝
金 缕 - 五 彩 - 春 色 - 青 青 - 金 缕==双 金 缕 胜 延 嘉 节	五 彩 为 幡 奉 紫 廷	春 色 渐 浓 人 未 觉	玉 阶 杨 柳 半 青 青
车 马 - 三 千 - 游 唱 - 一 朵 - 山 亭==锡 宴 山 亭 车 马 回	三 千 宫 女 醉 蓬 莱	绕 池 游 唱 逍 遥 乐	自 折 红 莲 一 朵 来
阑 干 - 聚 散 - 逢 江 - 马 嘶 - 阑 干==芳 郊 欲 别 阑 干 泪	故 国 难 期 聚 散 云	分 手 更 逢 江 驿 暮	马 嘶 猿 叫 不 堪 闻
倚 槛 - 一 枝 - 临 风 - 春 光 - 倚 槛==千 朵 稼 芳 倚 槛 斜	一 枝 枝 缀 乱 云 霞	凭 君 莫 厌 临 风 看	占 断 春 光 是 此 花
江 湖 - 风 流 - 水 落 - 宁 惜 - 江 湖==江 湖 知 友 亦 云 多	每 叹 风 流 奈 若 何	水 落 故 知 当 石 出	镜 中 宁 惜 鬓 将 皤
白 发 - 生 风 - 欢 相 - 商 山 - 白 发==两 两 鹑 衣 白 发 翁	讲 筵 谈 柄 坐 生 风	昭 明 太 子 欢 相 得	应 与 商 山 西 皓 同
竹 溪 - 深 红 - 落 英 - 青 旗 - 竹 溪==竹 溪 烟 绝 雨 才 通	无 数 深 红 间 浅 红	山 店 落 英 春 寂 寂	青 旗 吹 动 柳 花 风
玉 阶 - 夕 阳 - 西 风 - 芙 蓉 - 玉 阶==无 数 青 莎 绕 玉 阶	夕 阳 红 浅 过 墙 来	西 风 莫 道 无 情 思	未 放 芙 蓉 取 次 开
气 象 - 风 骚 - 窗 外 - 夜 吟 - 气 象==箫 鼓 元 宵 气 象 豪	拗 晴 天 意 亦 风 骚	怕 渠 窗 外 梅 花 落	永 夜 吟 声 不 敢 高
心 胸 - 谷 中 - 遗 编 - 鸣 风 - 心 胸==要 为 冷 语 豁 心 胸	孰 若 相 羊 涧 谷 中	试 把 遗 编 一 开 读	恍 疑 涧 谷 为 鸣 风
岁 月 - 喔 喔 - 九 苞 - 上 林 - 岁 月==栖 桀 栖 埘 岁 月 深	咿 咿 喔 喔 放 豪 音	九 苞 彩 色 丹 山 凤	春 暖 还 须 报 上 林
明 年 - 孤 吟 - 传 舍 - 惊 鹊 - 明 年==更 邀 明 月 说 明 年	记 取 孤 吟 孟 浩 然	此 去 宦 游 如 传 舍	拣 枝 惊 鹊 几 时 眠
上 下 - 娟 娟 - 蟾 宫 - 日 月 - 云 端==每 见 云 端 上 下 弦	遥 怜 破 镜 两 娟 娟	原 移 此 景 蟾 宫 去	日 月 当 令 一 再 圆
黄 昏 - 残 照 - 夕 阳 - 柳 丝 - 黄 昏==遥 天 已 报 黄 昏 入	残 照 孤 亭 一 角 支	莫 道 夕 阳 无 限 好	柳 丝 系 得 几 多 时
游 子 - 李 陵 - 北 风 - 雁 来 - 游 子==游 子 新 从 绝 塞 回	自 言 曾 上 李 陵 台	尊 前 语 尽 北 风 起	秋 色 萧 条 胡 雁 来
阶 前 - 露 枝 - 庭 下 - 春 风 - 阶 前==工 药 阶 前 半 吐 葩	露 枝 已 入 贵 人 家	不 如 庭 下 无 名 草	一 度 春 风 一 度 花
北 风 - 浮 烟 - 萦 纡 - 破 湖 - 客 愁==野 岸 北 风 归 客 愁	浮 烟 不 动 雨 飕 飕	围 成 野 色 萦 纡 岸	点 破 湖 光 三 四 鸥
兰 亭 - 金 丹 - 阳 杨 - 乌 丝 - 兰 亭==俗 书 只 识 兰 亭 面	欲 换 凡 骨 无 金 丹	谁 知 落 阳 杨 风 子	下 笔 便 到 乌 丝 阑
云 收 - 游 人 - 雪 霁 - 月 明 - 云 收==云 收 雾 落 天 围 净	乞 与 游 人 眼 界 宽	独 恨 不 当 新 雪 霁	月 明 来 此 倚 阑 干
去 去 - 何 处 - 有 栖 - 西 山 - 去 去==去 去 寻 师 莫 远 寻	蓬 莱 何 处 海 深 深	山 房 幸 有 栖 身 地	且 读 西 山 夜 气 箴
牧 鹅 - 今 朝 - 俯 仰 - 如 云 - 牧 鹅==野 童 绿 草 牧 鹅 群	诗 料 今 朝 得 几 分	俯 仰 纵 横 皆 合 律	云 如 层 树 树 如 云
六 月 - 炎 蒸 - 秋 风 - 烧 香 - 六 月==今 年 六 月 不 胜 凉	七 月 炎 蒸 不 可 当	一 阵 秋 风 初 过 雨	个 般 天 气 好 烧 香
风 雨 - 啼 鸟 - 黄 鹂 - 隔 叶 - 风 雨==风 雨 萧 萧 病 欲 侵	杂 然 啼 鸟 在 中 林	细 听 却 有 黄 鹂 语	端 是 当 年 隔 叶 音
水 流 - 日 静 - 风 流 - 一 邱 - 水 流==水 流 花 落 石 生 云	日 静 风 暄 草 欲 薰	老 去 风 流 犹 未 减	一 邱 一 壑 尚 勤 勤
尘 埃 - 眼 昏 - 江 上 - 经 春 - 骑 马==非 关 骑 马 踏 尘 埃	病 眼 昏 昏 自 懒 开	江 上 酒 徒 应 共 笑	经 春 不 作 看 花 来
春 回 - 盈 池 - 古 经 - 云 烟 - 春 回==刁 坞 春 回 花 满 枝	沈 溪 梦 断 水 盈 池	遥 知 吊 古 经 行 处	落 纸 云 烟 总 是 诗
新 年 - 暖 日 - 春 风 - 嫩 青 - 新 年==莫 道 新 年 贺 客 迟	晴 天 暖 日 却 相 期	春 风 只 被 多 情 苦	红 嫩 青 新 总 要 诗
西 城 - 篱 落 - 高 枕 - 烟 霞 - 西 城==西 城 闲 访 葛 洪 家	篱 落 秋 余 白 豆 花	高 枕 自 知 无 俗 梦	数 椽 茅 屋 在 烟 霞
风 急 - 洞 天 - 瀛 洲 - 醮 坛 - 风 急==风 急 云 轻 鹤 背 寒	洞 天 谁 道 却 归 难	千 山 万 水 瀛 洲 路	何 处 烟 飞 是 醮 坛
红 笺 - 题 诗 - 微 吟 - 蒙 蒙 - 红 笺==红 笺 一 幅 卷 明 霞	织 手 题 诗 寄 大 家	檀 口 微 吟 绕 廊 柱	蒙 蒙 春 雨 湿 梨 花
梅 雨 - 新 茶 - 两 腋 - 太 夸 - 梅 雨==谷 雨 已 过 又 梅 雨	故 山 犹 未 致 新 茶	清 风 两 腋 玉 川 句	三 百 团 应 似 太 夸
马 头 - 何 处 - 千 里 - 烟 波 - 马 头==马 头 过 了 又 驴 头	何 处 飞 来 海 上 洲	绝 顶 试 穷 千 里 目	烟 波 深 处 是 琉 球
读 易 - 力 到 - 日 长 - 兰 亭 - 读 易==读 易 年 深 眼 易 花	尚 余 心 力 到 诗 家	日 长 更 有 幽 忧 病	临 罢 兰 亭 品 建 茶
沙 头 - 气 清 - 无 人 - 师 识 - 沙 头==过 了 沙 头 渐 有 村	地 平 江 阔 气 清 温	暗 潮 巴 到 无 人 会	只 有 篙 师 识 水 痕
丹 凤 - 崎 岖 - 宫 阙 - 南 来 - 丹 凤==丹 凤 楼 头 语 未 终	崎 岖 蜀 道 复 相 逢	太 清 宫 阙 俱 煨 烬	岂 亦 南 来 避 贼 锋
江 天 - 句 句 - 文 章 - 兼 比 - 江 天==当 年 随 意 乐 江 天	句 句 新 诗 尽 可 传	事 业 文 章 两 俱 美	先 生 兼 比 二 公 贤
一 番 - 春 容 - 庭 外 - 飞 扬 - 一 番==一 番 微 雨 一 番 晴	淡 淡 春 容 照 眼 明	庭 外 幽 花 自 开 落	飞 扬 无 处 觅 残 英
蒸 梨 - 青 山 - 丁 丁 - 山 鸟 - 蒸 梨==蒸 梨 炊 黍 付 荆 妻	指 点 青 山 涧 水 西	忽 听 丁 丁 云 外 斧	一 声 山 鸟 背 人 啼
龟 壳 - 长 春 - 橘 隐 - 一 人 - 问 津==龟 壳 浮 游 不 问 津	壶 中 日 月 自 长 春	向 来 橘 隐 商 山 乐	今 日 中 间 添 一 人
红 尘 - 天 凝 - 峥 嵘 - 化 城 - 红 尘==红 尘 迎 马 尽 飞 浮	日 脚 横 天 凝 不 流	金 碧 峥 嵘 凉 意 动	归 轩 聊 作 化 城 游
龙 盘 - 消 亡 - 何 处 - 暮 烟 - 盘 龙==龙 盘 龙 踞 景 堪 寻	王 气 消 亡 信 祸 淫	结 绮 临 春 何 处 是	数 声 啼 鸟 暮 烟 深
百 舌 - 新 春 - 未 成 - 初 日 - 百 舌==傍 檐 百 舌 语 聪 珑	已 觉 新 春 在 眼 中	欲 起 未 成 还 小 睡	忽 看 初 日 满 窗 红
一 身 - 自 由 - 永 日 - 无 魂 - 一 身==一 身 文 采 异 常 流	却 使 闲 身 不 自 由	永 日 翠 笼 相 并 睡	岂 无 魂 梦 到 沧 州
蹇 驴 - 来 往 - 经 纶 - 读 书 - 蹇 驴==一 个 青 童 一 蹇 驴	九 年 来 往 定 林 居	经 纶 枉 被 周 公 误	罢 相 皈 来 始 读 书
数 声 - 万 里 - 避 雪 - 南 来 - 三 更==数 声 江 浒 三 更 雁	孤 影 霜 天 万 里 身	新 冷 犹 如 先 避 雪	南 来 应 笑 北 行 人
槐 叶 - 麦 秋 - 三 春 - 午 梦 - 阴 阴==槐 叶 阴 阴 覆 短 墙	微 风 细 雨 麦 秋 凉	如 何 一 岁 三 春 景	不 及 闲 窗 午 梦 长
雪 消 - 游 客 - 远 近 - 山 中 - 空 山==空 山 雪 消 溪 水 涨	游 客 渡 溪 横 古 槎	不 知 溪 源 来 远 近	但 见 流 出 山 中 花
云 雨 - 明 月 - 飞 翼 - 金 笼 - 云 雨==云 雨 阳 台 旧 路 迷	千 山 明 月 照 人 啼	背 风 纵 作 孤 飞 翼	索 胜 金 笼 里 面 栖
晓 风 - 蜀 锦 - 明 媚 - 故 乡 - 晓 风==晓 风 抹 尽 燕 支 颗	夜 雨 催 成 蜀 锦 机	当 昼 开 时 正 明 媚	故 乡 疑 是 买 臣 归
炎 蒸 - 梧 桐 - 爽 气 - 独 神 - 炎 蒸==楚 乡 秋 早 倦 炎 蒸	长 恨 梧 桐 不 可 凭	爽 气 忽 随 风 雨 至	晓 堂 无 寐 独 神 惊
苹 汀 - 兰 舟 - 沙 禽 - 谁 在 - 白 苹==白 苹 汀 是 旧 家 乡	归 兴 兰 舟 泛 渺 茫	日 暮 沙 禽 啼 欲 断	不 知 谁 在 碧 云 房
断 汊 - 倚 阑 - 沙 鸥 - 游 人 - 姓 存==断 汊 惟 余 旧 姓 存	倚 阑 投 饵 说 当 年	沙 鸥 曾 见 园 兴 废	近 日 游 人 又 玉 泉
花 片 - 点 点 - 造 化 - 新 绿 - 纷 纷==纷 纷 花 片 落 车 茵	点 点 苔 钱 衬 屐 痕	造 化 生 机 浑 不 尽	又 将 新 绿 转 春 温
素 娥 - 宝 髻 - 玉 簪 - 一 枝 - 素 娥==素 娥 昔 日 宴 仙 家	醉 里 从 他 宝 髻 斜	遗 下 玉 簪 无 觅 处	如 今 化 作 一 枝 花
雨 浥 - 青 柳 - 一 杯 - 故 人 - 雨 浥==渭 城 朝 雨 浥 轻 尘	客 舍 青 青 柳 色 春	劝 君 更 尽 一 杯 酒	西 出 阳 关 无 故 人
风 急 - 雁 声 - 夜 月 - 江 南 - 芦 花==芦 花 袅 袅 西 风 急	独 立 高 楼 闻 雁 声	志 士 最 伤 秋 夜 月	江 南 塞 北 两 般 明
红 紫 - 一 年 - 万 叠 - 万 点 - 飘 零==红 紫 飘 零 笋 蕨 抽	一 年 芳 事 又 成 休	榆 钱 万 叠 春 难 买	落 絮 随 风 万 点 愁
柳 暗 - 快 阁 - 南 山 - 暮 云 - 柳 暗==柳 暗 知 津 君 送 我	江 临 快 阁 我 辞 君	君 行 过 我 南 山 塔	为 道 长 怀 日 暮 云
凌 云 - 十 年 - 春 风 - 流 水 - 凌 云==凌 云 一 笑 见 桃 花	三 十 年 来 始 到 家	从 此 春 风 春 雨 後	乱 随 流 水 到 天 涯
山 行 - 夹 道 - 篱 边 - 诗 人 - 山 行==山 行 渐 欲 堕 荆 榛	夹 道 黄 花 独 尔 新	野 外 篱 边 非 失 所	尚 能 寒 眼 动 诗 人
试 笔 - 得 句 - 桃 李 - 梅 花 - 新 年==新 年 试 笔 欲 题 诗	老 去 才 衰 得 句 迟	春 事 未 容 桃 李 觉	梅 花 开 到 北 边 枝
一 年 - 六 月 - 今 夕 - 遇 夏 - 一 番==一 年 遇 暑 一 番 愁	六 月 梢 时 七 月 头	今 夕 追 凉 还 得 热	何 时 遇 夏 却 逢 秋
仙 子 - 愧 短 - 许 随 - 归 来 - 天 台==曾 闻 仙 子 住 天 台	欲 结 灵 姻 愧 短 才	若 许 随 君 洞 中 住	不 同 刘 阮 却 归 来
鲜 明 - 黄 叶 - 离 别 - 多 愁 - 色 鲜==颜 色 鲜 明 能 几 时	未 辞 黄 叶 已 辞 枝	都 缘 爱 管 闲 离 别	多 恨 多 愁 故 早 衰
茫 茫 - 云 无 - 风 月 - 一 钓 - 泽 国==泽 国 茫 茫 水 接 天	孰 云 无 法 与 人 传	见 成 风 月 难 回 避	尽 在 华 亭 一 钓 船
零 落 - 夕 阳 - 把 凤 - 蝴 蝶 - 杏 花==杏 花 零 落 燕 泥 香	闲 立 东 风 看 夕 阳	倒 把 凤 翘 搔 鬓 影	一 双 蝴 蝶 过 东 墙
万 峰 - 知 人 - 何 处 - 老 松 - 万 峰==每 欲 寻 君 千 万 峰	岂 知 人 世 也 相 逢	一 瓢 遗 却 在 何 处	应 挂 天 台 最 老 松
夜 雨 - 庭 院 - 樽 前 - 梅 花 - 夜 雨==浓 淡 春 云 夜 雨 干	寂 寥 庭 院 夹 衣 寒	无 人 为 发 樽 前 笑	但 把 梅 花 似 旧 看
争 战 - 干 戈 - 遗 迹 - 亭 前 - 争 战==自 昔 夷 陵 争 战 进	时 平 不 复 问 干 戈	三 游 洞 里 寻 遗 迹	至 喜 亭 前 足 雅 歌
作 诗 - 春 归 - 离 披 - 黄 昏 - 作 诗==因 甚 年 来 可 作 诗	奈 何 人 老 又 春 归	流 莺 不 忍 花 离 披	啼 到 黄 昏 犹 自 啼
切 切 - 高 柳 - 夕 阳 - 酒 楼 - 琵 琶==琵 琶 切 切 更 嘈 嘈	高 柳 群 蝉 遂 不 号	一 片 夕 阳 无 限 好	汶 河 西 上 酒 楼 高
有 无 - 四 面 - 紫 霄 - 吹 笙 - 半 空==半 空 烟 雨 有 无 间	碧 玉 屏 开 四 面 山	我 欲 紫 霄 亭 上 望	吹 笙 人 去 几 时 还
千 叶 - 花 心 - 草 木 - 君 臣 - 千 叶==万 枝 千 叶 递 相 貌	内 结 花 心 外 结 身	草 木 至 微 犹 有 合	悲 哉 你 子 与 君 臣
碧 落 - 散 步 - 神 光 - 是 处 - 碧 落==云 浮 碧 落 似 轻 尘	散 步 闲 过 析 木 津	莫 讶 神 光 生 两 舄	天 行 是 处 蹑 星 辰
苦 吟 - 把 酒 - 人 事 - 青 门 - 苦 吟==何 用 苦 吟 肝 肾 愁	但 知 把 酒 更 无 忧	声 名 本 不 关 人 事	看 取 青 门 一 故 侯
漠 漠 - 谁 家 - 天 台 - 采 药 - 漠 漠==漠 漠 云 林 小 小 山	谁 家 茅 屋 隐 松 间	石 桥 雨 过 天 台 远	采 药 仙 人 去 未 还
绝 顶 - 松 鹤 - 明 月 - 夜 深 - 清 秋==清 秋 绝 顶 竹 房 开	松 鹤 何 年 去 不 回	惟 有 前 峰 明 月 在	夜 深 犹 过 半 江 来
晓 云 - 潺 潺 - 白 石 - 汉 时 - 春 风==春 风 栈 阁 晓 云 寒	中 有 潺 潺 一 玉 湾	白 石 寨 盘 青 石 磴	藓 花 犹 带 汉 时 斑
水 云 - 竹 里 - 雨 晴 - 东 西 - 水 云==碧 空 一 片 水 云 飞	竹 里 人 家 午 唱 鸡	江 路 雨 晴 芳 草 润	杖 藜 行 遍 水 东 西
疏 篱 - 春 风 - 无 人 - 清 明 - 疏 篱==低 著 疏 篱 宽 著 天	春 风 不 撼 楚 江 船	无 人 为 挂 屋 头 眼	明 日 清 明 花 可 怜
物 外 - 清 泉 - 识 破 - 自 在 - 物 外==构 屋 山 居 物 外 禅	绕 窗 白 石 与 清 泉	年 来 识 破 安 心 法	衲 被 蒙 头 自 在 眠
运 粮 - 万 斛 - 添 气 - 赐 金 - 风 吹==南 风 吹 到 运 粮 船	万 斛 香 粳 倍 上 年	传 敕 漕 台 添 气 力	赐 金 多 办 太 平 筵
画 桥 - 精 神 - 无 语 - 春 风 - 画 桥==相 逢 记 得 画 桥 头	花 似 精 神 柳 似 柔	莫 谓 无 情 即 无 语	春 风 传 意 水 传 愁
徘 徊 - 锦 绣 - 似 君 - 春 色 - 徘 徊==青 春 深 处 每 徘 徊	为 爱 花 城 锦 绣 堆	谁 似 君 家 奇 绝 处	坐 迎 春 色 入 门 来
千 年 - 挥 毫 - 一 事 - 东 西 - 千 年==从 渠 满 腹 贮 千 年	遮 莫 挥 毫 动 百 篇	入 到 圣 门 无 一 事	东 西 日 月 自 行 天
黄 扉 - 染 素 - 一 竿 - 鸥 鸟 - 黄 扉==平 生 梦 不 到 黄 扉	安 得 京 尘 染 素 衣	只 把 一 竿 江 海 去	相 看 鸥 鸟 亦 忘 机
深 红 - 一 年 - 日 醉 - 明 年 - 深 红==高 烧 蜡 炬 照 深 红	恐 负 一 年 花 人 风	恶 客 敢 辞 今 日 醉	明 年 别 去 定 匆 匆
波 光 - 路 长 - 早 春 - 风 轻 - 波 光==南 山 晴 翠 入 波 光	一 派 溪 声 绕 路 长	最 爱 早 春 沙 岸 暖	东 风 轻 浪 拍 鸳 鸯
村 夫 - 胸 中 - 虚 空 - 江 湖 - 村 夫==匙 挑 不 上 个 村 夫	文 墨 胸 中 一 点 无	曾 把 虚 空 揣 出 骨	恶 声 赢 得 满 江 湖
春 寒 - 梅 花 - 火 气 - 少 陵 - 春 寒==瓮 澄 雪 水 酿 春 寒	蜜 点 梅 花 带 露 餐	句 里 略 无 烟 火 气	更 教 谁 上 少 陵 坛
鸣 蝉 - 芙 蓉 - 纨 扇 - 夜 夜 - 鸣 蝉==落 日 鸣 蝉 夏 木 荒	芙 蓉 半 落 柳 成 行	何 人 纨 扇 生 新 恨	亭 馆 迎 秋 夜 夜 凉
辟 兵 - 系 臂 - 微 凉 - 午 阴 - 辟 兵==辟 兵 龙 印 篆 神 经	系 臂 香 萦 绣 色 轻	自 有 微 凉 生 玉 宇	池 光 静 照 午 阴 清
解 围 - 闲 官 - 冷 落 - 飞 花 - 解 围==寒 阵 须 凭 酒 解 围	闲 官 幸 可 典 朝 衣	一 杯 冷 落 凭 谁 劝	却 有 飞 花 舞 入 帷
八 法 - 几 株 - 雨 后 - 山 色 - 云 林==云 林 八 法 写 倪 迂	夏 木 幽 亭 翠 几 株	雨 后 长 洲 政 如 此	骑 驼 山 色 近 何 如
朝 云 - 一 点 - 花 溪 - 断 肠 - 朝 云==朝 云 漠 漠 雨 丝 匀	山 路 清 无 一 点 尘	桃 李 著 花 溪 水 满	断 肠 何 处 故 园 深
两 年 - 出 处 - 书 卷 - 芭 蕉 - 两 年==古 寺 相 留 跨 两 年	穷 通 出 处 固 天 然	短 檠 灯 火 掩 书 卷	屡 听 芭 蕉 夜 雨 眠
溪 畔 - 照 水 - 酒 楼 - 梦 魂 - 溪 畔==若 耶 溪 畔 醉 秋 风	猎 猎 船 旗 照 水 红	后 夜 钱 塘 酒 楼 上	梦 魂 应 绕 浙 江 东
山 中 - 直 节 - 日 高 - 清 风 - 山 中==此 君 生 长 此 山 中	直 节 从 来 自 不 同	今 日 高 标 还 卓 出	万 人 谁 不 仰 清 风
交 加 - 清 流 - 知 几 - 春 风 - 交 加==台 前 藤 藓 碧 交 加	台 下 清 流 直 又 斜	待 得 丹 成 知 几 日	春 风 随 分 野 桃 花
万 古 - 百 战 - 陇 上 - 关 东 - 征 人==征 人 万 古 没 胡 中	百 战 难 收 一 战 功	陇 上 长 愁 云 不 断	何 年 重 向 玉 关 东
千 山 - 极 目 - 一 脉 - 数 丈 - 千 山==日 烁 千 山 草 树 然	海 乡 极 目 少 炊 烟	蒜 溪 一 脉 涓 涓 水	只 绿 庵 西 数 丈 田
瘦 马 - 客 怀 - 鸡 声 - 日 影 - 瘦 马==瘦 马 长 途 懒 着 鞭	客 怀 牢 落 五 更 天	几 时 不 属 鸡 声 管	睡 彻 东 窗 日 影 偏
黯 黯 - 数 声 - 纱 窗 - 半 夜 - 黯 黯==黯 黯 严 城 罢 鼓 鼙	数 声 相 续 出 寒 栖	不 嫌 惊 破 纱 窗 梦	却 怕 为 妖 半 夜 啼
瑶 池 - 风 落 - 飘 英 - 谁 人 - 有 梦==何 曾 有 梦 到 瑶 池	但 见 狂 风 落 海 陂	帘 外 飘 英 纷 不 识	谁 人 尚 复 忆 辛 夷
地 炉 - 柴 荆 - 雪 中 - 风 景 - 地 炉==无 因 同 拨 地 炉 灰	想 见 柴 荆 晚 未 开	不 是 雪 中 须 送 炭	聊 装 风 景 要 诗 来
清 泉 - 树 阴 - 得 意 - 忘 言 - 清 泉==自 汲 清 泉 除 砚 垢	树 阴 微 息 晚 凉 初	个 中 得 意 谁 知 我	笔 下 忘 言 我 羡 渠
夜 静 - 隐 映 - 银 塘 - 俯 仰 - 乘 凉==夜 静 乘 凉 坐 水 亭	草 头 隐 映 见 孤 萤	瞥 然 飞 过 银 塘 面	俯 仰 浮 光 几 点 星
凭 高 - 远 水 - 照 人 - 一 曲 - 凭 高==凭 高 座 久 渐 生 寒	远 水 明 楼 夜 正 残	月 色 照 人 人 似 月	椅 栏 一 曲 为 谁 弹
秋 山 - 茅 檐 - 日 观 - 寺 钟 - 秋 山==霜 落 秋 山 枫 树 红	茅 檐 直 面 列 诸 峰	上 人 竟 日 观 心 坐	粥 饭 遥 凭 别 寺 钟
一 年 - 万 木 - 为 国 - 桃 李 - 一 年==一 年 两 度 伐 枝 柯	万 木 丛 中 苦 最 多	为 国 为 民 皆 丝 汝	却 教 桃 李 听 笙 歌
花 柳 - 风 雨 - 红 紫 - 新 绿 - 花 柳==花 柳 芳 妍 十 日 晴	五 更 风 雨 送 余 春	莫 嫌 红 紫 都 吹 尽	新 绿 满 园 还 可 人
曙 光 - 深 藏 - 功 名 - 日 月 - 曙 光==倦 听 当 关 报 曙 光	深 藏 象 笏 解 荷 囊	身 闲 不 傍 功 名 路	方 外 方 知 日 月 长
风 流 - 梅 花 - 疏 影 - 人 世 - 风 流==咸 平 处 士 风 流 远	招 得 梅 花 枝 上 魂	疏 影 暗 得 如 昨 日	不 知 人 世 几 黄 昏
台 畔 - 寂 寂 - 不 能 - 妇 言 - 台 畔==刘 伶 台 畔 酹 金 卮	寂 寂 荒 丘 带 晚 晖	今 日 先 生 不 能 饮	妇 言 屏 弃 未 为 非
池 塘 - 暖 风 - 千 门 - 高 楼 - 池 塘==水 满 池 塘 花 绕 城	日 斜 南 陌 暖 风 轻	千 门 柳 色 春 烟 淡	独 倚 高 楼 闻 暮 莺
万 籁 - 倚 栏 - 松 风 - 秋 月 - 清 夜==万 籁 沉 沉 清 夜 阑	楼 前 独 自 倚 栏 干	金 鸡 叫 罢 松 风 动	三 十 六 天 秋 月 寒
三 月 - 长 短 - 归 去 - 今 十 - 绿 水==绿 水 白 鸥 三 月 天	哀 箫 长 短 使 人 怜	草 鞋 踏 雨 同 归 去	此 事 如 今 十 五 年
隐 几 - 看 书 - 风 清 - 溪 山 - 隐 几==饮 罢 池 蛆 聊 隐 几	醒 来 扪 虱 谩 看 书	风 清 襟 袖 凉 无 限	云 晚 溪 山 画 不 如
连 天 - 高 帆 - 乘 风 - 争 先 - 连 天==清 淮 直 上 水 连 天	坐 看 高 帆 後 复 前	自 是 乘 风 有 迟 速	不 由 人 力 爱 争 先
门 前 - 香 醪 - 风 雨 - 豹 韬 - 怒 涛==鹿 耳 门 前 吼 怒 涛	奇 愁 郁 勃 索 香 醪	记 曾 风 雨 苍 凉 夜	灯 影 摇 红 读 豹 韬
云 开 - 三 千 - 花 开 - 水 间 - 云 开==风 动 云 开 净 客 颜	三 千 丈 石 锦 烂 斑	淤 泥 不 是 花 开 处	擢 出 天 河 绿 水 间
鸳 鸯 - 望 月 - 同 心 - 黄 鹂 - 鸳 鸯==我 见 鸳 鸯 飞 水 上	君 还 望 月 苦 相 思	一 双 裙 带 同 心 结	早 寄 黄 鹂 孤 雁 儿
特 山 - 徘 徊 - 斜 阳 - 归 鸦 - 山 盘==不 特 山 盘 水 亦 回	溪 山 信 美 暇 徘 徊	行 人 自 趁 斜 阳 急	关 得 归 鸦 更 苦 催
红 绡 - 归 鸦 - 西 风 - 月 华 - 红 绡==一 抹 红 绡 日 脚 霞	千 林 暮 霭 纳 归 鸦	西 风 卷 尽 梧 桐 叶	乞 与 中 庭 散 月 华
松 筠 - 见 真 - 光 明 - 旧 交 - 松 筠==西 斋 前 后 半 松 筠	万 虑 澄 余 始 见 真	不 谓 天 光 明 净 处	又 能 时 忆 旧 交 亲
仙 桃 - 望 幸 - 春 思 - 杏 花 - 仙 桃==仙 桃 欲 拂 朝 真 脸	禁 柳 忙 催 望 幸 眉	不 会 君 王 春 思 别	杏 花 菖 叶 在 农 时
六 月 - 壁 立 - 今 好 - 第 一 - 六 月==天 半 飞 涛 六 月 寒	苍 岸 壁 立 互 回 环	从 今 好 事 能 题 品	列 作 南 中 第 一 仙
三 更 - 月 明 - 晓 钟 - 无 人 - 梦 觉==邮 亭 梦 觉 正 三 更	窗 上 花 阴 转 月 明	徙 倚 晓 钟 传 远 寺	更 无 人 见 苦 离 情
紫 薇 - 牵 牛 - 金 石 - 班 翻 - 紫 薇==紫 薇 花 下 玉 丁 东	夜 午 牵 牛 亦 未 中	孔 壁 尚 余 金 石 奏	卷 班 翻 过 玉 成 宫
五 色 - 千 年 - 日 月 - 在 天 - 金 缕==金 缕 开 辰 分 五 色	长 丝 献 寿 祝 千 年	垂 衣 日 月 承 嘉 庆	真 祖 飚 游 正 在 天
云 根 - 风 雷 - 骸 老 - 绿 苔 - 云 根==何 处 云 根 采 得 来	黑 龙 狂 欲 作 风 雷	知 师 念 我 形 骸 老	教 把 经 行 拄 绿 苔
乘 云 - 仙 桃 - 喜 偕 - 看 来 - 乘 云==乘 云 不 到 玉 皇 家	岩 上 仙 桃 几 度 花	今 日 喜 偕 三 益 友	看 来 丹 灶 炼 黄 芽
幽 居 - 春 风 - 藉 草 - 多 情 - 幽 居==幽 居 懒 慢 养 余 生	强 为 春 风 处 处 行	藉 草 弄 花 终 少 味	寻 山 爱 竹 尚 多 情
轮 转 - 知 音 - 天 开 - 沙 界 - 轮 转==赵 州 一 匝 天 轮 转	婆 子 知 音 未 足 酬	普 为 人 天 开 正 眼	大 千 沙 界 一 毫 收
江 水 - 白 发 - 风 雨 - 夜 深 - 江 水==江 水 东 流 更 不 回	行 人 白 发 苦 相 催	只 恐 明 朝 风 雨 恶	夜 深 灯 烛 亦 须 来
修 竹 - 箨 龙 - 太 守 - 千 亩 - 修 竹==汉 川 修 竹 贱 如 蓬	斤 斧 何 曾 赦 箨 龙	料 得 清 贫 馋 太 守	渭 滨 千 亩 在 胸 中
西 东 - 字 通 - 黄 鹤 - 月 明 - 西 东==君 从 庐 墓 我 西 东	数 载 惭 无 一 字 通	却 喜 梦 游 黄 鹤 寺	几 番 携 手 月 明 中
洛 阳 - 雄 图 - 最 佳 - 举 杯 - 洛 阳==洛 阳 官 满 归 吴 会	男 子 雄 图 志 未 伸	若 到 江 山 最 佳 处	举 杯 无 惜 望 天 津
虚 明 - 八 穴 - 霜 风 - 人 也 - 虚 明==六 处 虚 明 不 假 修	七 穿 八 穴 有 来 由	霜 风 霰 雪 纵 横 入	不 是 愁 人 也 著 愁
客 归 - 娟 娟 - 夸 客 - 桂 花 - 客 归==日 西 何 事 客 归 迟	等 看 娟 娟 一 寸 眉	却 民 嫦 娥 太 夸 客	和 宫 推 出 桂 花 枝
物 华 - 只 今 - 江 边 - 一 日 - 物 华==几 为 年 华 叹 物 华	只 今 结 束 定 还 家	且 看 垂 发 江 边 树	未 问 长 安 一 日 花
冲 风 - 诗 情 - 正 被 - 雪 声 - 冲 风==知 褐 冲 风 立 晓 亭	无 端 物 物 搅 诗 情	梅 边 正 被 寒 山 恼	又 听 松 梢 衮 雪 声
反 覆 - 交 情 - 双 眸 - 月 光 - 反 覆==出 态 炎 凉 反 覆 易	交 情 贵 贱 死 生 殊	双 眸 炯 炯 碧 天 阔	霁 月 光 风 夜 读 书
昭 回 - 玉 杯 - 团 扇 - 子 问 - 浮 云==浮 云 仙 殿 切 昭 回	甘 露 通 宵 滴 玉 杯	金 锁 才 开 团 扇 入	圣 神 天 子 问 安 来
木 落 - 云 阴 - 苍 苍 - 芙 蓉 - 木 落==桑 枯 木 落 响 天 风	霞 彩 云 阴 暮 景 中	树 色 苍 苍 遮 不 断	满 江 还 有 木 芙 蓉
山 花 - 红 紫 - 蔷 薇 - 落 香 - 山 花==春 晚 山 花 各 静 芳	从 教 红 紫 送 韶 光	忍 冬 清 馥 蔷 薇 酽	薰 满 千 村 万 落 香
野 花 - 桑 麻 - 垂 柳 - 个 个 - 野 花==两 日 山 寻 尽 野 花	今 晨 水 眺 如 桑 麻	春 风 娇 得 千 垂 柳	恰 限 身 才 个 个 斜
修 竹 - 水 面 - 夹 岸 - 秋 风 - 修 竹==山 腰 有 路 穿 修 竹	水 面 无 桥 涉 浅 沙	夹 岸 人 家 尽 农 圃	秋 风 吹 老 木 棉 花
疏 疏 - 楚 楚 - 冰 壶 - 瑶 琴 - 疏 疏==日 华 露 重 疏 疏 竹	宝 砌 风 回 楚 楚 松	酪 粉 冰 壶 驱 薄 暑	瑶 琴 永 日 得 从 容
啼 鸟 - 落 花 - 绿 云 - 游 丝 - 啼 鸟==怕 惊 啼 鸟 推 棋 罢	为 爱 落 花 迂 屐 行	窈 窈 绿 云 春 一 坞	游 丝 飞 絮 弄 新 晴
芙 蓉 - 憔 悴 - 一 枝 - 明 年 - 芙 蓉==今 年 古 寺 摘 芙 蓉	憔 悴 真 成 泽 畔 翁	聊 把 一 枝 闲 照 酒	明 年 何 处 对 霜 红
物 华 - 伤 春 - 憔 悴 - 看 花 - 物 华==二 月 吾 庐 感 物 华	伤 春 多 在 别 人 家	今 年 莫 使 春 憔 悴	能 有 几 番 归 看 花
坐 忘 - 吟 魂 - 孤 鸿 - 残 月 - 坐 忘==夜 已 三 更 忽 坐 忘	吟 魂 醉 魄 政 悠 扬	孤 鸿 见 召 听 寒 角	残 月 相 辞 过 粉 墙
惨 淡 - 婆 娑 - 西 风 - 夜 雨 - 惨 淡==老 去 相 看 终 惨 淡	秋 来 无 赖 对 婆 娑	任 从 叶 逐 西 风 去	要 听 庭 宽 夜 雨 多
十 年 - 东 湖 - 白 云 - 钓 舟 - 青 山==十 年 小 隐 在 青 山	喜 有 东 湖 屋 数 间	门 外 白 云 常 在 眼	此 身 浑 似 钓 舟 闲
梦 中 - 胡 床 - 烹 茶 - 客 情 - 梦 中==梦 中 何 许 得 嘉 宾	对 影 胡 床 岸 幅 巾	石 鼎 烹 茶 火 煨 栗	主 人 坦 率 客 情 真
狂 吟 - 霜 翎 - 春 雨 - 抱 瑶 - 白 鹤==狂 吟 辞 舞 双 白 鹤	霜 翎 玉 羽 纷 纷 落	空 庭 向 晚 春 雨 微	却 敛 寒 香 抱 瑶 萼
玉 殿 - 金 胜 - 云 容 - 曙 色 - 玉 漏==玉 殿 签 声 玉 漏 催	彩 花 金 胜 巧 先 裁	宿 云 容 与 朝 晖 丽	共 喜 春 随 曙 色 来
止 水 - 濯 缨 - 万 斛 - 山 中 - 水 中==止 水 中 间 别 有 天	濯 缨 人 去 自 清 涟	明 珠 万 斛 归 尘 土	不 及 山 中 一 掬 泉
太 乙 - 春 风 - 绛 节 - 青 鸟 - 太 乙==武 帝 清 斋 太 乙 宫	上 林 无 处 不 春 风	遥 知 绛 节 随 王 母	青 鸟 飞 来 御 苑 中
分 符 - 一 纸 - 函 谷 - 应 时 - 疏 疏==老 分 符 竹 发 疏 疏	手 把 南 徐 一 纸 书	端 恨 相 望 隔 函 谷	故 应 时 展 凤 林 图
台 榭 - 风 烟 - 安 成 - 西 湖 - 台 榭==山 环 台 榭 水 环 堤	雪 月 风 烟 是 处 宜	豢 养 宴 安 成 鸩 毒	西 湖 只 合 比 西 施
有 声 - 去 识 - 开 花 - 黄 鹂 - 有 声==雪 覆 岩 眉 涧 有 声	雾 来 雾 去 识 阴 晴	花 开 花 落 山 如 旧	添 得 黄 鹂 绾 别 情
西 湖 - 繁 华 - 仙 诗 - 国 色 - 西 湖==谁 将 西 子 比 西 湖	旧 日 繁 华 渐 欲 无	始 信 坡 仙 诗 是 谶	捧 心 国 色 解 亡 吴
万 卷 - 公 也 - 倚 天 - 龙 头 - 万 卷==万 卷 无 书 道 用 归	闲 文 公 也 未 须 知	倚 天 长 剑 如 重 战	更 有 龙 头 复 是 谁
分 明 - 西 风 - 为 愁 - 长 江 - 梦 中==往 事 分 明 似 梦 中	敝 衣 破 帽 立 西 风	河 流 不 为 愁 人 计	势 逐 长 江 日 夜 东
西 南 - 金 风 - 关 情 - 秋 月 - 在 西==人 在 西 南 分 楚 越	天 转 金 风 更 凄 切	此 时 何 事 最 关 情	团 圆 独 对 中 秋 月
白 头 - 无 力 - 规 模 - 第 一 - 白 头==束 发 学 忆 今 白 头	腕 中 无 力 合 休 休	规 模 尚 欲 从 公 乞	翰 墨 于 今 第 一 流
天 开 - 细 细 - 宫 殿 - 楼 台 - 天 开==天 开 黄 道 日 华 明	细 细 南 薰 下 太 清	宫 殿 云 扶 龙 虎 气	楼 台 风 转 管 弦 声
江 湖 - 风 月 - 为 归 - 青 山 - 江 湖==文 盟 无 主 江 湖 冷	诗 社 欠 人 风 月 闲	老 去 盍 为 归 隐 计	却 於 何 处 买 青 山
鸿 雁 - 烟 雨 - 功 名 - 逍 遥 - 鸿 雁==天 无 鸿 雁 水 无 鸥	烟 雨 茫 茫 我 即 浮	已 识 功 名 如 嚼 蜡	逍 遥 偶 逐 大 鹏 游
春 至 - 萧 然 - 故 人 - 含 情 - 陂 塘==陂 塘 春 至 绿 波 生	讲 肆 萧 然 对 古 城	多 谢 故 人 频 问 讯	渚 兰 汀 树 正 含 情
倚 云 - 翠 华 - 锁 窗 - 梨 花 - 云 霞==上 阳 宫 殿 倚 云 霞	天 外 时 闻 度 翠 华	鱼 钥 重 重 锁 窗 户	夜 来 春 雨 到 梨 花
生 烟 - 六 朝 - 家 缘 - 两 枝 - 生 烟==野 草 生 烟 日 暮 时	六 朝 陵 墓 转 凄 其	家 缘 解 道 鸠 偏 巧	但 取 枯 柴 一 两 枝
日 本 - 征 帆 - 明 月 - 白 云 - 卿 辞==日 本 晁 卿 辞 帝 都	征 帆 一 片 绕 蓬 壶	明 月 不 归 沉 碧 海	白 云 愁 色 满 苍 梧
风 外 - 日 边 - 无 疆 - 一 片 - 风 外==蝉 外 西 风 风 外 叶	雁 边 落 日 日 边 云	诗 仙 世 界 无 疆 场	一 片 青 山 共 子 分
三 千 - 朱 帘 - 春 光 - 花 间 - 三 千==禁 宫 宫 女 三 千 室	多 下 朱 帘 昼 掩 窗	为 避 春 光 羞 独 见	花 间 恨 杀 蝶 飞 双
屈 曲 - 淡 烟 - 诗 人 - 三 弄 - 屈 曲==屈 曲 溪 桥 路 两 丫	淡 烟 如 隔 小 棂 纱	南 枝 已 入 诗 人 手	三 弄 从 教 咽 暮 笳
芙 蓉 - 彩 霞 - 沙 头 - 鱼 飞 - 芙 蓉==芙 蓉 湾 口 绿 阴 斜	吹 笛 何 人 隔 彩 霞	惊 起 沙 头 双 翠 羽	衔 鱼 飞 上 刺 桐 花
新 绿 - 花 非 - 草 木 - 抽 梢 - 绿 深==新 绿 深 深 嫩 更 黄	非 花 非 草 定 何 香	故 山 草 木 皆 余 爱	最 爱 抽 梢 竹 过 墙
故 园 - 一 杯 - 新 诗 - 徘 徊 - 故 园==故 园 回 首 雁 初 来	马 上 千 愁 付 一 杯	惟 有 新 诗 似 相 识	暮 山 吟 处 共 徘 徊
步 月 - 芒 鞋 - 松 竹 - 风 雨 - 步 月==步 月 寻 溪 过 佛 斋	溪 边 石 藓 湿 芒 鞋	虚 窗 独 卧 听 松 竹	半 夜 一 山 风 雨 来
前 村 - 苍 苔 - 春 风 - 花 底 - 前 村==见 说 前 村 破 雪 开	我 来 雪 影 浸 苍 苔	平 生 不 识 春 风 面	却 道 春 从 花 底 来
断 肠 - 断 肠 - 关 更 - 北 风 - 断 肠==断 肠 声 里 无 形 影	画 出 无 声 亦 断 肠	想 得 阳 关 更 西 路	北 风 低 草 见 牛 羊
悠 悠 - 惊 涛 - 钱 塘 - 白 头 - 悠 悠==浙 江 悠 悠 海 西 绿	惊 涛 日 夜 两 翻 覆	钱 塘 郭 里 看 潮 人	直 至 白 头 看 不 足
绝 壁 - 猿 鹤 - 垂 藤 - 一 人 - 绝 壁==绝 壁 深 溪 无 四 邻	每 逢 猿 鹤 即 相 亲	小 奴 惊 出 垂 藤 下	山 犬 今 朝 吠 一 人
花 落 - 风 光 - 蛙 闹 - 紫 燕 - 一 片==一 片 飞 花 落 酒 缸	风 光 渐 觉 远 书 窗	草 深 两 部 青 蛙 闹	芹 湿 重 檐 紫 燕 双
玉 阶 - 湘 裙 - 间 别 - 香 销 - 玉 阶==忽 离 琼 筵 下 玉 阶	湘 裙 低 覆 蹋 云 鞋	情 知 不 是 人 间 别	歌 散 香 销 十 二 钗
雁 来 - 捣 衣 - 独 步 - 绿 苔 - 雁 来==今 夕 秦 天 一 雁 来	梧 桐 坠 叶 捣 衣 催	思 君 独 步 华 亭 月	旧 馆 秋 阴 生 绿 苔
诗 成 - 小 窗 - 岭 外 - 松 间 - 诗 成==十 首 诗 成 尽 可 怜	怜 他 只 影 小 窗 前	也 知 岭 外 归 来 客	独 宿 松 间 十 七 年
山 川 - 江 流 - 十 年 - 衰 草 - 形 胜==山 川 形 胜 说 钱 塘	海 接 江 流 入 混 茫	百 五 十 年 成 底 事	一 丘 衰 草 委 秋 阳
无 言 - 三 农 - 香 穗 - 麈 尾 - 无 言==梵 相 无 言 旱 气 奢	三 农 无 饭 欲 蒸 沙	狻 头 香 穗 成 禾 穗	麈 尾 天 花 化 雨 花
穿 沙 - 林 叶 - 春 来 - 着 地 - 流 水==溅 溅 流 水 曲 穿 沙	林 叶 深 深 不 过 鸦	自 恨 春 来 浑 不 识	殷 勤 着 地 拾 残 花
老 蚌 - 庭 前 - 风 雷 - 缤 纷 - 老 蚌==老 蚌 虚 含 素 月 胎	庭 前 花 雨 自 成 堆	吾 将 倒 转 风 雷 舌	未 必 缤 纷 动 地 来
青 冢 - 埋 玉 - 延 寿 - 毫 端 - 青 冢==青 冢 今 成 土 一 堆	娇 容 埋 玉 恨 难 开	无 端 当 日 毛 延 寿	轻 把 毫 端 巧 作 媒
风 霜 - 石 心 - 苦 吟 - 千 古 - 风 霜==谁 能 当 此 风 霜 面	政 要 渠 侬 铁 石 心	我 亦 苦 吟 羞 不 足	愿 从 千 古 觅 遗 香
叶 疏 - 夕 阳 - 凌 空 - 意 秋 - 疏 林==黄 叶 疏 林 江 上 洲	西 风 角 怨 夕 阳 楼	晚 天 紫 翠 凌 空 阔	只 有 樊 山 取 意 秋
田 夫 - 骑 马 - 看 山 - 自 由 - 田 夫==我 本 田 夫 作 比 丘	也 知 骑 马 胜 骑 牛	如 今 马 上 看 山 色	不 似 骑 牛 得 自 由
清 梦 - 庐 山 - 菊 酒 - 剧 谈 - 清 梦==才 怀 故 里 馀 清 梦	方 说 庐 山 得 好 诗	何 日 与 师 传 菊 酒	剧 谈 浩 劫 未 分 时
乘 凉 - 萍 开 - 微 风 - 清 香 - 乘 凉==侵 晓 乘 凉 偶 独 来	不 因 鱼 跃 见 萍 开	卷 荷 忽 被 微 风 触	泻 下 清 香 露 一 杯
幽 居 - 傍 水 - 草 木 - 江 湖 - 幽 居==幽 人 作 计 筑 幽 居	傍 水 为 亭 手 植 芦	何 爱 世 间 闲 草 木	只 缘 胸 次 有 江 湖
恩 光 - 江 梅 - 百 年 - 甘 棠 - 恩 光==三 的 朝 露 借 恩 光	剩 种 江 梅 作 洞 房	待 得 百 年 俱 玉 雪	冷 官 亦 自 有 甘 棠
东 君 - 轻 红 - 雨 洗 - 翠 幄 - 东 君==欲 识 东 君 用 意 工	故 将 残 叶 衬 轻 红	可 怜 雨 洗 胭 脂 湿	只 怕 风 吹 翠 幄 空
雨 过 - 斜 阳 - 渔 人 - 船 头 - 雨 过==雨 过 春 波 柳 浪 香	布 帆 归 缓 怕 斜 阳	渔 人 为 指 江 城 近	一 塔 船 头 看 渐 长
历 历 - 题 诗 - 露 白 - 西 湖 - 明 珠==树 头 历 历 见 明 珠	底 用 题 诗 问 老 逋	且 买 金 陵 秋 露 白	小 舟 载 月 过 西 湖
海 外 - 到 处 - 临 风 - 传 德 - 海 外==海 外 归 来 解 战 袍	南 游 到 处 任 逍 遥	临 风 快 读 琳 琅 句	棠 荫 争 传 德 政 高
丘 自 - 万 里 - 山 河 - 峰 晚 - 足 更==一 丘 自 足 更 何 营	万 里 福 州 长 在 眼	莫 愁 风 景 异 山 河	晴 天 云 荫 清 峰 晚
茅 亭 - 花 木 - 西 山 - 云 涛 - 茅 亭==茅 亭 水 溜 四 周 遭	花 木 经 春 一 一 高	却 望 西 山 隔 江 水	经 思 一 叶 泛 云 涛
个 个 - 军 中 - 目 士 - 浣 花 - 个 个==生 男 个 个 欲 如 狼	妇 女 军 中 气 不 扬	试 问 争 功 嗔 目 士	几 人 能 敌 浣 花 娘
野 草 - 破 屋 - 满 巷 - 故 人 - 蒙 蒙==蒙 蒙 野 草 自 荣 华	破 屋 夹 茅 人 卖 茶	满 巷 门 基 带 砖 石	有 时 认 得 故 人 家
父 子 - 女 何 - 昨 夜 - 横 枝 - 父 子==从 来 父 子 不 相 离	石 女 何 劳 更 问 伊	昨 夜 寒 岩 无 影 木	白 云 深 处 露 横 枝
风 摇 - 熟 梅 - 去 路 - 撒 手 - 风 摇==风 摇 顶 笠 晓 山 隈	觅 法 心 如 未 熟 梅	去 路 两 肩 担 不 起	会 看 撒 手 得 空 回
藜 火 - 绿 玉 - 同 心 - 山 中 - 藜 火==欲 看 太 乙 青 藜 火	笑 领 仙 人 绿 玉 杯	物 外 同 心 谁 管 鲍	山 中 清 话 得 张 裴
鳌 头 - 月 下 - 红 萼 - 绿 杨 - 鳌 头==鳌 头 移 得 山 三 岛	月 下 传 来 灯 万 枝	香 陌 马 嘶 红 萼 锦	翠 楼 人 倚 绿 杨 眉
箕 山 - 无 人 - 岩 畔 - 千 古 - 寂 寂==寂 寂 箕 山 春 复 秋	更 无 人 到 此 溪 头	弃 瓢 岩 畔 中 宵 月	千 古 空 闻 属 许 由
萧 萧 - 清 泉 - 履 霜 - 人 静 - 曲 槛==修 竹 萧 萧 曲 槛 前	清 泉 虢 虢 小 池 边	琴 中 一 弄 履 霜 操	人 静 当 庭 月 正 圆
百 川 - 中 天 - 东 西 - 今 来 - 百 川==鹿 耳 雄 关 障 百 川	晴 帆 连 贯 水 中 天	好 风 早 晚 东 西 便	送 尽 今 来 古 往 船
对 床 - 敲 窗 - 联 句 - 欹 枕 - 对 床==对 床 风 雨 饱 曾 听	听 雪 敲 窗 更 自 清	旧 日 拥 炉 联 句 乐	而 今 欹 枕 打 逢 声
一 日 - 心 难 - 南 檐 - 向 日 - 一 日==一 日 迢 迢 每 一 餐	我 心 难 伏 我 无 难	南 檐 十 月 绳 床 暖	背 卷 真 经 向 日 看
晴 岚 - 夕 阳 - 倒 影 - 余 霞 - 晴 岚==欲 识 晴 岚 熊 度 奇	直 须 待 到 夕 阳 时	回 光 倒 影 山 如 染	状 出 余 霞 散 绮 诗
滔 天 - 翠 辇 - 千 载 - 福 向 - 滔 天==妖 胡 作 逆 罪 滔 天	翠 辇 仓 皇 幸 蜀 川	千 载 业 缘 磨 不 尽	却 来 邀 福 向 金 仙
锦 城 - 风 声 - 不 眠 - 天 明 - 锦 城==锦 城 飞 马 过 青 城	无 奈 风 声 更 雨 声	一 夜 不 眠 何 似 者	筹 花 赌 酒 到 天 明
山 居 - 闭 门 - 苍 玉 - 一 而 - 山 居==指 点 山 居 向 那 边	闭 门 花 木 养 风 烟	邻 人 不 馔 苍 玉 束	一 一 而 今 欲 造 天
微 茫 - 菱 歌 - 红 衣 - 银 塘 - 微 茫==烟 水 微 茫 漾 远 愁	采 菱 歌 断 夕 阳 收	鹭 鹚 不 省 红 衣 老	犹 恋 银 塘 十 里 秋
寒 梅 - 一 杯 - 远 近 - 维 舟 - 寒 梅==西 陵 江 口 折 寒 梅	争 劝 行 人 把 一 杯	须 信 春 风 无 远 近	维 舟 处 处 有 花 开
窗 前 - 朝 昏 - 苔 痕 - 山 云 - 窗 前==竹 映 窗 前 水 漱 门	数 声 幽 鸟 报 朝 昏	行 来 恐 踏 苔 痕 破	目 送 山 云 过 远 村
韶 华 - 红 蕊 - 书 窗 - 风 暖 - 韶 华==韶 华 向 曙 海 天 开	红 蕊 青 枝 照 水 隈	镇 日 书 窗 无 客 至	小 帘 风 暖 燕 飞 来
细 雨 - 木 叶 - 小 春 - 何 处 - 细 雨==细 雨 生 寒 未 有 霜	庭 前 木 叶 半 青 黄	小 春 此 去 无 多 日	何 处 梅 花 一 绽 香
如 霜 - 前 隐 - 祝 融 - 吟 笔 - 如 霜==平 南 无 策 鬓 如 霜	七 十 峰 前 隐 旧 乡	相 约 祝 融 孤 顶 上	借 君 吟 笔 画 潇 湘
叶 落 - 疏 林 - 车 马 - 闭 门 - 叶 落==叶 落 萧 萧 雍 树 根	疏 林 带 郭 半 颖 村	卧 闻 车 马 墙 边 过	无 事 呼 儿 早 闭 门
菊 开 - 西 成 - 月 明 - 清 香 - 菊 开==稚 子 书 传 白 菊 开	西 成 相 滞 未 容 回	月 明 阶 下 窗 纱 薄	多 少 清 香 透 入 来
仙 子 - 一 杯 - 羽 衣 - 李 花 - 仙 子==满 室 天 香 仙 子 家	一 琴 一 剑 一 杯 茶	羽 衣 常 带 烟 霞 色	不 惹 人 间 桃 李 花
人 迹 - 石 床 - 露 冷 - 松 花 - 无 人==悄 无 人 迹 蔽 瑶 房	数 卷 丹 书 在 石 床	侵 晓 鹤 翻 松 露 冷	松 花 细 细 落 衣 裳
清 标 - 点 缀 - 绚 烂 - 洛 阳 - 清 标==占 断 清 标 第 一 香	墨 池 点 缀 亦 花 王	当 时 绚 烂 今 平 淡	声 价 依 然 重 洛 阳
去 来 - 天 台 - 碧 桃 - 玉 杯 - 归 去==若 问 先 生 归 去 来	此 行 直 是 到 天 台	碧 桃 瑶 草 紫 芝 熟	到 日 须 容 醉 玉 杯
回 心 - 曾 小 - 雪 花 - 冥 冥 - 回 心==回 心 三 月 不 违 仁	已 后 元 曾 小 失 真	一 片 雪 花 轻 著 水	冥 冥 不 复 省 漓 醇
骄 阳 - 开 筵 - 感 应 - 风 雨 - 骄 阳==骄 阳 为 戾 已 成 灾	赖 有 开 筵 周 秀 才	莫 道 上 天 无 感 应	故 教 风 雨 一 齐 来
亭 亭 - 末 官 - 恩 知 - 烂 柯 - 亭 亭==亭 亭 采 棒 足 流 传	太 末 官 勋 压 此 年	感 德 衔 恩 知 有 自	定 应 亦 致 烂 柯 仙
流 光 - 金 壶 - 彩 凤 - 桂 影 - 流 光==缺 月 流 光 入 绮 疏	金 壶 傅 箭 梦 回 初	秦 台 彩 凤 无 消 息	桂 影 空 闲 十 二 除
归 来 - 片 时 - 九 华 - 风 雷 - 归 来==得 诀 归 来 试 炼 看	龙 争 虎 斗 片 时 间	九 华 天 上 人 知 得	一 夜 风 雷 撼 万 山
百 里 - 城 头 - 薄 命 - 沧 浪 - 百 里==自 来 百 里 半 九 十	望 见 城 头 路 愈 长	薄 命 只 愁 追 者 至	人 人 摇 桨 渡 沧 浪
渺 渺 - 飞 燕 - 游 人 - 笙 歌 - 渺 渺==渺 渺 春 湖 夕 霭 浮	落 花 飞 燕 打 兰 舟	游 人 半 入 烟 城 去	月 照 笙 歌 上 水 楼
松 篁 - 道 院 - 清 香 - 数 声 - 松 篁==松 篁 交 翠 入 幽 深	道 院 萧 闲 每 遣 心	一 炷 清 香 宜 燕 坐	数 声 钟 磬 有 余 音
古 今 - 崇 墉 - 风 寒 - 竞 摩 - 古 今==五 丁 鉴 剑 古 今 传	屹 立 崇 墉 蔽 两 川	满 目 风 寒 无 处 避	祗 今 由 径 竞 摩 肩
金 樽 - 客 不 - 一 杯 - 黄 昏 - 金 樽==送 春 剩 欲 举 金 樽	客 不 开 襟 怎 与 论	自 饮 一 杯 归 去 后	喜 逢 家 乐 闹 黄 昏
千 门 - 柳 丝 - 和 风 - 晴 日 - 千 门==万 户 千 门 入 建 章	金 绳 界 路 柳 丝 黄	和 风 偏 度 乐 声 细	晴 日 自 随 宫 泉 长
天 边 - 广 寒 - 江 山 - 逢 山 - 天 边==水 际 天 边 尽 画 屏	广 寒 宫 阙 玉 为 城	南 来 已 为 江 山 助	到 此 逢 山 眼 更 明
玉 钩 - 重 重 - 行 客 - 花 落 - 玉 钩==四 面 帘 垂 碧 玉 钩	重 重 深 院 锁 春 愁	天 涯 行 客 无 归 信	花 落 东 风 懒 下 楼
珍 重 - 章 砥 - 公 子 - 得 意 - 珍 重==珍 重 新 来 十 绝 诗	末 章 砥 柱 不 去 移	因 思 唐 代 诸 公 子	故 少 撞 钟 得 意 时
玉 兔 - 霜 风 - 重 门 - 月 中 - 玉 兔==定 知 玉 兔 十 分 圆	已 作 霜 风 九 月 寒	寄 语 重 门 休 上 钥	夜 潮 留 向 月 中 看
青 云 - 一 枝 - 徘 徊 - 几 点 - 青 云==迭 嶂 青 云 放 晓 晴	乍 看 红 叶 一 枝 横	徘 徊 体 物 难 成 句	几 点 玫 瑰 衬 绿 琼
暖 风 - 拂 羽 - 春 光 - 唤 雨 - 暖 风==日 暖 风 喧 泪 竹 斑	鸣 鸠 拂 羽 树 林 间	眼 中 正 是 春 光 好	唤 雨 呼 晴 莫 等 闲
六 龙 - 箫 鼓 - 繁 华 - 落 日 - 六 龙==昔 记 神 皇 驻 六 龙	横 波 箫 鼓 沸 天 中	谁 知 一 代 繁 华 意	吹 作 菰 蒲 落 日 风
气 象 - 春 酒 - 禁 火 - 欲 然 - 气 象==气 象 才 过 一 百 五	且 持 春 酒 养 衰 年	中 林 不 是 不 禁 火	其 奈 山 樱 发 欲 然
庭 院 - 背 立 - 不 言 - 说 与 - 秋 千==秋 千 庭 院 闭 青 春	背 立 谁 曾 见 得 真	莫 道 不 言 思 忆 事	欲 言 还 说 与 何 人
东 风 - 芭 蕉 - 残 雨 - 人 语 - 东 风==东 风 吹 展 半 廊 青	数 叶 芭 蕉 未 拟 听	记 得 楚 江 残 雨 后	背 灯 人 语 醉 初 醒
得 意 - 蜀 国 - 高 歌 - 两 头 - 得 意==郎 君 得 意 及 青 春	蜀 国 将 军 又 不 贫	一 曲 高 歌 红 一 匹	两 头 娘 子 谢 夫 人
雨 摧 - 离 披 - 残 花 - 春 初 - 风 雨==风 雨 摧 残 桃 李 枝	东 园 无 树 不 离 披	海 棠 过 後 残 花 在	恰 似 上 春 初 发 时
白 石 - 往 来 - 剪 就 - 刘 郎 - 白 石==白 石 鄱 姜 病 更 贫	几 年 白 下 往 来 频	歌 词 剪 就 能 哀 怨	未 必 刘 郎 是 后 身
生 涯 - 字 字 - 沉 水 - 寒 月 - 生 涯==醉 乡 诗 笔 是 生 涯	短 短 蛮 笺 字 字 斜	沉 水 一 株 烟 未 断	半 窗 寒 月 上 梅 花
草 色 - 白 日 - 富 贵 - 疏 花 - 草 色==台 边 草 色 苑 边 云	载 酒 来 游 白 日 曛	富 贵 可 怜 成 一 梦	疏 花 冷 雨 信 陵 坟
纷 纷 - 落 花 - 春 色 - 枝 上 - 纷 纷==杏 雨 纷 纷 满 径 迷	穿 帘 燕 补 落 花 泥	衔 将 春 色 归 巢 去	辜 负 莺 儿 枝 上 啼
凉 露 - 北 风 - 波 浪 - 碎 月 - 凉 露==松 梢 凉 露 警 孤 鹤	潭 面 北 风 蟠 老 蛟	蛟 老 涎 腥 波 浪 恶	独 吟 碎 月 看 松 梢
阴 阴 - 无 人 - 动 地 - 回 波 - 阴 阴==阴 阴 松 竹 景 自 转	午 枕 无 人 到 北 窗	何 许 狂 风 来 动 地	梦 回 波 浪 汹 春 江
方 响 - 声 声 - 谁 家 - 月 下 - 方 响==方 响 闻 时 夜 已 深	声 声 敲 著 客 愁 心	不 知 正 在 谁 家 乐	月 下 犹 疑 是 远 砧
一 曲 - 塞 上 - 正 发 - 北 风 - 一 曲==闻 君 一 曲 古 梁 州	惊 起 黄 云 塞 上 愁	秦 女 树 前 花 正 发	北 风 吹 落 满 城 秋
风 急 - 寒 林 - 辍 棹 - 莲 花 - 风 急==霜 鹤 鸣 时 夕 风 急	乱 鸦 又 向 寒 林 集	此 君 辍 棹 悲 且 吟	独 对 莲 花 一 峰 立
三 年 - 东 堂 - 何 处 - 玉 人 - 三 年==大 学 三 年 闻 琢 玉	东 堂 一 举 早 成 名	借 问 还 家 何 处 好	玉 人 含 笑 下 机 迎
天 涯 - 黯 黯 - 江 上 - 晚 潮 - 天 涯==白 烟 弥 漫 接 天 涯	黯 黯 长 空 一 道 斜	有 似 钱 塘 江 上 望	晚 潮 初 落 见 平 沙
故 人 - 万 壑 - 苍 烟 - 作 人 - 故 人==故 人 折 松 寄 千 里	想 听 万 壑 风 泉 音	谁 言 五 鬣 苍 烟 面	犹 作 人 间 儿 女 心
采 薪 - 荷 叶 - 石 路 - 如 飞 - 采 薪==归 州 女 儿 采 薪 归	荷 叶 遮 头 雨 湿 衣	不 怕 山 边 石 路 滑	竹 篮 在 背 走 如 飞
缭 绕 - 参 差 - 润 柳 - 细 细 - 缭 绕==缭 绕 春 堤 去 欲 穷	参 差 烟 坞 到 还 通	依 依 润 柳 侵 晨 雨	细 细 吹 花 傍 午 风
第 一 - 小 春 - 年 年 - 穷 愁 - 第 一==菊 殿 百 花 梅 第 一	重 阳 节 遇 小 春 来	年 年 岁 岁 身 长 健	摆 去 穷 愁 醉 几 杯
御 沟 - 归 来 - 紫 陌 - 牡 丹 - 御 沟==御 沟 春 水 绕 闲 坊	信 马 归 来 傍 短 墙	幽 榭 名 园 临 紫 陌	晚 风 时 带 牡 丹 香
石 头 - 人 愁 - 风 前 - 西 淮 - 石 头==挝 鼓 民 旗 向 石 头	列 山 山 下 使 人 愁	风 前 独 倚 危 樯 立	遥 认 西 淮 四 五 州
梅 黄 - 重 重 - 人 语 - 采 莲 - 梅 黄==青 梅 黄 尽 雨 无 多	柳 影 重 重 午 日 过	忽 听 隔 篱 人 语 笑	采 莲 艇 子 上 新 河
古 径 - 无 根 - 花 落 - 手 拈 - 古 径==古 径 苔 生 路 已 差	无 根 树 上 发 空 花	一 番 花 落 成 空 果	信 手 拈 来 是 苦 瓜
陂 塘 - 莫 蹉 - 取 盈 - 六 月 - 陂 塘==闻 说 陂 塘 处 处 多	并 工 修 筑 莫 蹉 跎	十 分 积 取 盈 堤 水	六 月 骄 阳 柰 汝 何
鹦 鹉 - 白 龙 - 游 人 - 鼓 声 - 鹦 鹉==鹦 鹉 湖 流 碧 几 湾	白 龙 湫 水 落 陈 山	游 人 秦 小 娘 祠 过	社 鼓 声 边 醉 酒 还
嵩 山 - 松 声 - 九 龙 - 清 夜 - 归 路==嵩 山 归 路 绕 天 坛	雪 影 松 声 满 谷 寒	君 见 九 龙 潭 上 月	莫 辞 清 夜 访 袁 安
列 屋 - 独 斋 - 上 品 - 夜 窗 - 倾 城==贵 人 列 屋 贮 倾 城	公 独 斋 居 彻 骨 清	七 帙 高 年 高 上 品	夜 窗 相 伴 一 寒 檠
柳 条 - 池 边 - 别 后 - 胜 悲 - 柳 条==柳 条 风 暖 会 吟 时	林 下 池 边 屐 齿 移	别 后 过 从 更 疏 懒	暮 蝉 嘹 乱 不 胜 悲
新 月 - 一 吸 - 广 寒 - 水 晶 - 半 规==半 规 新 月 滑 如 酥	流 入 清 樽 一 吸 无	明 日 定 知 广 寒 殿	姮 娥 失 却 水 晶 梳
柳 枝 - 折 柳 - 车 轮 - 长 条 - 柳 枝==门 外 春 风 杨 柳 枝	去 年 折 柳 送 郎 时	车 轮 一 去 无 消 息	只 有 长 条 依 旧 垂
华 南 - 二 女 - 亦 有 - 斑 斑 - 不 南==重 华 南 去 不 南 还	二 女 啼 痕 在 竹 间	亦 有 富 川 苏 子 墨	至 今 枝 叶 尚 斑 斑
英 雄 - 萧 萧 - 铁 马 - 负 耒 - 英 雄==汉 楚 英 雄 逝 水 东	萧 萧 荒 垒 几 秋 风	金 戈 铁 马 酣 争 地	付 与 寻 常 负 耒 翁
虫 鸣 - 梧 桐 - 无 人 - 团 扇 - 虫 鸣==草 要 无 数 候 虫 鸣	月 在 梧 桐 树 上 明	庭 院 无 人 过 夜 半	自 携 团 扇 绕 阶 行
谁 家 - 故 故 - 黄 昏 - 天 涯 - 秋 思==不 知 秋 思 在 谁 家	风 自 西 南 故 故 斜	独 坐 黄 昏 谁 是 伴	应 怜 夫 婿 更 天 涯
秦 楼 - 银 烛 - 香 气 - 歌 声 - 秦 楼==秦 楼 宴 喜 月 裴 回	妓 筵 银 烛 满 庭 开	坐 中 香 气 排 花 出	扇 后 歌 声 逐 酒 来
迢 递 - 别 愁 - 春 风 - 扬 州 - 迢 递==江 山 迢 递 水 东 流	芳 草 无 情 管 别 愁	若 听 春 风 商 女 曲	天 涯 人 在 古 扬 州
隐 隐 - 江 南 - 月 夜 - 玉 人 - 隐 隐==青 山 隐 隐 水 迢 迢	秋 尽 江 南 草 木 凋	二 十 四 桥 明 月 夜	玉 人 何 处 教 吹 箫
茅 檐 - 一 粒 - 萧 条 - 芭 蕉 - 千 金==茅 檐 月 有 千 金 税	稻 饭 年 无 一 粒 租	生 事 萧 条 人 问 我	水 芭 蕉 与 石 菖 蒲
白 白 - 焚 香 - 清 明 - 江 南 - 白 白==梨 花 白 白 柳 条 青	闭 阁 焚 香 奈 雨 声	闻 道 清 明 明 日 是	江 南 风 土 只 宜 晴
岂 有 - 年 光 - 霜 风 - 断 肠 - 元 知==荣 悴 元 知 岂 有 常	纷 纷 草 木 占 年 光	霜 风 一 扫 知 何 在	楚 客 从 来 枉 断 肠
出 谷 - 归 期 - 举 头 - 飞 远 - 出 谷==出 谷 入 谷 路 回 转	秋 风 已 至 归 期 晚	举 头 何 处 望 来 踪	万 仞 千 山 鸟 飞 远
河 声 - 去 国 - 客 情 - 桃 花 - 河 声==河 声 连 底 卷 黄 沙	回 首 方 惊 去 国 赊	唯 有 客 情 无 心 处	暗 随 春 水 涨 桃 花
迎 暖 - 风 自 - 新 岁 - 新 诗 - 迎 暖==送 寒 迎 暖 柳 梢 知	风 自 东 来 着 意 吹	百 万 人 家 贺 新 岁	几 家 荼 垒 有 新 诗
纱 笼 - 雨 后 - 月 朗 - 一 声 - 纱 笼==回 途 石 马 出 纱 笼	嘶 起 寰 中 雨 后 风	吹 散 暮 运 孤 月 朗	危 峦 烟 寺 一 声 钟
鸭 头 - 一 日 - 谁 家 - 花 阴 - 鸭 头==湖 波 绿 似 鸭 头 深	一 日 春 晴 直 万 金	好 事 谁 家 斗 歌 舞	方 舟 齐 榜 出 花 阴
江 上 - 一 枝 - 冷 艳 - 生 香 - 江 上==江 上 春 风 几 日 回	一 枝 先 傍 小 堂 开	恨 无 冷 艳 连 天 白	已 有 生 香 特 地 来
春 色 - 四 老 - 百 岁 - 风 味 - 春 色==锦 园 春 色 满 西 东	一 笑 相 欢 四 老 翁	八 秩 总 开 三 百 岁	玺 天 风 味 此 时 同
野 菊 - 秋 风 - 斜 阳 - 高 下 - 蓼 红==野 菊 斑 斑 岸 蓼 红	使 旗 同 驻 赏 秋 风	斜 阳 更 助 凭 栏 胜	高 下 楼 台 波 影 中
从 樽 - 风 姿 - 日 相 - 雌 雄 - 樽 酒==屡 从 樽 酒 接 从 容	叔 宝 风 姿 照 座 中	他 日 相 逢 年 益 老	棋 坛 尚 可 角 雌 雄
香 销 - 芳 树 - 蛾 眉 - 襄 王 - 香 销==黼 帐 香 销 宝 镜 尘	经 过 芳 树 不 成 春	蛾 眉 莫 道 为 枯 骨	犹 作 襄 王 梦 里 人
碧 玉 - 西 山 - 岚 光 - 新 诗 - 碧 玉==谁 结 危 亭 碧 玉 堆	西 山 爽 气 唤 仍 回	岚 光 只 恐 不 堪 着	更 遣 新 诗 勾 引 来
茫 茫 - 风 吹 - 残 阳 - 今 古 - 茫 茫==白 骨 茫 茫 散 不 收	朔 风 吹 雪 度 瓜 州	残 阳 欲 落 未 落 处	照 尽 行 人 今 古 愁
夜 半 - 义 气 - 整 顿 - 归 来 - 夜 半==禁 中 夜 半 定 天 下	仁 风 义 气 彻 修 门	十 分 整 顿 乾 坤 了	复 辟 归 来 道 更 尊
归 来 - 谪 宦 - 无 弦 - 况 临 - 归 来==陶 令 归 来 为 逸 赋	乐 天 谪 宦 起 悲 歌	有 弦 应 被 无 弦 笑	何 况 临 弦 泣 更 多
溪 头 - 巷 陌 - 酒 旗 - 画 楼 - 溪 头==溪 头 亭 匾 佳 山 水	水 绕 山 围 巷 陌 清	晚 向 酒 旗 向 处 泊	画 楼 更 点 亦 春 声
登 临 - 太 平 - 及 楼 - 凝 情 - 登 临==登 临 只 待 此 楼 成	要 与 邦 人 乐 太 平	甫 及 楼 成 余 已 去	匆 匆 一 眺 但 凝 情
桑 林 - 牛 羊 - 唐 汝 - 为 发 - 桑 林==黄 叶 桑 林 赤 土 冈	蓬 茅 小 径 度 牛 羊	似 闻 流 乞 之 唐 汝	叹 息 何 人 为 发 仓
画 像 - 高 阁 - 今 朝 - 种 松 - 画 像==新 作 斋 当 祠 画 像	又 兴 高 阁 秘 天 踪	今 朝 还 藉 君 移 柏	昨 日 已 因 鹅 种 松
千 古 - 茫 茫 - 商 山 - 白 头 - 千 古==焚 书 千 古 讶 嬴 秦	逃 难 茫 茫 走 缙 绅	尚 忆 商 山 近 京 洛	白 头 容 得 采 芝 人
江 干 - 狐 裘 - 输 与 - 金 丹 - 雨 暗==早 春 风 雨 暗 江 干	羔 酒 狐 裘 不 敌 寒	输 与 蒲 龛 深 袖 手	一 炉 真 火 养 金 丹
溶 溶 - 潺 潺 - 云 水 - 何 处 - 曳 曳==溶 溶 曳 曳 山 上 云	潺 潺 湲 湲 山 下 水	试 问 其 间 云 水 人	更 於 何 处 求 诸 己
茅 屋 - 随 意 - 三 冬 - 百 尺 - 茅 屋==茅 屋 东 溪 兴 可 乘	竹 篱 随 意 挂 鱼 罾	三 冬 雪 压 千 年 树	四 月 花 繁 百 尺 藤
翠 阴 - 成 林 - 诗 句 - 凌 虚 - 翠 阴==忆 弄 吟 毫 倚 翠 阴	也 应 新 笋 更 成 林	感 君 潇 洒 赓 诗 句	不 负 凌 虚 一 寸 心
和 气 - 喜 晴 - 篱 边 - 青 青 - 和 气==时 近 清 和 气 愈 浓	雨 催 花 实 喜 晴 风	篱 边 点 点 如 钱 大	尽 是 青 青 间 绿 红
流 水 - 天 寒 - 卒 岁 - 负 暄 - 流 水==药 溪 流 水 碧 差 差	不 拟 天 寒 出 浴 迟	卒 岁 无 衣 双 赤 膊	负 暄 岩 下 曝 孙 儿
功 名 - 十 年 - 湖 上 - 尽 日 - 功 名==落 落 功 名 鬓 早 斑	蹉 跎 心 事 十 年 间	看 来 只 合 归 湖 上	渔 钓 丛 中 尽 日 闲
蝶 梦 - 一 帘 - 柳 腰 - 今 夜 - 蝶 梦==香 透 蜂 房 蝶 梦 残	一 帘 新 雨 又 春 阑	柳 腰 瘦 得 难 禁 舞	今 夜 春 风 莫 更 寒
无 尘 - 万 瓦 - 晓 来 - 精 神 - 风 高==风 高 一 阔 净 无 尘	万 瓦 生 光 冷 射 人	不 见 晓 来 迷 晓 雪	但 看 霜 月 益 精 神
故 人 - 风 味 - 千 年 - 驿 骑 - 故 人==手 自 封 题 寄 故 人	聊 将 风 味 赴 诗 唇	千 年 尚 忆 唐 羌 疏	不 污 华 清 驿 骑 尘
红 锦 - 柳 绿 - 窥 鱼 - 一 点 - 红 锦==出 岸 桃 花 红 锦 英	夹 堤 杨 柳 绿 丝 轻	遥 看 白 鹭 窥 鱼 处	立 破 平 湖 一 点 青
青 山 - 松 竹 - 柴 门 - 窗 前 - 青 山==江 上 青 山 叠 叠 来	屋 头 松 竹 手 亲 栽	柴 门 尽 日 无 人 到	时 见 窗 前 云 作 堆
跪 乳 - 芳 谥 - 洗 盏 - 菜 羹 - 跪 乳==生 尝 跪 乳 资 名 教	死 去 遗 芳 谥 碧 香	洗 盏 开 尝 吾 未 敢	称 冤 肯 入 菜 羹 肠
花 红 - 中 流 - 春 夏 - 一 年 - 两 岸==两 岸 桃 花 红 欲 然	沿 中 流 出 自 涓 涓	仙 家 不 曾 论 春 夏	石 烂 松 枯 是 一 年
万 里 - 西 风 - 论 斤 - 耳 目 - 万 里==万 里 江 滨 长 野 芦	西 风 元 不 费 工 夫	两 京 齐 菜 论 斤 卖	耳 目 由 来 喜 所 无
云 气 - 潮 生 - 短 笛 - 柳 阴 - 云 气==雨 过 山 头 云 气 湿	潮 生 渡 口 岸 痕 深	一 声 短 笛 斜 阳 外	知 有 渔 舟 泊 柳 阴
美 人 - 碧 玉 - 水 深 - 江 南 - 萧 萧==萧 萧 美 人 脱 凡 俗	蕉 姓 称 罗 各 碧 玉	月 昏 潇 湘 烟 水 深	为 君 一 弄 江 南 曲
鹦 鹉 - 桃 花 - 文 章 - 何 年 - 鹦 鹉==安 南 远 进 红 鹦 鹉	色 似 桃 花 语 似 人	文 章 辩 慧 皆 如 此	笼 槛 何 年 出 得 身
桃 李 - 山 城 - 狐 裘 - 愁 宽 - 桃 李==桃 李 欲 开 天 雨 雪	二 月 山 城 无 奈 寒	赖 尔 狐 裘 来 送 质	更 须 樽 酒 放 愁 宽
千 里 - 波 浪 - 干 戈 - 龙 舟 - 千 里==千 里 长 河 一 旦 开	亡 隋 波 浪 九 天 来	锦 帆 未 落 干 戈 起	惆 怅 龙 舟 更 不 回
蔓 草 - 夕 阳 - 谈 天 - 西 风 - 蔓 草==废 鼓 楼 前 蔓 草 多	夕 阳 骑 马 下 坡 陀	欲 谈 天 祐 谁 堪 问	自 唱 西 风 菜 叶 歌
柴 门 - 床 西 - 出 户 - 落 木 - 柴 门==柴 门 一 月 南 京 雨	斗 帐 半 床 西 晋 书	藜 杖 日 晴 初 出 户	园 林 落 木 已 萧 疏
孤 村 - 焚 香 - 陌 上 - 知 巢 - 孤 村==缚 茅 本 不 傍 孤 村	尽 日 焚 香 深 闭 门	陌 上 红 尘 高 没 马	谁 知 巢 父 个 中 存
西 湖 - 云 间 - 如 今 - 西 湖 - 西 湖==每 泛 西 湖 不 忍 还	高 亭 数 叠 出 云 间	如 今 回 至 高 亭 路	却 望 西 湖 数 叠 山
迢 迢 - 风 弄 - 晓 日 - 轻 寒 - 迢 迢==野 塘 春 水 绿 迢 迢	上 有 东 风 弄 柳 条	晓 日 已 穿 东 岭 出	轻 寒 犹 欲 战 驼 毛
十 年 - 花 开 - 三 春 - 逢 大 - 十 年==二 十 年 来 辨 是 非	榴 花 开 处 照 官 闱	三 春 争 及 初 春 景	虎 兔 相 逢 大 梦 归
如 云 - 绮 罗 - 莲 花 - 千 年 - 如 云==汉 将 如 云 不 直 言	寇 来 翻 罪 绮 罗 恩	托 君 休 洗 莲 花 血	留 记 千 年 妾 泪 痕
江 上 - 早 梅 - 幽 香 - 一 樽 - 江 上==新 春 江 上 使 星 回	不 为 离 人 寄 早 梅	爱 惜 幽 香 意 如 此	一 樽 岂 是 等 闲 来
五 老 - 目 断 - 山 色 - 烟 岚 - 一 醉==五 老 峰 前 一 醉 休	长 空 目 断 水 云 浮	要 将 心 地 同 山 色	莫 放 烟 岚 翳 上 头
吹 雨 - 轻 寒 - 又 老 - 芳 草 - 晚 风==晚 风 吹 雨 过 西 畴	恻 恻 轻 寒 似 早 秋	燕 乳 鸠 鸣 春 又 老	可 堪 芳 草 唤 人 愁
鱼 村 - 雨 外 - 竹 边 - 暮 色 - 鱼 村==鱼 村 橘 市 楚 江 边	人 外 秋 原 雨 外 川	遣 骑 竹 边 邀 短 艇	天 涯 暮 色 已 苍 然
春 风 - 红 药 - 病 夫 - 金 缕 - 风 雨==涉 春 风 雨 见 花 稀	红 药 开 时 春 已 非	病 夫 何 与 知 许 事	送 与 缓 歌 金 缕 衣
宰 相 - 林 下 - 一 壶 - 松 风 - 宰 相==试 问 朝 中 为 宰 相	何 如 林 下 作 神 仙	一 壶 美 酒 一 炉 药	饱 听 松 风 白 昼 眠
风 光 - 千 红 - 牡 丹 - 无 心 - 风 光==三 月 风 光 不 贷 人	千 红 百 紫 已 成 尘	牡 丹 底 事 开 偏 晚	本 自 无 心 独 占 春
片 片 - 江 上 - 飘 零 - 清 光 - 片 片==片 片 飞 来 静 又 闲	楼 头 江 上 复 山 前	飘 零 尽 日 不 归 去	帖 破 清 光 万 里 天
昨 夜 - 散 漫 - 陶 写 - 尘 埃 - 昨 夜==昨 夜 青 皇 驾 趣 旋	星 榆 散 漫 晚 风 颠	一 春 无 著 供 陶 写	满 砚 尘 埃 费 洗 前
秋 山 - 蛩 声 - 银 河 - 酒 醒 - 雨 过==雨 过 秋 山 翠 满 城	思 君 江 馆 入 蛩 声	夜 凉 独 坐 银 河 下	吟 到 酒 醒 溪 月 明
幽 人 - 春 雨 - 幽 人 - 柳 眉 - 幽 人==幽 人 何 事 苦 伤 春	春 雨 无 端 愁 杀 人	不 但 幽 人 独 愁 怨	江 头 多 少 柳 眉 颦
毫 末 - 松 声 - 风 雨 - 冰 壶 - 毫 末==笔 间 云 气 生 毫 末	纸 上 松 声 听 有 无	收 得 三 茅 风 雨 样	高 堂 六 月 是 冰 壶
无 心 - 骑 马 - 可 怜 - 何 处 - 无 心==无 心 看 春 只 欲 坐	偶 骑 马 傍 春 街 行	可 怜 愁 以 草 得 暖	一 寸 心 从 何 处 生
隐 映 - 高 低 - 无 人 - 夜 夜 - 隐 映==幽 岛 曲 池 相 隐 映	小 桥 虚 阁 半 高 低	好 风 好 月 无 人 宿	夜 夜 水 禽 船 上 栖
水 边 - 小 艇 - 浊 酒 - 斜 日 - 水 边==乱 山 深 处 水 边 村	小 艇 初 归 未 掩 门	吹 火 煮 鱼 倾 浊 酒	半 规 斜 日 照 黄 昏
雪 花 - 酒 壶 - 琼 瑶 - 迷 路 - 雪 花==雪 花 如 掌 角 阶 除	剧 饮 时 看 卧 酒 壶	半 夜 琼 瑶 深 没 膝	欲 归 迷 路 肯 留 无
腐 草 - 数 点 - 无 人 - 入 照 - 腐 草==化 形 腐 草 暗 生 光	数 点 随 风 过 野 塘	窗 下 久 无 人 夜 读	此 身 不 入 照 书 囊
天 台 - 带 月 - 石 桥 - 春 雨 - 天 台==天 台 路 上 寻 牛 迹	瀑 雪 千 寻 带 月 飞	见 说 石 桥 行 不 得	年 年 春 雨 上 苔 衣
翠 色 - 幽 怀 - 阑 干 - 云 深 - 翠 色==翠 色 沈 沈 万 树 春	幽 怀 宜 共 竹 为 邻	黄 山 只 在 阑 干 外	鸡 阁 云 深 认 不 真
白 头 - 无 奈 - 易 吟 - 肠 断 - 白 头==白 头 从 事 未 抛 诗	无 奈 才 何 复 苦 饥	我 易 吟 愁 归 乐 土	因 君 肠 断 邺 中 诗
山 极 - 白 雪 - 千 里 - 残 照 - 云 合==前 山 极 远 碧 云 合	清 夜 一 声 白 雪 微	欲 寄 相 思 千 里 月	溪 边 残 照 雨 霏 霏
东 风 - 识 阿 - 归 路 - 太 平 - 东 风==东 风 放 牧 出 长 坡	谁 识 阿 童 乐 趣 多	归 路 转 鞭 牛 背 上	笛 声 吹 老 太 平 歌
竹 影 - 桂 子 - 是 客 - 他 乡 - 斜 阳==满 阶 竹 影 扫 斜 阳	一 枕 秋 风 桂 子 香	梦 裹 不 知 身 是 客	觉 来 依 旧 在 他 乡
似 火 - 中 能 - 佳 人 - 翠 云 - 似 火==似 火 山 榴 映 小 山	繁 中 能 薄 艳 中 闲	一 朵 佳 人 玉 钗 上	只 疑 烧 却 翠 云 鬟
香 消 - 玉 殿 - 千 门 - 无 人 - 香 消==金 鸭 香 消 更 漏 长	沉 沉 玉 殿 紫 苔 生	高 空 有 月 千 门 照	大 道 无 人 独 自 行
桃 红 - 玄 都 - 花 开 - 春 风 - 桃 红==琳 宫 深 处 小 桃 红	当 日 玄 都 事 已 空	今 见 花 开 浑 似 旧	不 知 又 隔 几 春 风
安 排 - 红 尘 - 年 分 - 侍 郎 - 安 排==明 头 暗 合 绝 安 排	莫 厌 红 尘 拨 不 开	不 见 当 年 分 庵 主	一 声 江 上 侍 郎 来
悲 秋 - 月 中 - 秋 色 - 悲 秋 - 悲 秋==旧 不 悲 秋 只 爱 秋	风 中 吹 笛 月 中 楼	如 今 秋 色 浑 如 旧	欲 不 悲 秋 不 自 由
北 斗 - 逐 月 - 一 声 - 万 里 - 低 垂==北 斗 低 垂 挂 戍 楼	黄 河 不 逐 月 西 流	一 声 长 笛 冲 沙 起	散 作 边 人 万 里 愁
万 瓦 - 别 山 - 阁 下 - 一 日 - 万 瓦==万 瓦 如 鳞 绣 作 堆	别 山 重 见 秃 翁 来	晴 川 阁 下 南 条 水	一 日 同 君 荡 几 回
看 山 - 山 骨 - 白 头 - 江 南 - 看 山==终 日 看 山 唤 不 回	却 如 山 骨 瘦 归 来	白 头 未 老 青 鞋 底	无 限 江 南 翠 作 堆
清 风 - 垂 虹 - 命 驾 - 清 游 - 清 风==一 舸 清 风 四 牡 还	垂 虹 亭 上 几 栏 干	季 鹰 命 驾 劳 千 里	如 我 清 游 却 不 难
绿 杨 - 树 含 - 天 为 - 麒 麟 - 绿 杨==绿 杨 红 杏 满 城 春	杂 树 含 芳 让 锦 茵	天 为 吾 皇 宗 杜 计	老 君 亲 送 石 麒 麟
画 船 - 风 烟 - 应 节 - 哥 哥 - 画 船==画 船 女 儿 打 吴 歌	缥 缈 风 烟 莎 接 麽	却 与 桨 声 相 应 节	到 来 只 是 唤 哥 哥
新 诗 - 沉 沉 - 疏 花 - 和 烟 - 新 诗==改 罢 新 诗 独 自 吟	忆 君 不 至 意 沉 沉	疏 花 对 雨 平 栏 静	芳 草 和 烟 古 巷 深
衣 冠 - 千 年 - 居 山 - 明 月 - 拂 拂==拂 拂 云 衣 冠 紫 烟	已 为 丁 令 一 千 年	留 君 且 伴 居 山 客	幸 有 松 梢 明 月 天
题 诗 - 日 上 - 松 阴 - 渡 水 - 题 诗==拾 叶 题 诗 愧 不 才	袖 遮 微 日 上 层 台	山 僧 分 我 松 阴 坐	隔 岸 花 香 渡 水 来
读 书 - 屠 苏 - 蒲 团 - 宰 予 - 读 书==汲 古 无 初 不 读 书	屠 苏 新 制 帖 僧 庐	痴 禅 昼 夜 蒲 团 上	贪 睡 犹 胜 学 宰 予
将 归 - 细 雨 - 泪 尽 - 沾 衣 - 将 归==断 帆 秋 水 送 将 归	满 目 黄 花 细 雨 飞	泪 尽 报 恩 惟 一 剑	要 离 冢 上 血 沾 衣
游 春 - 风 光 - 歌 舞 - 白 头 - 游 春==欲 随 年 少 强 游 春	自 觉 风 光 不 属 身	歌 舞 屏 风 花 障 上	几 时 曾 画 白 头 人
春 来 - 花 开 - 新 春 - 幽 人 - 春 来==今 岁 春 来 我 亦 来	折 花 犹 未 见 花 开	新 春 况 有 四 十 日	莫 怪 幽 人 空 手 回
名 花 - 梅 竟 - 中 华 - 闻 香 - 名 花==名 花 齐 向 胆 瓶 张	桃 菊 荷 梅 竟 竞 芳	说 与 中 华 人 不 信	老 夫 亲 见 细 闻 香
怀 恩 - 东 堂 - 犹 有 - 惭 京 - 怀 恩==怀 恩 马 柳 志 何 卑	挟 恨 东 堂 德 愈 衰	犹 有 豫 章 苏 武 节	不 惭 京 口 协 谋 时
零 落 - 薄 暮 - 人 情 - 倚 栏 - 零 落==零 落 斜 枝 雪 未 乾	且 垂 薄 暮 护 微 寒	大 都 荣 悴 人 情 别	我 为 残 英 特 倚 栏
春 色 - 清 流 - 雪 消 - 惊 飞 - 春 色==洛 川 春 色 几 时 归	漾 漾 清 流 照 翠 微	日 暖 雪 消 沙 岸 软	鸳 鸯 相 对 不 惊 飞
清 明 - 楼 台 - 秋 千 - 斗 草 - 清 明==门 巷 清 明 燕 子 来	绿 杨 如 雾 掩 楼 台	同 随 女 伴 秋 千 下	更 向 花 间 斗 草 回
梧 桐 - 生 凉 - 阑 干 - 紫 箫 - 秋 声==秋 声 早 已 到 梧 桐	露 气 生 凉 湛 碧 空	独 倚 阑 干 待 明 月	紫 箫 吹 散 木 樨 风
大 千 - 万 重 - 上 宝 - 照 北 - 大 千==玉 京 世 界 大 千 中	银 屋 楼 台 一 万 重	好 上 宝 莲 山 上 望	南 高 峰 照 北 高 峰
纤 纤 - 跃 隔 - 篮 舆 - 玉 壶 - 新 月==新 月 纤 纤 淡 欲 无	时 闻 鱼 跃 隔 菰 蒲	篮 舆 小 放 湖 堤 上	信 有 人 间 白 玉 壶
寒 泉 - 芭 蕉 - 一 叶 - 犹 明 - 峥 嵘==寒 泉 中 有 小 峥 嵘	种 得 芭 蕉 积 渐 成	一 叶 似 抽 人 不 见	无 窗 头 白 眼 犹 明
别 离 - 南 北 - 十 年 - 立 马 - 灞 水==灞 水 何 人 不 别 离	无 家 南 北 倚 空 悲	十 年 此 路 花 时 节	立 马 沾 襟 酒 一 卮
西 成 - 谁 家 - 早 起 - 檐 前 - 西 成==西 成 课 罢 赴 群 居	中 路 谁 家 倦 憩 予	恰 见 主 人 方 早 起	檐 前 观 我 所 为 书
云 间 - 萧 森 - 溪 头 - 霜 花 - 云 间==云 间 古 寺 陆 机 宅	草 木 萧 森 鹤 不 来	惟 有 溪 头 老 梅 树	霜 花 犹 是 旧 时 开
玉 楼 - 繁 华 - 园 中 - 蝉 声 - 佳 人==一 自 佳 人 坠 玉 楼	繁 华 东 逐 洛 河 流	唯 馀 金 谷 园 中 树	残 日 蝉 声 送 客 愁
光 流 - 感 慨 - 云 气 - 朝 云 - 转 寻==时 光 流 转 寻 常 事	世 故 惊 心 感 慨 多	一 岁 休 祥 在 云 气	今 朝 云 气 果 如 何
步 步 - 琼 树 - 逃 名 - 安 一 - 金 莲==步 步 金 莲 何 可 得	朝 朝 琼 树 有 无 新	那 能 寇 录 逃 名 姓	早 醉 长 安 一 息 春
天 府 - 将 烦 - 可 人 - 斡 旋 - 天 府==天 府 何 为 屈 我 公	谩 将 烦 处 压 才 雄	若 兼 二 辅 亦 可 人	万 化 斡 旋 犹 有 功
落 落 - 冥 冥 - 春 风 - 南 陌 - 落 落==身 谋 落 落 屠 羊 说	心 事 冥 冥 司 马 炎	告 诉 春 风 无 一 语	江 南 陌 上 雨 廉 纤
江 湖 - 玉 隆 - 精 神 - 胸 中 - 江 湖==江 湖 见 说 老 蓝 公	今 日 相 逢 在 玉 隆	竹 样 精 神 梅 样 骨	况 君 梅 竹 在 胸 中
山 亭 - 五 夜 - 柏 台 - 可 怜 - 山 亭==羊 公 留 宴 岘 山 亭	洛 浦 高 歌 五 夜 情	独 向 柏 台 为 老 吏	可 怜 林 木 响 馀 声
独 立 - 满 树 - 四 时 - 秋 天 - 黄 昏==黄 昏 独 立 佛 堂 前	满 地 槐 花 满 树 蝉	大 抵 四 时 心 总 苦	就 中 肠 断 是 秋 天
跃 马 - 一 杯 - 茫 茫 - 锦 鳞 - 跃 马==跃 马 来 游 汉 水 春	一 杯 聊 买 醮 诗 神	茫 茫 鹦 鹉 洲 边 渡	尺 素 谁 能 寄 锦 鳞
花 柳 - 百 和 - 银 箭 - 仙 子 - 枫 宸==千 门 花 柳 转 枫 宸	百 和 香 中 过 辇 尘	银 箭 忽 从 天 上 落	六 宫 仙 子 听 时 辰
杏 花 - 雪 飞 - 横 槊 - 春 归 - 杏 花==湖 山 春 花 杏 花 稀	柳 絮 漫 空 作 雪 飞	横 槊 赋 诗 有 余 暇	不 妨 倒 载 送 春 归
光 冷 - 流 萤 - 天 阶 - 织 女 - 秋 光==红 烛 秋 光 冷 画 屏	轻 罗 小 扇 扑 流 萤	天 阶 夜 色 凉 如 水	坐 看 牵 牛 织 女 星
洛 邑 - 苍 翠 - 风 流 - 青 山 - 洛 邑==洛 邑 从 来 天 地 中	嵩 高 苍 翠 北 邙 红	风 流 耆 旧 消 磨 尽	只 有 青 山 对 病 翁
西 风 - 窗 前 - 秋 月 - 拈 弄 - 昨 夜==西 风 昨 夜 到 庭 梧	晓 看 窗 前 一 叶 无	秋 月 照 人 眠 不 得	等 闲 拈 弄 绣 工 夫
三 尺 - 秋 风 - 有 恨 - 人 更 - 三 尺==京 索 先 生 三 尺 坟	秋 风 漠 漠 吐 寒 云	从 来 有 恨 君 多 哭	今 日 何 人 更 哭 君
览 镜 - 容 枯 - 态 侵 - 迟 迟 - 览 镜==朝 来 览 镜 一 何 衰	好 秃 容 枯 半 白 髭	老 态 侵 寻 光 景 促	著 鞭 从 此 勿 迟 迟
悠 悠 - 柳 拂 - 江 南 - 送 春 - 斜 日==远 汀 斜 日 思 悠 悠	花 拂 离 肠 柳 拂 舟	江 北 江 南 芳 草 遍	送 君 并 得 送 春 愁
扁 舟 - 雨 昏 - 江 上 - 蓼 红 - 晚 风==一 叶 扁 舟 信 晚 风	雨 昏 浑 不 辨 西 东	不 因 再 到 秋 江 上	争 见 芦 花 对 蓼 红
鳞 皴 - 绿 苔 - 先 生 - 花 开 - 鳞 皴==鳞 皴 一 块 烂 枯 柴	几 见 春 风 长 绿 苔	岂 谓 先 生 也 相 许	驴 年 决 定 放 花 开
林 间 - 两 朵 - 池 中 - 吓 不 - 林 间==月 黑 林 间 亦 自 奇	莲 花 两 朵 白 如 衣	初 疑 野 鹭 池 中 立	试 拍 栏 干 吓 不 飞
浮 云 - 纷 纷 - 晚 岁 - 忘 言 - 浮 云==白 衣 苍 狗 变 浮 云	过 眼 纷 纷 不 可 论	晚 岁 逢 迎 真 耐 久	青 山 相 对 两 忘 言
秋 天 - 客 思 - 州 路 - 江 边 - 鸟 声==鸟 声 愁 雨 似 秋 天	病 客 思 家 一 向 眠	草 馆 门 临 广 州 路	夜 闻 蛮 语 小 江 边
春 风 - 柳 外 - 苦 未 - 眼 看 - 春 风==一 堤 杨 柳 占 春 风	柳 外 群 山 细 雨 中	人 苦 未 晴 浑 不 到	只 宜 老 眼 看 空 濛
依 依 - 翠 袖 - 香 风 - 江 妃 - 依 依==湘 云 冉 冉 月 依 依	翠 袖 霓 裳 作 队 归	怪 底 香 风 吹 不 断	水 晶 宫 里 宴 江 妃
宫 妆 - 温 泉 - 风 来 - 披 云 - 宫 妆==亭 亭 青 盖 倚 宫 妆	新 浴 温 泉 体 自 香	暂 借 清 风 来 一 霎	欲 披 云 锦 见 蜂 房
腾 空 - 崎 岖 - 衡 用 - 一 家 - 腾 空==人 言 潘 谷 久 腾 空	衡 也 崎 岖 隐 墨 中	谷 见 坡 诗 衡 用 诀	了 知 真 是 一 家 风
云 敛 - 万 木 - 亭 前 - 冷 泉 - 云 敛==晚 云 敛 尽 鹤 声 迟	万 木 号 空 夜 景 移	三 笑 亭 前 山 月 上	却 如 身 在 冷 泉 时
摩 挲 - 硬 黄 - 游 戏 - 千 金 - 微 茫==摩 挲 石 刻 叹 微 茫	孰 若 汗 青 移 硬 黄	几 净 窗 明 肯 游 戏	千 金 便 当 橐 中 装
春 来 - 江 山 - 白 首 - 三 杯 - 春 来==天 上 春 来 谁 报 人	江 山 气 象 一 时 新	懒 将 白 首 簪 幡 胜	寿 酒 三 杯 慰 逐 臣
雨 余 - 庭 院 - 画 栏 - 山 光 - 蛙 吹==雨 余 蛙 吹 歇 池 塘	庭 院 人 闲 日 正 长	独 倚 画 栏 看 不 尽	海 棠 无 处 是 山 光
一 水 - 斑 斑 - 扁 舟 - 落 日 - 一 水==白 下 长 干 一 水 间	竹 云 新 笋 已 斑 斑	明 朝 若 有 扁 舟 兴	落 日 潮 生 尚 可 还
朦 胧 - 饶 舌 - 春 睡 - 骑 马 - 残 月==梦 和 残 月 两 朦 胧	饶 舌 幽 禽 苦 唤 侬	若 说 五 更 春 睡 好	绝 胜 骑 马 火 城 中
槐 市 - 得 意 - 夜 月 - 画 船 - 柳 桥==柳 桥 槐 市 暂 经 过	飘 泊 汀 洲 得 意 多	夜 月 已 忘 吴 主 恨	画 船 空 有 采 莲 歌
西 湖 - 古 松 - 花 落 - 岩 前 - 西 湖==家 住 西 湖 深 更 深	古 松 隐 裹 礼 茅 君	白 猿 攀 树 藤 花 落	点 破 岩 前 一 地 云
舞 筵 - 断 肠 - 秋 日 - 带 蝉 - 舞 筵==曾 逐 东 风 拂 舞 筵	乐 游 春 苑 断 肠 天	如 何 肯 到 清 秋 日	已 带 斜 阳 又 带 蝉
悠 扬 - 轻 飞 - 百 斛 - 浓 抹 - 悠 扬==东 家 蝴 蝶 爱 悠 扬	不 肯 轻 飞 过 短 墙	剩 买 麝 煤 千 百 斛	暖 熏 浓 抹 到 沈 香
鹧 鸪 - 兽 舞 - 花 村 - 今 自 - 鹧 鸪==呜 呜 胡 笛 鹧 鸪 声	三 叠 鸣 兽 舞 袖 轻	灯 市 花 村 旧 欢 醉	如 今 自 厌 邈 无 情
红 云 - 晴 日 - 玉 阙 - 霞 巾 - 红 云==海 棠 亭 上 号 红 云	晴 日 青 天 绛 彩 新	疑 是 群 仙 朝 玉 阙	一 时 都 戴 紫 霞 巾
西 风 - 月 华 - 枝 柔 - 绿 叶 - 西 风==西 风 顿 拆 晚 秋 葩	色 映 霜 华 与 月 华	不 特 翠 枝 柔 猗 傩	更 饶 绿 叶 密 交 加
翠 竹 - 青 山 - 白 昼 - 秋 霜 - 翠 竹==阴 阴 翠 竹 销 虚 堂	竹 外 青 山 半 出 墙	七 尺 龙 牙 消 白 昼	便 应 题 作 小 秋 霜
沧 浪 - 寒 烟 - 珍 重 - 斜 阳 - 沧 浪==沧 浪 渡 口 莫 愁 乡	万 顷 寒 烟 木 落 霜	珍 重 使 君 留 客 意	一 尊 芳 酒 醉 斜 阳
云 华 - 凤 凰 - 区 区 - 成 康 - 云 华==狠 云 华 月 丽 衣 裳	搏 拊 初 登 下 凤 凰	竹 矢 区 区 天 亦 爱	河 图 相 伴 到 成 康
树 头 - 秋 声 - 茅 亭 - 青 山 - 树 头==云 压 树 头 兼 雨 气	水 流 溪 口 夹 秋 声	就 岩 着 个 茅 亭 子	不 必 青 山 定 有 名
步 履 - 雨 余 - 黄 犬 - 溪 边 - 步 履==步 履 寻 春 有 好 怀	雨 余 蹄 道 水 如 杯	随 人 黄 犬 搀 前 去	走 到 溪 边 忽 自 回
鸟 啼 - 花 落 - 刻 漏 - 桐 阴 - 鸟 啼==寂 寂 青 山 一 鸟 啼	紫 藤 花 落 午 风 微	不 知 刻 漏 长 多 少	但 觉 桐 阴 半 日 移
事 随 - 法 皆 - 一 条 - 古 今 - 事 随==万 事 随 缘 无 所 为	万 法 皆 空 无 所 思	惟 有 一 条 生 死 路	古 今 来 往 更 何 疑
无 物 - 生 涯 - 坐 久 - 鸡 黍 - 拳 拳==远 来 无 物 示 拳 拳	到 老 生 涯 尚 阙 然	坐 久 但 贪 情 话 好	又 勤 鸡 黍 纲 囊 钱
春 色 - 酒 杯 - 佳 人 - 命 轻 - 春 色==春 色 关 心 万 种 情	酒 杯 聊 寞 可 怜 生	折 花 比 对 佳 人 面	把 臂 相 同 觉 命 轻
济 人 - 青 山 - 到 处 - 岩 头 - 济 人==契 翁 来 作 济 人 舟	两 岩 青 山 浸 碧 流	舞 棹 舷 歌 不 到 处	知 心 惟 有 老 岩 头
空 山 - 甲 乙 - 僧 种 - 茯 苓 - 空 山==空 山 涧 畔 枯 松 树	禅 老 堂 头 甲 乙 身	传 是 昔 朝 僧 种 著	下 头 应 有 茯 苓 神
汉 庭 - 群 飞 - 白 发 - 挂 冠 - 汉 庭==汉 庭 用 少 公 何 在	不 使 群 飞 接 羽 翰	今 代 贵 人 须 白 发	挂 冠 高 处 未 宜 弹
路 长 - 春 风 - 残 云 - 明 入 - 客 路==积 雨 成 湖 客 路 长	春 风 掀 搅 意 何 狂	残 云 吹 尽 真 天 力	乞 我 晴 明 入 帝 乡
云 梦 - 万 叠 - 鱼 龙 - 鸟 雀 - 云 梦==云 梦 悬 知 八 九 吞	银 山 万 叠 涨 天 门	长 江 日 落 鱼 龙 舞	古 寺 烟 深 鸟 雀 喧
云 雨 - 山 中 - 杖 藜 - 有 秋 - 云 雨==十 日 阴 云 雨 未 收	山 中 新 涨 足 溪 流	杖 藜 不 到 闲 亭 上	恐 有 秋 声 在 树 头
碎 身 - 埋 骨 - 霜 露 - 暖 日 - 碎 身==碎 身 鹰 犬 惭 何 忍	埋 骨 诗 书 事 亦 微	霜 露 深 林 可 终 岁	雌 雄 暖 日 莫 忘 机
悬 崖 - 动 地 - 尺 语 - 徘 徊 - 千 古==清 潭 千 古 照 悬 崖	崖 上 飞 流 动 地 来	咫 尺 语 言 闻 不 得	夕 阳 佳 景 更 徘 徊
三 年 - 城 边 - 萧 萧 - 城 头 - 三 年==三 年 身 不 到 姑 苏	见 说 城 边 柳 半 枯	纵 有 萧 萧 几 株 在	也 应 啼 杀 城 头 乌
年 老 - 槐 庭 - 彩 笔 - 画 图 - 老 干==千 年 老 干 对 壶 峰	不 数 槐 庭 两 翠 龙	六 月 薰 风 腾 彩 笔	赤 瑛 苍 璧 画 图 供
人 立 - 青 丝 - 银 瓶 - 桃 花 - 人 立==汲 水 佳 人 立 晓 风	青 丝 辗 尽 辘 轳 空	银 瓶 触 破 残 妆 影	零 乱 桃 花 满 井 红
黄 云 - 垂 老 - 几 许 - 贩 山 - 黄 云==黄 云 百 亩 割 还 空	垂 老 禾 堂 泣 晚 舂	偿 却 公 私 能 几 许	贩 山 烧 炭 过 残 冬
欲 满 - 锦 衣 - 宗 臣 - 白 发 - 渡 口==渡 口 斜 阳 欲 满 旗	锦 衣 容 易 逐 云 衣	圣 朝 无 事 宗 臣 老	白 发 沧 浪 一 舸 归
散 丝 - 花 枝 - 龙 楼 - 词 臣 - 散 丝==浩 荡 东 风 雨 散 丝	暗 移 春 色 上 花 枝	云 阴 半 卷 龙 楼 晚	正 是 词 臣 退 直 时
江 村 - 向 暖 - 何 处 - 寻 香 - 江 村==行 遍 江 村 未 有 梅	一 花 忽 向 暖 枝 开	黄 蜂 何 处 知 消 息	便 解 寻 香 隔 舍 来
玉 露 - 紫 茎 - 秋 月 - 月 下 - 玉 露==玉 露 金 风 喜 乍 凉	紫 茎 绿 叶 荐 秋 芳	今 年 最 好 中 秋 月	更 着 秋 兰 月 下 香
金 缕 - 宫 腰 - 风 急 - 春 寒 - 金 缕==金 缕 新 幡 翠 凤 翘	侧 商 催 酒 转 宫 腰	玉 栏 风 急 花 零 乱	始 觉 春 寒 第 一 朝
秋 风 - 鸣 琴 - 孤 舟 - 长 啸 - 秋 风==秋 风 亭 上 思 悠 哉	想 见 鸣 琴 日 日 来	野 水 孤 舟 故 如 昨	为 公 长 啸 一 徘 徊
水 清 - 穿 溪 - 无 人 - 渡 水 - 树 老==溪 水 清 涟 树 老 苍	行 穿 溪 树 踏 春 阳	溪 深 树 密 无 人 处	唯 有 幽 花 渡 水 香
名 花 - 妙 香 - 素 馨 - 如 霜 - 名 花==名 花 闻 道 出 南 荒	亲 到 南 天 闻 妙 香	弟 是 素 馨 兄 是 菊	澹 烟 如 水 月 如 霜
元 亮 - 白 衣 - 秋 来 - 菊 花 - 陶 元==平 生 膛 酒 陶 元 亮	曾 绕 东 篱 望 白 衣	底 事 秋 来 犹 止 酒	重 阳 须 插 菊 花 归
三 千 - 清 明 - 大 人 - 月 明 - 三 千==普 贤 行 愿 等 三 千	正 是 清 明 首 夏 天	要 是 见 大 人 境 界	月 明 常 照 御 楼 前
天 涯 - 凄 凉 - 立 马 - 一 声 - 天 涯==广 陵 人 去 客 天 涯	旧 馆 凄 凉 闭 落 花	立 马 斜 阳 空 洒 泪	一 声 横 笛 起 邻 家
北 风 - 自 由 - 天 时 - 报 道 - 北 风==南 风 作 雨 北 风 休	岂 是 春 云 得 自 由	只 者 天 时 过 湖 得	长 年 报 道 不 须 愁
红 杏 - 画 出 - 一 行 - 人 愁 - 红 杏==绿 扬 红 杏 闹 墙 头	画 出 眉 山 却 带 秋	一 行 珠 帘 休 卷 上	怕 春 知 道 有 人 愁
画 屏 - 聪 慧 - 竹 韵 - 熏 风 - 画 屏==秀 色 罗 山 列 画 屏	男 生 聪 慧 女 娉 婷	三 苞 竹 韵 琴 堂 化	管 领 熏 风 动 舜 廷
六 龙 - 和 风 - 冉 冉 - 重 重 - 六 龙==八 景 云 舆 驾 六 龙	东 方 常 御 太 和 风	箫 笳 冉 冉 升 黄 道	冠 剑 重 重 拜 木 公
一 水 - 赤 城 - 城 上 - 烧 香 - 一 水==翠 拥 层 崖 一 水 分	括 苍 遥 接 赤 城 春	观 音 城 上 灵 官 庙	多 少 烧 香 行 路 人
空 山 - 绮 色 - 烟 光 - 石 田 - 空 山==空 山 顽 质 世 偏 须	禅 客 元 惭 绮 色 枯	几 吐 烟 光 供 染 翰	石 田 只 字 可 留 无
走 马 - 零 落 - 天 低 - 梨 花 - 走 马==走 马 寻 春 西 复 东	夭 桃 零 落 委 残 红	可 怜 日 暮 天 低 处	但 有 梨 花 弄 晚 风
轻 轻 - 雨 暗 - 渔 翁 - 落 花 - 烟 雾==轻 轻 烟 雾 失 楼 台	雨 暗 吴 山 锁 山 开	试 与 渔 翁 闲 访 问	落 花 几 许 泛 溪 来
今 朝 - 茅 檐 - 养 老 - 楚 俗 - 今 朝==今 朝 溪 女 留 鲜 鲫	洒 扫 茅 檐 旋 置 樽	养 老 不 须 烦 祝 鲠	从 来 楚 俗 惯 鱼 餐
八 尺 - 脱 巾 - 何 处 - 自 凉 - 八 尺==笛 簟 平 铺 八 尺 床	脱 巾 高 卧 对 疏 篁	近 村 得 雨 知 何 处	此 地 无 风 亦 自 凉
山 中 - 不 言 - 尘 飞 - 明 月 - 山 中==山 中 之 乐 何 由 说	知 者 不 言 言 者 拙	红 尘 飞 尽 散 松 风	独 酌 寒 泉 弄 明 月
江 南 - 树 阴 - 然 驴 - 夕 阳 - 江 南==江 南 春 尽 野 花 稀	绿 树 阴 阴 结 夏 帏	诗 在 浩 然 驴 背 上	按 鞭 徐 咏 夕 阳 归
偃 蹇 - 纵 横 - 乐 天 - 无 人 - 偃 蹇==年 华 偃 蹇 留 不 住	鬓 雪 纵 横 耘 更 多	乐 天 不 生 梦 得 死	恨 无 人 续 竹 枝 歌
青 青 - 年 光 - 柳 丝 - 柳 絮 - 杨 柳==杨 柳 青 青 杨 柳 黄	青 黄 变 色 过 年 光	妾 似 柳 丝 易 憔 悴	郎 如 柳 絮 太 颠 狂
憔 悴 - 凋 零 - 篱 落 - 红 红 - 憔 悴==憔 悴 牵 牛 病 雨 些	凋 零 木 槿 怯 风 斜	道 边 篱 落 聊 遮 眼	白 白 红 红 匾 豆 花
古 碑 - 旧 江 - 夜 夜 - 是 曹 - 古 碑==黄 绢 古 碑 千 载 事	汀 花 岸 草 旧 江 村	波 心 夜 夜 见 明 月	疑 是 曹 娥 堕 水 魂
渺 渺 - 乘 风 - 困 模 - 骑 马 - 茫 茫==渺 渺 茫 茫 远 愈 微	乘 风 日 夜 趁 东 归	半 醒 半 困 模 糊 处	一 似 醉 中 骑 马 飞
吹 箫 - 凤 凰 - 明 年 - 织 女 - 吹 箫==帝 子 吹 箫 上 翠 微	秋 风 一 曲 凤 凰 归	明 年 七 月 重 相 见	依 旧 高 悬 织 女 机
万 里 - 断 云 - 秋 风 - 江 南 - 晴 沙==万 里 晴 沙 夕 照 西	此 心 唯 有 断 云 知	年 年 数 尽 秋 风 字	相 风 江 南 摇 落 时
桃 叶 - 东 风 - 南 北 - 肯 过 - 扬 州==扬 州 桃 叶 能 留 客	任 是 东 风 江 上 狂	南 北 人 情 亦 相 似	六 军 不 肯 过 咸 阳
上 日 - 满 树 - 青 云 - 在 天 - 江 上==送 君 江 上 日 西 斜	泣 向 江 边 满 树 花	若 见 青 云 旧 相 识	为 言 流 落 在 天 涯
水 清 - 洛 阳 - 归 去 - 凉 风 - 水 清==秋 在 水 清 山 暮 蝉	洛 阳 树 色 鸣 皋 烟	送 君 归 去 愁 不 尽	又 惜 空 度 凉 风 天
鲜 明 - 菱 花 - 照 影 - 湖 海 - 鲜 明==一 奁 春 锦 斗 鲜 明	较 古 菱 花 越 样 清	照 影 不 应 呼 小 玉	至 今 湖 海 客 关 情
居 官 - 鸟 声 - 园 花 - 青 山 - 居 官==居 家 到 底 胜 居 官	啼 鸟 声 中 昼 掩 关	待 得 小 园 花 落 尽	更 须 移 酒 对 青 山
灯 前 - 枕 上 - 高 情 - 清 秋 - 灯 前==病 多 渐 减 灯 前 课	老 甚 都 忘 枕 上 愁	一 段 高 情 谁 会 得	卧 听 檐 雨 泻 清 秋
归 期 - 春 风 - 芳 菲 - 殷 勤 - 归 期==只 说 归 期 为 底 忙	春 风 九 奏 奉 花 王	芳 菲 莫 管 前 驱 尽	末 后 殷 勤 最 久 长
便 班 - 四 方 - 寒 窗 - 香 细 - 年 把==少 年 把 笔 便 班 扬	咳 唾 珠 玑 落 四 方	岁 晚 寒 窗 浑 忘 却	瓦 炉 香 细 雨 声 长
静 坐 - 茫 茫 - 累 菊 - 新 诗 - 静 坐==静 坐 思 君 秋 日 长	清 波 白 鹭 两 茫 茫	定 应 嚼 遍 湘 累 菊	寄 我 新 诗 字 字 香
病 龙 - 藤 杖 - 天 台 - 一 枝 - 龙 锺==老 病 龙 锺 不 自 持	饱 知 藤 杖 可 扶 衰	明 朝 欲 入 天 台 去	试 就 高 人 乞 一 枝
逆 旅 - 一 醉 - 酒 阑 - 吹 月 - 逆 旅==相 逢 逆 旅 若 为 亲	一 醉 难 酬 一 笑 开	夜 静 酒 阑 清 不 奈	好 风 吹 月 入 樽 来
触 石 - 万 壑 - 一 帆 - 画 船 - 触 石==拍 天 触 石 怒 涛 鸣	悬 瀑 奔 流 万 壑 声	好 借 一 帆 风 信 急	画 船 飞 过 富 阳 城
风 雨 - 岩 下 - 松 筠 - 炊 烟 - 风 雨==岩 巅 风 雨 落 泉 声	岩 下 江 流 见 底 清	夹 岸 松 筠 倒 流 影	炊 烟 渔 父 近 寒 城
紫 鸾 - 一 笑 - 今 夜 - 无 双 - 紫 鸾==侍 儿 扶 上 紫 鸾 车	一 笑 相 逢 萼 绿 华	今 夜 芜 城 好 明 月	无 双 亭 上 看 琼 花
半 生 - 万 里 - 佳 气 - 青 青 - 半 生==半 生 书 剑 孤 心 老	万 里 山 川 两 眼 醒	空 向 西 陵 问 佳 气	舜 田 禹 穴 草 青 青
草 屋 - 前 溪 - 图 画 - 一 醉 - 草 屋==草 屋 柴 门 无 点 尘	门 前 溪 水 绿 粼 粼	中 间 有 甚 堪 图 画	满 坞 桃 花 一 醉 人
鸟 声 - 无 心 - 道 人 - 高 栋 - 鸟 声==偶 被 鸟 声 惊 破 梦	无 心 行 到 黄 龙 洞	道 人 已 击 晚 香 钟	犹 有 残 阳 在 高 栋
云 收 - 树 头 - 断 弦 - 百 年 - 彩 云==沈 郎 院 闭 彩 云 收	寂 寞 秋 花 拆 树 头	留 取 断 弦 来 世 续	此 生 长 抱 百 年 愁
骑 马 - 东 风 - 王 城 - 寒 食 - 骑 马==骑 马 寻 春 春 尚 迟	东 风 空 自 向 人 吹	燕 王 城 里 千 株 柳	寒 食 来 看 未 有 丝
原 富 - 千 古 - 凯 望 - 人 欲 - 原 富==拥 麾 犹 原 富 腰 钱	千 古 相 传 跨 鹤 仙	莫 笑 昔 人 空 凯 望	后 来 人 欲 更 熏 天
桃 李 - 水 隔 - 清 夜 - 露 湿 - 桃 李==一 点 不 杂 桃 李 春	一 水 隔 断 车 马 尘	恨 不 来 为 清 夜 饮	月 中 香 露 湿 乌 巾
风 日 - 高 歌 - 无 佗 - 密 密 - 风 日==云 敛 长 空 风 日 和	太 平 樵 牧 共 高 歌	衲 僧 饭 饱 无 佗 事	密 密 机 前 弄 玉 梭
琥 珀 - 梨 花 - 颗 颗 - 尊 来 - 琥 珀==闻 道 君 家 琥 珀 霞	杭 州 那 更 说 梨 花	樱 桃 颗 颗 堪 持 比	换 取 一 尊 来 水 涯
晴 天 - 红 杏 - 意 懒 - 风 烟 - 放 灯==放 灯 时 节 快 晴 天	红 杏 梢 头 璧 月 圆	物 色 似 嫌 人 意 懒	故 撩 吟 思 着 风 烟
丁 宁 - 红 药 - 相 思 - 春 归 - 丁 宁==莺 语 丁 宁 隔 晓 窗	露 翻 红 药 斗 新 妆	玉 笙 莫 作 相 思 调	犹 恐 春 归 得 见 郎
碧 波 - 云 帆 - 何 处 - 成 行 - 碧 波==青 天 无 尽 碧 波 长	百 尺 云 帆 挂 夕 阳	海 路 音 书 何 处 寄	西 风 吹 雁 不 成 行
西 湖 - 龙 岩 - 诗 家 - 举 棹 - 西 湖==西 湖 浪 宕 我 能 知	却 赋 龙 岩 老 古 锥	便 做 诗 家 元 不 恶	华 亭 举 棹 是 因 谁
未 见 - 叶 底 - 蜂 蝶 - 春 色 - 未 见==雨 来 未 见 花 间 蕊	雨 後 全 无 叶 底 花	蜂 蝶 纷 纷 过 墙 去	却 疑 春 色 在 邻 家
鸾 集 - 玉 堂 - 不 知 - 一 枝 - 鸾 集==振 鹭 翔 鸾 集 禁 闱	玉 堂 珠 树 莹 风 仪	不 知 新 到 灵 和 殿	张 绪 何 如 柳 一 枝
功 名 - 何 为 - 青 子 - 烟 雨 - 功 名==昔 人 行 役 功 名 误	嗟 我 何 为 久 未 回	落 尽 繁 花 有 青 子	期 君 烟 雨 上 池 台
三 台 - 画 鼓 - 列 炬 - 半 空 - 三 台==紫 坛 云 雾 切 三 台	玉 趾 将 临 画 鼓 催	列 炬 照 天 驰 道 远	佩 声 遥 自 半 空 来
天 机 - 览 镜 - 生 春 - 漫 间 - 天 机==天 机 流 转 一 回 头	览 镜 何 须 空 自 羞	雪 尽 草 生 春 意 好	人 心 不 解 漫 间 愁
月 华 - 夜 阑 - 扬 州 - 人 庙 - 一 树==一 树 婆 娑 种 月 华	夜 阑 依 旧 护 风 沙	今 年 不 往 扬 州 过	曾 看 夫 人 庙 里 花
如 神 - 物 外 - 穷 通 - 生 色 - 如 神==眼 如 明 月 口 如 神	闲 里 乾 坤 物 外 身	世 上 穷 通 都 莫 问	粹 然 生 色 几 何 人
江 湖 - 庐 山 - 门 前 - 相 思 - 浩 荡==春 风 浩 荡 江 湖 客	咫 尺 庐 山 风 雨 急	门 前 老 树 最 关 情	一 夜 相 思 头 尽 白
直 渠 - 爬 沙 - 河 面 - 千 里 - 直 渠==直 渠 杀 势 烦 才 吏	机 器 爬 沙 聚 水 兵	河 面 常 从 天 上 落	金 堤 千 里 护 都 城
石 门 - 屐 齿 - 浊 酒 - 日 月 - 石 门==细 数 峰 峦 到 石 门	缓 移 屐 齿 步 云 根	一 樽 浊 酒 林 间 坐	古 木 苍 萝 日 月 昏
融 和 - 谁 家 - 风 急 - 飞 花 - 细 腰==长 日 融 和 舞 细 腰	谁 家 庭 院 不 相 招	江 皋 二 月 斜 风 急	拚 逐 飞 花 过 短 桥
团 栾 - 斋 中 - 红 杏 - 三 年 - 团 栾==酒 边 无 日 不 团 栾	独 冷 斋 中 忆 旧 欢	窗 外 一 株 红 杏 树	三 年 不 得 与 君 看
冥 冥 - 一 灯 - 荷 叶 - 摇 曳 - 冥 冥==苑 墙 曲 曲 柳 冥 冥	人 静 山 空 见 一 灯	荷 叶 似 云 香 不 断	小 船 摇 曳 入 西 陵
秋 晚 - 耿 耿 - 新 月 - 玉 楼 - 条 风==秋 晚 萧 条 风 露 清	星 河 耿 耿 漏 丁 丁	只 应 新 月 频 相 见	长 向 玉 楼 东 畔 生
惊 梦 - 疏 疏 - 春 色 - 诗 酒 - 隐 隐==轻 雷 隐 隐 初 惊 梦	小 雨 疏 疏 巧 润 花	正 是 暄 和 好 春 色	常 将 诗 酒 赏 年 华
不 雨 - 阴 阴 - 炎 气 - 春 风 - 云 浓==蛮 烟 不 雨 似 云 浓	白 日 阴 阴 惨 澹 中	炎 气 薰 人 冬 亦 暖	不 知 何 地 候 春 风
金 波 - 无 尘 - 飞 仙 - 青 绶 - 金 波==月 分 圆 影 委 金 波	峰 面 无 尘 莹 不 磨	应 是 飞 仙 梳 洗 处	碧 台 青 绶 挂 云 萝
青 霄 - 上 方 - 冷 云 - 天 香 - 九 层==九 层 塔 耸 青 霄 外	七 佛 灵 踪 在 上 方	山 冷 云 寒 当 午 夜	唯 闻 仙 乐 散 天 香
洗 钵 - 海 门 - 掉 臂 - 在 烟 - 洗 钵==洗 钵 家 家 事 一 同	新 罗 不 在 海 门 东	因 行 掉 臂 赵 州 老	身 在 烟 萝 第 几 重
溪 山 - 风 月 - 诗 酒 - 红 尘 - 溪 山==拈 弄 溪 山 诗 伎 巧	吐 吞 风 月 酒 神 通	且 将 诗 酒 瞒 人 眼	出 入 红 尘 过 几 冬
三 千 - 春 须 - 草 堂 - 一 钱 - 三 千==三 千 丈 发 从 渠 脱	九 十 日 春 须 我 游	出 欲 草 堂 三 五 里	囊 中 无 得 一 钱 留
登 台 - 胡 床 - 清 凉 - 手 倦 - 登 台==登 台 长 早 下 台 迟	移 遍 胡 床 无 处 移	不 是 清 凉 罢 挥 扇	自 缘 手 倦 歇 些 时
溪 边 - 参 差 - 孤 帆 - 秋 风 - 溪 边==杜 若 溪 边 手 自 移	旋 抽 烟 剑 碧 参 差	何 时 织 得 孤 帆 去	悬 向 秋 风 访 所 思
勒 花 - 浅 红 - 游 人 - 红 雨 - 勒 花==花 神 不 管 勒 花 风	开 尽 深 红 到 浅 红	未 放 游 人 偷 眼 看	已 惊 红 雨 乱 濛 濛
层 峦 - 依 云 - 平 波 - 青 山 - 层 峦==独 下 层 峦 景 物 秋	依 依 云 木 似 相 留	孤 舟 晓 泛 平 波 去	更 为 青 山 一 转 头
一 径 - 松 阴 - 江 亭 - 红 叶 - 一 径==竹 杖 芒 鞋 一 径 深	小 桥 晴 涨 泻 松 阴	隔 江 亭 子 是 何 处	红 叶 白 云 秋 满 林
玉 壶 - 远 空 - 寒 江 - 渔 翁 - 玉 壶==群 山 总 入 玉 壶 中	只 有 沧 波 映 远 空	独 钓 寒 江 晚 来 雪	凭 谁 画 我 作 渔 翁
汗 简 - 烂 柯 - 幽 香 - 作 出 - 汗 简==晓 翻 汗 简 因 遮 眼	午 对 枯 枰 辄 烂 柯	天 遣 幽 香 一 唤 起	醒 然 屯 作 出 瓶 鹅
春 色 - 开 樽 - 青 苔 - 一 片 - 春 色==春 色 将 穷 诗 未 穷	开 樽 姑 为 慰 东 风	偶 然 行 到 青 苔 上	尚 有 残 英 一 片 红
牡 丹 - 灯 火 - 霜 风 - 上 元 - 红 锦==红 锦 芙 蓉 碧 牡 丹	今 番 灯 火 减 前 番	雪 泥 没 滕 霜 风 紧	也 有 游 人 看 上 元
埋 玉 - 冠 谋 - 新 诗 - 可 徒 - 埋 玉==埋 玉 腰 间 觅 性 宗	儒 冠 谋 道 有 谁 同	笔 尖 冻 折 新 诗 就	但 可 徒 收 翰 墨 功
郁 木 - 云 迷 - 风 流 - 草 书 - 头 春==郁 木 坑 头 春 鸟 呼	云 迷 帝 子 在 时 居	风 流 扫 地 无 寻 处	只 有 寒 藤 学 草 书
出 群 - 承 恩 - 年 年 - 落 黄 - 蛾 眉==学 画 蛾 眉 独 出 群	当 时 人 道 便 承 恩	年 年 不 见 君 王 面	花 落 黄 昏 空 掩 门
绿 波 - 沙 上 - 飞 去 - 飞 去 - 绿 波==水 虫 才 出 绿 波 来	细 看 爬 沙 上 石 崖	化 作 蜻 蜓 忽 飞 去	几 时 飞 去 却 飞 回
离 微 - 道 合 - 春 色 - 不 萌 - 透 离==玄 途 不 涉 透 离 微	道 合 平 常 发 上 机	无 影 树 头 春 色 晓	金 鸡 啼 在 不 萌 枝
马 蹄 - 归 来 - 青 楼 - 新 曲 - 马 蹄==春 城 踏 踏 马 蹄 轻	醉 里 归 来 鼓 二 更	月 满 青 楼 人 不 寐	政 将 新 曲 按 银 筝
夏 日 - 池 塘 - 水 精 - 蔷 薇 - 夏 日==绿 树 阴 浓 夏 日 长	楼 台 倒 影 入 池 塘	水 精 帘 动 微 风 起	满 架 蔷 薇 一 院 香
酒 家 - 感 慨 - 人 事 - 一 年 - 酒 家==酒 家 旗 下 分 携 久	山 驿 灯 前 感 慨 频	人 事 已 随 双 鬓 改	柳 条 又 见 一 年 新
车 马 - 掩 扉 - 梅 花 - 带 香 - 车 马==江 郊 车 马 满 斜 辉	争 赴 城 南 未 掩 扉	要 识 梅 花 无 尽 藏	人 人 襟 袖 带 香 归
平 堤 - 有 携 - 何 处 - 如 雪 - 平 堤==乌 塘 渺 渺 绿 平 堤	堤 上 行 人 各 有 携	试 问 春 风 何 处 好	辛 夷 如 雪 柘 冈 西
茅 屋 - 桥 横 - 无 人 - 梅 花 - 谁 家==荒 寒 茅 屋 是 谁 家	独 木 桥 横 小 迳 斜	却 是 无 人 行 到 处	春 风 先 已 到 梅 花
方 丈 - 出 城 - 乌 啼 - 山 月 - 方 丈==方 丈 香 销 客 未 眠	出 城 顿 觉 夜 如 年	乌 啼 霜 落 僧 归 院	云 满 空 山 月 满 天
千 官 - 同 轨 - 一 御 - 丹 凤 - 千 官==文 武 千 官 岁 仗 兵	万 方 同 轨 奏 升 平	上 皇 一 御 含 元 殿	丹 凤 门 开 白 日 明
管 弦 - 赋 诗 - 归 去 - 风 月 - 管 弦==管 弦 韵 胜 堪 娱 客	山 水 音 清 好 赋 诗	底 事 翩 然 欲 归 去	尊 前 风 月 又 相 思
一 点 - 依 水 - 云 飞 - 参 差 - 白 浪==一 点 青 螺 白 浪 中	全 依 水 府 与 天 通	晴 江 万 里 云 飞 尽	鳌 背 参 差 日 气 红
物 古 - 只 恐 - 处 处 - 不 妨 - 古 犹==南 朝 人 物 古 犹 今	只 恐 前 身 是 道 林	处 处 经 行 常 自 适	不 妨 谭 笑 不 妨 吟
五 里 - 松 风 - 斜 阳 - 来 半 - 五 里==五 里 晴 行 信 一 筇	入 松 迎 面 旧 松 风	斜 阳 归 路 樵 渔 笑	翁 自 何 来 半 醉 中
无 人 - 孤 舟 - 鲈 鱼 - 珍 重 - 无 人==人 间 疏 散 更 无 人	浪 兀 孤 舟 酒 兀 身	芦 笋 鲈 鱼 抛 不 得	五 陵 珍 重 五 湖 春
狂 吟 - 一 径 - 花 信 - 东 风 - 渔 歌==渔 歌 听 尽 欲 狂 吟	一 径 人 家 柳 影 深	天 意 似 嫌 花 信 早	东 风 吹 雨 又 成 阴
月 色 - 横 陈 - 得 月 - 觅 句 - 今 夜==今 夜 鲸 川 月 色 明	卧 烟 虹 影 正 横 陈	市 桥 得 月 喧 箫 鼓	堪 羡 溪 桥 觅 句 人
扶 桑 - 铜 瓶 - 人 日 - 上 元 - 扶 桑==扶 桑 初 日 映 帘 升	已 觉 铜 瓶 暖 不 冰	七 种 共 挑 人 日 菜	千 枝 先 剪 上 元 灯
芍 药 - 一 日 - 难 辞 - 山 中 - 芍 药==芍 药 丁 香 手 里 栽	临 行 一 日 绕 千 回	外 人 应 怪 难 辞 别	总 是 山 中 自 取 来
思 归 - 春 深 - 昨 夜 - 满 树 - 思 归==客 情 谁 是 不 思 归	芳 划 春 深 未 有 期	昨 夜 月 明 啼 更 苦	山 花 满 树 落 胭 脂
花 残 - 秋 香 - 伤 心 - 北 岸 - 残 岁==桂 老 花 残 岁 月 催	秋 香 无 复 旧 亭 台	伤 心 乌 鹊 桥 头 水	犹 望 阊 门 北 岸 来
一 曲 - 举 头 - 花 枝 - 风 流 - 一 曲==风 前 一 曲 动 离 愁	那 个 行 人 不 举 头	手 把 花 枝 半 蔗 面	不 令 人 见 转 风 流
顶 偏 - 灵 苗 - 翠 叶 - 春 光 - 顶 偏==妙 峰 孤 顶 偏 肥 腻	天 产 灵 苗 不 触 地	翠 叶 无 风 常 自 摇	清 香 那 逐 春 光 媚
畏 日 - 涧 水 - 来 萧 - 篮 舆 - 畏 日==畏 日 流 金 不 断 声	松 风 涧 水 助 泠 泠	我 来 萧 散 无 余 事	得 倚 篮 舆 细 细 听
明 月 - 月 里 - 道 旁 - 折 桂 - 明 月==水 际 空 明 月 正 圆	人 行 月 里 水 如 天	道 旁 听 得 人 争 指	半 是 当 年 折 桂 仙
啼 鹃 - 南 人 - 衣 冠 - 玉 堂 - 啼 鹃==天 津 桥 上 听 啼 鹃	从 此 南 人 弄 相 权	多 少 衣 冠 落 沙 漠	朱 崖 宜 著 玉 堂 仙
晴 昼 - 乐 事 - 陇 麦 - 吴 蚕 - 晴 昼==暑 雨 初 晴 昼 漏 迟	江 乡 乐 事 有 谁 知	村 村 陇 麦 登 场 後	户 户 吴 蚕 拆 簇 时
高 鸟 - 扰 扰 - 千 年 - 城 郭 - 高 鸟==高 鸟 翩 翩 去 未 穷	行 人 扰 扰 复 西 东	何 须 华 表 千 年 鹤	城 郭 重 来 便 不 同
秋 色 - 岁 寒 - 桃 花 - 避 秦 - 秋 色==秋 色 何 妨 陪 露 菊	岁 寒 真 欲 友 霜 筠	只 应 涧 底 桃 花 笑	苦 爱 微 官 不 避 秦
到 处 - 自 由 - 归 来 - 十 年 - 到 处==一 生 到 处 贾 胡 留	身 属 官 仓 不 自 由	白 首 归 来 更 何 恨	十 年 烂 醉 石 帆 秋
孤 城 - 远 山 - 月 明 - 白 发 - 孤 城==水 绕 孤 城 意 自 由	远 山 无 数 郁 相 缪	月 明 又 作 中 秋 好	白 发 相 望 在 两 州
虚 堂 - 萧 然 - 维 摩 - 却 藜 - 虚 堂==新 辟 虚 堂 痛 扫 除	萧 然 终 日 屏 僮 奴	此 间 恐 是 维 摩 室	除 却 藜 床 一 物 无
高 风 - 花 枝 - 三 株 - 飘 零 - 柳 外==柳 外 高 风 尽 日 吹	春 来 不 省 见 花 枝	汉 傍 野 墅 三 株 杏	记 得 飘 零 似 雪 时
残 日 - 先 生 - 入 夜 - 流 萤 - 日 照==隔 林 残 日 照 孤 亭	玄 晏 先 生 酒 未 醒	入 夜 莫 愁 迷 下 路	昔 人 犹 在 逐 流 萤
漏 声 - 舆 清 - 草 木 - 新 春 - 殿 开==玉 漏 声 残 金 殿 开	乘 舆 清 跸 问 安 来	尽 将 草 木 欣 欣 意	同 与 新 春 人 寿 杯
鸭 新 - 水 暖 - 避 人 - 莫 是 - 鸭 鸭==鸭 鸭 新 晴 出 翠 蒲	春 江 水 暖 互 相 呼	避 人 深 入 苍 烟 去	莫 是 乔 仟 双 履 无
名 园 - 春 风 - 是 天 - 行 乐 - 名 园==绮 罗 丝 竹 沸 名 园	想 见 春 风 玉 树 前	况 是 天 公 饶 一 月	何 妨 行 乐 倍 他 年
歌 声 - 落 花 - 休 恨 - 青 冢 - 舞 影==歌 声 舞 影 散 春 霞	月 殉 香 魂 几 落 花	休 恨 天 家 无 分 到	汉 妃 青 冢 落 胡 沙
浮 云 - 飘 扬 - 多 情 - 东 风 - 浮 云==时 来 便 逐 浮 云 去	一 意 飘 扬 万 种 空	自 是 多 情 轻 薄 态	佳 人 枉 自 怨 东 风
丰 年 - 为 兆 - 芙 蓉 - 玉 山 - 雪 积==丰 年 瑞 雪 积 峰 头	为 兆 磺 溪 岁 有 收	远 望 芙 蓉 无 限 白	教 人 错 认 玉 山 浮
一 片 - 将 疏 - 往 来 - 萧 然 - 一 片==一 片 间 心 只 在 山	故 将 疏 懒 傲 尘 寰	白 云 犹 有 往 来 意	师 独 萧 然 天 壤 间
小 桥 - 桃 花 - 日 长 - 松 风 - 小 桥==清 溪 狭 径 小 桥 东	春 入 桃 花 处 处 同	我 为 日 长 无 一 事	偶 然 来 此 听 松 风
夜 阑 - 何 处 - 浮 云 - 一 树 - 夜 阑==独 听 钟 声 坐 夜 阑	袈 裟 何 处 问 丰 干	浮 云 忽 灭 心 灯 在	一 树 梅 花 月 影 寒
活 计 - 生 涯 - 乐 事 - 一 家 - 活 计==我 向 诗 中 为 活 计	君 於 酒 里 作 生 涯	世 间 乐 事 惟 诗 酒	各 自 风 流 占 一 家
门 前 - 柳 绿 - 飘 荡 - 博 山 - 三 月==宣 阳 门 前 三 月 初	家 家 杨 柳 绿 藏 鸟	欢 似 白 花 飘 荡 去	忍 能 弃 掷 博 山 炉
杏 花 - 寻 芳 - 满 地 - 近 人 - 江 南==江 南 春 暖 杏 花 多	拾 翠 寻 芳 逐 队 过	满 地 绿 阴 铺 径 转	隔 枝 黄 鸟 近 人 歌
摇 落 - 一 点 - 万 物 - 梅 花 - 风 霜==风 霜 摇 落 都 庐 尽	一 点 春 回 造 化 家	万 物 成 终 又 成 始	须 将 艮 体 看 梅 花
白 虎 - 帝 乡 - 太 乙 - 白 苹 - 白 虎==白 虎 明 光 奏 五 侯	帝 乡 寥 隔 在 温 柔	甘 泉 太 乙 重 招 起	聊 答 青 藜 照 白 苹
春 风 - 棠 梨 - 郎 去 - 画 眉 - 春 风==二 月 春 风 澹 荡 时	旅 人 虚 对 海 棠 梨	不 如 寄 与 星 郎 去	想 得 朝 回 正 画 眉
夜 阑 - 声 送 - 风 吹 - 云 外 - 夜 阑==辗 转 无 眠 到 夜 阑	鹊 声 送 喜 近 檐 间	好 风 吹 断 夜 来 雨	晴 日 放 开 云 外 山
瞿 塘 - 江 水 - 明 月 - 游 丝 - 瞿 塘==瞿 塘 嘈 嘈 十 二 滩	绕 船 明 月 江 水 寒	欲 随 郎 船 看 明 月	游 丝 落 絮 春 漫 漫
萧 萧 - 邮 亭 - 凄 凉 - 风 蝉 - 萧 萧==短 鬓 萧 萧 失 旧 青	此 身 已 看 作 邮 亭	新 秋 无 限 凄 凉 意	尽 付 风 蝉 与 露 萤
夜 凉 - 孤 云 - 山 月 - 清 风 - 夜 凉==夜 凉 扶 杖 出 山 斋	身 似 孤 云 倚 石 岸	吟 就 不 知 山 月 晓	清 风 满 面 落 松 钗
悠 悠 - 流 光 - 作 劳 - 紫 芋 - 悠 悠==事 业 悠 悠 雪 满 头	流 光 那 会 与 人 谋	作 劳 输 与 田 间 叟	紫 芋 黄 鸡 满 意 秋
修 干 - 水 滨 - 炎 威 - 如 云 - 鳞 皴==插 天 修 干 已 鳞 皴	谁 挽 青 枝 架 水 滨	却 退 炎 威 凉 满 座	都 缘 清 荫 布 如 云
连 云 - 邯 郸 - 千 载 - 人 争 - 连 云==秦 兵 百 万 气 连 云	屋 瓦 邯 郸 震 欲 焚	千 载 尚 留 城 市 在	土 人 争 说 信 陵 君
可 爱 - 岭 外 - 四 围 - 荔 枝 - 微 凉==微 凉 可 爱 是 薰 风	岭 外 风 行 瘴 雨 中	渴 暑 四 围 如 甑 斧	不 妨 蒸 得 荔 枝 红
一 架 - 胭 脂 - 淡 红 - 清 露 - 一 架==一 架 蔷 薇 四 面 垂	花 工 不 苦 费 胭 脂	淡 红 点 染 轻 随 粉	浥 偏 幽 香 清 露 知
溪 云 - 一 曲 - 桃 花 - 武 陵 - 云 水==一 溪 云 水 一 渔 夫	一 曲 沧 浪 酒 一 壶	笑 指 桃 花 问 春 色	武 陵 得 似 此 间 无
平 平 - 自 清 - 竹 根 - 十 年 - 平 平==布 衣 蔬 食 已 平 平	砌 草 墙 花 也 自 清	醉 抱 竹 根 如 意 卧	十 年 无 有 唾 壶 声
玉 殿 - 月 明 - 三 千 - 丹 砂 - 玉 殿==武 帝 升 遐 玉 殿 空	金 人 夜 泣 月 明 中	三 千 嫔 御 无 行 幸	独 费 丹 砂 饲 守 宫
歌 舞 - 洛 阳 - 龙 骧 - 谁 家 - 歌 舞==歌 舞 从 来 最 得 名	如 今 老 寄 洛 阳 城	当 时 醉 送 龙 骧 曲	留 与 谁 家 唱 月 明
走 狗 - 览 德 - 欲 开 - 蒿 莱 - 斗 鸡==斗 鸡 走 狗 登 皇 极	览 德 毛 从 何 许 来	汉 室 欲 开 新 室 业	王 阳 分 合 守 蒿 莱
拍 肩 - 山 巅 - 千 古 - 高 深 - 拍 肩==隐 士 洪 崖 可 拍 肩	尚 留 陈 迹 此 山 巅	祗 应 千 古 人 如 在	陵 谷 高 深 却 变 迁
芳 心 - 春 色 - 东 君 - 白 头 - 芳 心==欲 诉 芳 心 未 肯 休	不 知 春 色 去 难 留	东 君 亦 是 无 情 物	莫 向 花 间 怨 白 头
步 虚 - 杂 和 - 山 腰 - 野 人 - 步 虚==天 风 稳 送 步 虚 声	杂 和 漫 山 桧 柏 鸣	远 望 山 腰 多 白 石	细 看 知 是 野 人 行
西 山 - 岭 头 - 倾 菱 - 川 流 - 西 山==馆 娃 宫 在 西 山 下	游 鹿 台 居 西 岭 头	倒 翠 尽 倾 菱 镜 里	夕 阳 平 照 满 川 流
南 山 - 机 锋 - 道 人 - 如 自 - 南 山==细 读 南 山 扣 角 歌	机 锋 投 处 几 曾 多	道 人 不 踏 门 前 路	敝 帚 其 如 自 爱 何
烟 云 - 道 前 - 望 城 - 宫 阙 - 出 没==烟 云 出 没 微 微 白	知 道 前 山 雪 出 来	应 在 山 中 望 城 郭	烂 银 宫 阙 是 蓬 莱
虎 踞 - 强 名 - 千 古 - 潮 声 - 龙 蟠==龙 蟠 虎 踞 秣 陵 城	甬 上 苍 官 亦 强 名	独 占 高 峰 傲 千 古	夜 深 月 照 落 潮 声
杨 柳 - 风 吹 - 清 阴 - 蔷 薇 - 杨 柳==杨 柳 藏 鸦 笋 作 竿	晓 风 吹 雨 作 轻 寒	清 阴 一 片 收 春 去	留 得 蔷 薇 数 点 殷
溪 头 - 小 楼 - 无 奈 - 潮 生 - 溪 头==江 家 旧 宅 枕 溪 头	谁 向 溪 湾 著 小 楼	无 奈 当 年 亡 国 恨	潮 生 潮 落 几 时 休
气 寒 - 桃 李 - 朱 雀 - 酒 旗 - 杏 子==杏 子 雨 晴 天 气 寒	追 寻 桃 李 畏 花 残	朱 雀 航 头 南 去 路	酒 旗 悬 处 是 长 干
奇 峰 - 危 阑 - 宿 鸟 - 淡 烟 - 奇 峰==奇 峰 列 列 树 苍 苍	每 爱 危 阑 挹 翠 光	宿 鸟 皈 时 看 最 好	淡 烟 一 抹 锁 斜 阳
朱 甍 - 花 舫 - 第 宅 - 芳 菲 - 碧 瓦==朱 甍 碧 瓦 粉 墙 围	花 舫 回 光 洞 户 辉	自 是 故 家 开 第 宅	乔 林 景 物 两 芳 菲
风 落 - 寂 寥 - 雁 行 - 山 中 - 落 叶==秋 雨 秋 风 落 叶 频	江 湖 谁 念 寂 寥 身	雁 行 自 向 东 南 去	太 白 山 中 有 故 人
不 雨 - 赫 赫 - 游 人 - 梅 花 - 十 月==十 月 园 林 不 雨 霜	朝 曦 赫 赫 似 秋 阳	夜 来 听 得 游 人 语	不 见 梅 花 见 海 棠
霜 操 - 繁 花 - 意 足 - 分 明 - 霜 操==平 生 固 守 冰 霜 操	不 与 繁 花 一 样 情	岁 晏 溪 头 春 意 足	是 谁 看 得 最 分 明
连 宵 - 晓 来 - 闲 云 - 万 里 - 连 宵==积 雨 连 宵 气 象 清	晓 来 日 色 顿 分 明	更 无 一 片 闲 云 采	万 里 青 天 万 里 晴
连 云 - 山 河 - 枕 簟 - 去 国 - 连 云==锦 树 连 云 烂 不 收	山 河 风 景 一 番 秋	老 夫 枕 簟 便 凉 夜	不 比 新 亭 去 国 愁
万 户 - 骑 牛 - 马 上 - 自 由 - 万 户==我 是 山 中 万 户 侯	明 知 骑 马 胜 骑 牛	晚 来 马 上 看 山 色	不 似 骑 牛 得 自 由
缥 缈 - 吹 箫 - 不 知 - 霜 花 - 缥 缈==五 云 缥 缈 隔 蓬 莱	仙 子 吹 箫 月 下 回	转 首 不 知 春 几 许	霜 花 如 雪 满 瑶 台
西 湖 - 横 斜 - 一 片 - 清 香 - 西 湖==常 忆 西 湖 处 士 家	疏 枝 冷 蕊 自 横 斜	精 明 一 片 当 时 事	只 欠 清 香 不 欠 华
南 来 - 避 人 - 莺 莺 - 立 春 - 南 来==流 落 南 来 自 可 嗟	避 人 不 敢 御 铅 华	却 怜 当 日 莺 莺 事	独 立 春 风 露 鬓 斜
三 月 - 寂 寞 - 五 色 - 千 丝 - 三 月==落 花 三 月 葬 西 施	寂 寞 城 隅 范 蠡 祠	水 底 尽 传 螺 五 色	湖 边 空 挂 网 千 丝
大 明 - 新 开 - 四 五 - 此 时 - 大 明==水 味 甘 於 大 明 并	鱼 肥 恰 似 新 开 湖	十 四 五 年 劳 梦 寐	此 时 才 得 少 踟 蹰
名 花 - 春 风 - 倚 栏 - 珊 瑚 - 名 花==不 是 名 花 作 意 红	老 来 颜 色 傲 春 风	几 回 侧 倚 栏 杆 立	错 认 珊 瑚 出 汉 宫
肠 断 - 离 披 - 秀 枯 - 胜 初 - 肠 断==肠 断 黄 花 霜 後 枝	花 乾 叶 悴 两 离 披	一 花 忽 秀 枯 丛 里	更 胜 初 开 乍 见 时
春 日 - 到 处 - 两 朵 - 残 影 - 春 日==半 春 日 日 雨 兼 风	野 杏 官 桃 到 处 空	此 树 偶 留 三 两 朵	依 依 残 影 夕 阳 中
年 年 - 寒 生 - 昨 夜 - 移 时 - 年 年==年 年 心 与 雪 霜 期	一 点 寒 生 古 树 枝	昨 夜 故 休 相 问 信	隔 窗 无 月 坐 移 时
骚 人 - 年 丰 - 仝 茗 - 两 腋 - 骚 人==不 是 骚 人 不 是 农	笔 耕 墨 耒 原 年 丰	有 时 啜 罢 卢 仝 茗	羽 羽 能 生 两 腋 风
清 水 - 杖 头 - 黄 菊 - 篱 边 - 清 水==山 下 江 清 水 见 沙	杖 头 沽 醉 酒 旗 家	多 情 黄 菊 知 人 意	故 放 篱 边 三 四 花
芭 蕉 - 随 日 - 无 生 - 今 朝 - 芭 蕉==芭 蕉 无 耳 闻 雷 开	葵 华 无 眼 随 日 转	释 迦 老 子 亦 无 生	每 岁 今 朝 浴 一 遍
茅 檐 - 秋 雨 - 败 荷 - 渔 舟 - 茅 檐==池 上 茅 檐 覆 水 低	早 来 秋 雨 尚 虹 霓	败 荷 折 苇 飞 鸿 下	正 忆 渔 舟 泊 故 溪
寒 鸦 - 茅 舍 - 小 桥 - 平 芜 - 寒 鸦==喜 鹊 寒 鸦 噪 晚 田	山 前 茅 舍 起 炊 烟	小 桥 败 叶 风 频 扫	斜 月 平 芜 犊 自 眠
看 山 - 扁 舟 - 城 郭 - 我 闲 - 看 山==且 欲 相 邀 卧 看 山	扁 舟 自 可 送 君 还	留 连 城 郭 今 如 此	知 复 何 时 伴 我 闲
眠 风 - 水 云 - 枕 上 - 树 头 - 不 眠==坏 屋 不 眠 风 雨 夜	故 园 无 信 水 云 秋	病 中 枕 上 谁 相 问	一 一 蝉 声 槐 树 头
春 柳 - 闭 户 - 寒 食 - 风 雨 - 春 柳==街 头 春 柳 弄 疏 柔	闭 户 何 曾 一 醉 谋	只 道 将 家 对 寒 食	三 千 风 雨 隔 松 楸
山 行 - 一 杯 - 不 须 - 醉 醒 - 山 行==山 行 颇 觉 兴 悠 哉	到 此 何 妨 饮 一 杯	烂 醉 不 须 愁 世 事	明 朝 醉 醒 又 愁 来
天 光 - 归 来 - 一 棹 - 荷 风 - 天 光==波 光 万 顷 接 天 光	画 舫 归 来 载 夕 阳	一 棹 湖 心 天 不 暑	万 荷 风 裹 满 身 香
山 行 - 眼 界 - 衲 衣 - 云 峰 - 山 行==山 行 百 折 路 重 重	到 顶 回 头 眼 界 空	但 觉 衲 衣 冰 样 冷	不 知 身 在 现 云 峰
登 山 - 班 荆 - 便 取 - 夜 半 - 登 山==命 友 登 山 共 寄 情	亦 逢 佳 处 便 班 荆	有 时 便 取 琴 双 锁	写 出 苍 髯 夜 半 声
妙 用 - 阴 阳 - 阴 阳 - 有 无 - 阴 阳==阴 阳 妙 用 表 三 才	却 问 阴 阳 底 许 来	若 识 阴 阳 由 动 静	何 人 更 作 有 无 猜
渺 渺 - 沾 衣 - 千 条 - 客 归 - 渺 渺==渺 渺 春 江 空 落 晖	行 人 相 顾 欲 沾 衣	楚 王 宫 外 千 条 柳	不 遣 飞 花 送 客 归
萧 萧 - 似 前 - 云 林 - 一 幅 - 萧 萧==行 李 萧 萧 担 一 肩	有 人 踪 迹 似 前 贤	倩 渠 摹 得 云 林 笔	一 幅 溪 藤 淡 墨 传
随 行 - 尽 朝 - 渺 渺 - 林 深 - 随 行==随 行 茶 灶 曾 同 宿	看 尽 朝 岚 与 夕 霏	一 片 诗 愁 夜 渺 渺	树 林 深 处 见 僧 归
黄 金 - 歌 舞 - 蔓 草 - 寒 烟 - 黄 金==黄 金 不 惜 教 婵 娟	歌 舞 于 今 乐 少 年	月 榭 风 台 生 蔓 草	钿 筝 锦 瑟 化 寒 烟
绿 阴 - 红 蕖 - 画 桥 - 景 淡 - 荷 盖==一 池 荷 盖 绿 阴 凉	数 朵 红 蕖 浥 露 香	最 是 画 桥 林 薄 外	满 湖 烟 景 淡 斜 阳
树 影 - 花 间 - 春 光 - 怜 只 - 婆 娑==宝 林 双 树 影 婆 娑	普 照 花 间 系 玉 珂	如 此 春 光 独 憔 悴	可 怜 只 是 恨 人 多
夏 云 - 款 段 - 出 谷 - 今 朝 - 如 火==夏 云 如 火 铄 晨 辉	款 段 羸 车 整 素 衣	知 尔 业 成 还 出 谷	今 朝 莫 怆 断 行 飞
金 马 - 埋 玉 - 父 老 - 上 书 - 气 象==气 象 重 归 金 马 地	更 看 埋 玉 乱 松 楠	他 年 父 老 还 能 说	道 上 书 生 为 指 南
烟 低 - 处 处 - 梅 花 - 一 朵 - 软 草==雨 膏 风 软 草 烟 低	处 处 春 来 处 处 知	尤 喜 梅 花 未 轻 褪	枝 头 一 朵 尚 凝 脂
漫 漫 - 钓 竿 - 桥 畔 - 飞 去 - 风 冷==阑 干 风 冷 雪 漫 漫	惆 怅 无 人 把 钓 竿	时 有 官 船 桥 畔 过	白 鸥 飞 去 落 前 滩
低 小 - 春 来 - 春 酒 - 晴 色 - 低 小==溪 上 草 亭 绝 低 小	春 来 有 客 日 相 过	便 须 对 柳 开 春 酒	坐 看 晴 色 上 新 鹅
簇 簇 - 栽 培 - 花 心 - 净 士 - 簇 簇==簇 簇 青 莲 满 意 开	老 僧 夸 说 旧 栽 培	尘 埃 不 涅 花 心 性	净 客 原 从 净 士 来
水 蓬 - 红 笺 - 清 宵 - 纱 窗 - 蓬 山==弱 水 蓬 山 梦 不 分	红 笺 无 处 寄 行 云	海 棠 睡 醒 清 宵 月	影 入 纱 窗 疑 是 君
鹏 程 - 三 千 - 难 老 - 仙 风 - 鹏 程==鹏 程 九 万 翼 方 展	桃 实 三 千 花 正 开	再 拜 愿 伸 难 老 颂	仙 风 定 合 继 蓬 莱
蓬 壶 - 流 水 - 南 北 - 风 光 - 蓬 壶==蓬 壶 咫 尺 隔 尘 氛	流 水 桃 源 上 下 村	游 遍 东 西 南 北 洞	风 光 别 是 一 乾 坤
天 白 - 萧 萧 - 水 落 - 声 清 - 白 日==青 天 白 日 十 分 晴	轿 上 萧 萧 忽 雨 声	却 是 松 梢 霜 水 落	雨 声 那 得 此 声 清
绿 阴 - 桥 边 - 归 路 - 泉 声 - 猿 啼==绿 阴 清 画 白 猿 啼	三 峡 桥 边 路 欲 迷	赖 得 泉 声 引 归 路	泉 声 鸣 咽 路 高 低
一 人 - 来 来 - 高 下 - 亦 沾 - 一 人==一 人 不 杀 谢 乾 坤	万 里 来 来 谒 帝 阍	高 下 受 官 随 品 从	九 流 艺 术 亦 沾 恩
梅 溪 - 千 峰 - 谓 业 - 耙 与 - 梅 溪==鼻 绳 拽 脱 上 梅 溪	横 卧 千 峰 适 所 宜	岂 谓 业 级 逃 不 得	依 前 拽 耙 与 牵 梨
谁 家 - 微 微 - 月 中 - 经 年 - 谁 家==砧 杵 谁 家 夜 捣 衣	金 风 淅 淅 露 微 微	月 中 独 坐 不 成 寐	旧 业 经 年 未 得 归
奕 叶 - 秋 光 - 翅 绣 - 难 成 - 奕 叶==猗 兰 奕 叶 晓 疏 晴	栩 栩 秋 光 小 蝶 轻	皂 翅 绣 花 三 五 点	庾 郎 无 句 画 难 成
乔 木 - 门 前 - 白 头 - 年 年 - 乔 木==马 家 宅 畔 无 乔 木	徐 氏 门 前 芳 草 多	留 得 白 头 渔 父 在	年 年 长 笛 送 沧 波
放 翁 - 看 山 - 摇 落 - 衰 鬓 - 放 翁==放 翁 病 起 不 禁 愁	买 酒 看 山 自 献 酬	八 月 吴 中 未 摇 落	谁 令 衰 鬓 早 知 秋
妙 相 - 黄 泉 - 红 颜 - 焚 香 - 妙 相==竟 日 冥 思 绝 妙 相	碧 落 黄 泉 两 茫 茫	奈 何 红 颜 一 时 现	不 需 枯 坐 与 焚 香
色 鲜 - 山 家 - 道 人 - 鬓 仙 - 色 鲜==五 股 钗 松 黛 色 鲜	山 家 插 鬓 不 成 妍	道 人 见 了 都 无 用	付 与 云 鬟 雾 鬓 仙
家 住 - 江 山 - 堂 前 - 画 图 - 家 住==我 生 家 住 浙 江 西	不 见 江 山 自 是 痴	浮 远 堂 前 今 日 望	画 图 待 我 看 潮 时
柳 絮 - 暮 烟 - 分 明 - 青 楼 - 柳 絮==柳 絮 春 泥 玉 垒 封	珠 帘 深 锁 暮 烟 浓	分 明 记 得 双 栖 处	梦 绕 青 楼 十 二 重
道 人 - 觌 面 - 神 仙 - 归 来 - 道 人==道 人 只 具 一 只 眼	觌 面 全 提 格 外 机	尘 里 神 仙 谁 做 得	归 来 试 举 问 麻 衣
群 鸥 - 终 朝 - 柳 岸 - 春 日 - 群 鸥==门 外 群 鸥 我 所 知	终 朝 相 见 不 相 离	借 尔 桥 东 杨 柳 岸	明 年 春 日 更 添 儿
松 柏 - 上 生 - 古 木 - 牛 羊 - 松 柏==越 井 岗 头 松 柏 老	越 王 台 上 生 秋 草	古 木 多 年 无 子 孙	牛 羊 践 踏 成 官 道
晓 色 - 迢 递 - 簇 簇 - 亭 亭 - 晓 色==阊 阖 六 开 晓 色 回	禁 涂 迢 递 接 银 台	华 簪 簇 簇 呼 班 后	黄 伞 亭 亭 过 蓼 来
雨 意 - 踏 歌 - 丰 愿 - 高 眠 - 雨 意==尽 道 今 年 雨 意 稠	踏 歌 芒 时 偏 东 畴	微 官 祗 有 半 丰 愿	一 饱 高 眠 万 事 休
柔 条 - 采 莲 - 小 艇 - 柳 叶 - 柔 条==拾 得 柔 条 弄 浅 波	清 风 吹 断 采 莲 歌	又 移 小 艇 前 汀 去	莲 叶 稠 时 柳 叶 多
乡 人 - 年 丰 - 今 至 - 青 青 - 得 乡==闻 得 乡 人 说 刺 桐	花 如 后 发 始 年 丰	我 今 至 此 忧 民 切	只 爱 青 青 不 爱 红
俯 仰 - 升 堂 - 请 祷 - 上 下 - 无 欺==子 心 俯 仰 一 无 欺	由 也 升 堂 尚 不 知	疾 病 如 何 犹 请 祷	孰 分 上 下 与 神 只
轻 风 - 满 庭 - 载 酒 - 新 诗 - 轻 风==一 霎 轻 风 过 雨 稀	满 庭 春 色 碎 珠 玑	使 君 载 酒 花 前 醉	更 有 新 诗 为 发 挥
晴 朝 - 虚 空 - 无 心 - 白 云 - 晴 朝==阴 晴 朝 暮 几 回 新	已 向 虚 空 付 此 身	出 本 无 心 归 亦 好	白 云 还 似 望 云 人
孤 舟 - 云 山 - 柴 门 - 黄 叶 - 天 涯==孤 舟 相 访 至 天 涯	万 转 云 山 路 更 赊	欲 扫 柴 门 迎 远 客	青 苔 黄 叶 满 贫 家
翠 袖 - 一 枝 - 十 年 - 婵 娟 - 翠 袖==翠 袖 无 香 镜 有 尘	一 枝 花 瘦 不 藏 春	十 年 不 识 君 王 面	始 信 婵 娟 解 误 人
道 人 - 东 郭 - 看 山 - 泉 声 - 道 人==溪 上 道 人 幽 思 长	堂 开 东 郭 引 青 阳	日 斜 开 户 看 山 色	十 里 泉 声 半 在 床
银 塘 - 双 飞 - 采 莲 - 垂 杨 - 芙 蓉==芙 蓉 秋 色 满 银 塘	白 鹭 双 飞 下 晚 凉	记 得 采 莲 看 越 女	醉 骑 骄 马 映 垂 杨
父 子 - 青 灯 - 犬 吠 - 月 上 - 父 子==夜 窗 父 子 共 煎 茶	一 点 青 灯 冷 结 花	村 落 盗 清 无 犬 吠	园 林 月 上 有 啼 鸦
露 冕 - 野 人 - 东 风 - 一 树 - 露 冕==露 冕 行 春 向 若 耶	野 人 怀 惠 欲 移 家	东 风 二 月 淮 阴 郡	唯 见 棠 梨 一 树 花
纤 尘 - 云 山 - 一 径 - 竹 床 - 冷 淡==湖 波 冷 淡 绝 纤 尘	满 目 云 山 是 四 邻	一 径 草 深 人 不 到	竹 床 蒲 扇 养 天 真
寒 月 - 忆 林 - 烟 树 - 梅 花 - 夜 深==夜 深 寒 月 照 窗 纱	忽 忆 林 逋 处 士 家	鸥 鹭 正 眠 烟 树 冷	不 知 谁 可 伴 梅 花
不 贷 - 无 穷 - 昂 藏 - 年 年 - 惟 世==所 不 贷 人 惟 世 道	最 无 穷 处 是 天 机	昂 藏 池 上 霜 枫 树	寒 冷 年 年 着 锦 衣
诗 卷 - 灯 残 - 灭 灯 - 风 吹 - 灯 前==把 君 诗 卷 灯 前 读	诗 尽 灯 残 天 未 明	眼 痛 灭 灯 犹 暗 坐	逆 风 吹 浪 打 船 声
行 脚 - 闲 游 - 归 时 - 已 绝 - 行 脚==行 脚 亲 曾 到 地 头	固 知 不 是 等 闲 游	归 时 有 问 五 峰 信	为 报 龙 渊 已 绝 流
招 提 - 酒 旆 - 云 林 - 山 灵 - 招 提==招 提 依 约 在 烟 萝	酒 旆 风 微 拂 钓 蓑	欲 税 云 林 归 卜 隐	山 灵 应 笔 赚 人 多
江 上 - 南 来 - 登 高 - 衡 阳 - 江 上==江 上 青 峰 宿 雨 开	江 头 归 使 日 南 来	登 高 欲 访 平 安 字	二 月 衡 阳 雁 已 回
萦 纡 - 参 差 - 沧 洲 - 山 阴 - 一 水==一 水 萦 纡 荡 夕 霏	樵 风 上 下 燕 参 差	斜 阳 无 限 沧 洲 景	可 惜 山 阴 兴 尽 归
丛 生 - 傅 坟 - 人 世 - 巍 巍 - 丛 生==孙 陵 冈 上 丛 生 草	太 傅 坟 前 没 字 碑	人 世 百 年 元 有 限	何 须 功 业 更 巍 巍
梅 花 - 瑶 林 - 横 枝 - 小 山 - 梅 花==每 至 梅 花 辄 解 颜	瑶 林 孤 绝 迥 难 攀	拟 将 和 靖 横 枝 句	搂 入 离 骚 大 小 山
琼 树 - 长 春 - 云 间 - 日 新 - 琼 树==种 玉 栽 琼 树 树 匀	主 人 心 地 况 长 春	便 教 不 假 云 间 路	亦 有 芳 菲 日 日 新
千 里 - 更 倾 - 无 心 - 一 粒 - 神 京==觅 官 千 里 赴 神 京	钟 老 相 传 盖 更 倾	未 必 无 心 唐 事 业	金 丹 一 粒 误 先 生
万 重 - 繁 华 - 归 去 - 他 人 - 万 重==岷 峨 路 远 万 重 云	锦 水 繁 华 一 聚 尘	帝 子 但 知 归 去 好	故 家 城 阙 已 他 人
少 女 - 断 肠 - 舞 袖 - 秋 霜 - 少 女==长 安 少 女 踏 春 阳	何 处 春 阳 不 断 肠	舞 袖 弓 弯 浑 忘 却	罗 衣 空 换 九 秋 霜
丹 书 - 神 清 - 烟 霞 - 鸾 鹤 - 万 仞==四 字 丹 书 万 仞 崖	神 清 之 洞 锁 楼 台	烟 霞 极 目 无 人 到	鸾 鹤 今 应 待 我 来
芙 蓉 - 落 日 - 深 夜 - 十 分 - 芙 蓉==芙 蓉 未 拆 桂 香 浮	落 日 西 风 雁 过 楼	一 雨 空 阶 深 夜 滴	十 分 秋 是 十 分 愁
招 提 - 云 天 - 山 林 - 新 诗 - 招 提==扶 藤 来 访 古 招 提	月 壑 云 天 分 外 奇	料 得 山 林 暗 相 贺	苍 崖 今 日 有 新 诗
月 窟 - 无 人 - 桂 开 - 载 酒 - 年 年==长 恨 年 年 月 窟 秋	无 人 共 拍 酒 船 浮	君 家 双 桂 开 时 节	我 欲 从 君 载 酒 游
云 低 - 照 眼 - 冷 落 - 千 里 - 冷 云==东 城 十 时 冷 云 低	照 眼 传 香 总 是 梅	冷 落 京 尘 谁 晤 语	关 河 千 里 独 裴 回
高 挂 - 安 贫 - 门 前 - 功 成 - 高 挂==高 挂 尘 冠 静 拂 衣	安 贫 知 退 似 君 稀	门 前 便 是 东 山 路	谁 肯 功 成 名 遂 归
梦 中 - 可 寄 - 晓 月 - 数 片 - 梦 中==风 泉 只 向 梦 中 闻	身 外 无 馀 可 寄 君	当 户 一 轮 惟 晓 月	挂 檐 数 片 是 秋 云
急 流 - 风 吹 - 黄 云 - 甘 蔗 - 破 腊==破 腊 侵 星 渡 急 流	晓 风 吹 动 黑 貂 裘	黄 云 不 断 碧 云 暗	荔 子 林 边 甘 蔗 洲
青 青 - 银 丝 - 双 蛾 - 肠 断 - 雨 压==桑 子 青 青 雨 压 枝	宫 蚕 老 尽 簇 银 丝	侍 儿 擘 破 双 蛾 茧	肠 断 西 窗 有 所 思
桑 柘 - 鸡 鸣 - 此 时 - 眼 界 - 桑 柘==桑 柘 阴 中 日 日 行	只 闻 犬 吠 与 鸡 鸣	此 时 身 在 烟 云 上	眼 界 不 知 如 许 明
桥 下 - 露 气 - 未 晓 - 花 香 - 桥 下==高 登 桥 下 水 汤 汤	朝 涉 河 边 露 气 凉	行 过 淇 园 天 未 晓	一 痕 残 月 杏 花 香
胡 人 - 海 月 - 落 梅 - 从 风 - 戍 楼==胡 人 吹 笛 戍 楼 间	楼 上 萧 条 海 月 闲	借 问 落 梅 凡 几 曲	从 风 一 夜 满 关 山
春 归 - 春 色 - 洛 阳 - 小 车 - 春 归==去 岁 春 归 留 不 住	今 年 春 色 来 何 处	洛 阳 处 处 是 桃 源	小 车 渐 转 东 街 去
和 风 - 海 角 - 远 近 - 春 容 - 和 风==三 月 和 风 塞 太 空	天 涯 海 角 竞 青 红	不 知 花 卉 何 远 近	六 合 内 外 俱 春 容
结 庐 - 箨 龙 - 孤 高 - 轮 囷 - 结 庐==借 屋 何 如 退 结 庐	箨 龙 环 水 小 方 壶	孤 高 不 贵 封 千 户	独 笑 轮 囷 秩 大 夫
苍 龙 - 凤 衔 - 古 今 - 东 西 - 带 雨==苍 龙 带 雨 离 深 洞	彩 凤 衔 花 入 帝 关	一 句 古 今 无 渗 漏	祖 师 不 在 东 西 山
独 坐 - 历 历 - 变 化 - 重 阳 - 独 坐==小 船 独 坐 看 平 洋	历 历 登 高 旧 事 长	戏 把 此 身 观 变 化	今 年 无 酒 过 重 阳
看 云 - 回 风 - 鼓 吹 - 雨 后 - 看 云==南 窗 高 卧 看 云 生	日 暮 回 风 动 紫 荆	鼓 吹 不 须 过 野 坞	青 蛙 雨 后 自 能 鸣
风 外 - 月 色 - 江 南 - 徘 徊 - 吹 笛==何 人 吹 笛 秋 风 外	北 固 山 前 月 色 寒	亦 有 江 南 未 归 客	徘 徊 终 夜 倚 阑 干
仙 班 - 九 华 - 窈 窕 - 翠 微 - 晓 景==朝 下 仙 班 晓 景 迟	步 摇 香 认 九 华 妃	花 藏 窈 窕 知 金 屋	亭 照 回 波 在 翠 微
金 丸 - 氏 今 - 群 鸣 - 官 何 - 金 丸==燕 池 昔 有 金 丸 戏	蝈 氏 今 无 牡 菊 烟	暗 水 群 鸣 聊 借 问	为 官 何 似 为 私 年
一 株 - 半 卷 - 窗 前 - 碧 纱 - 吐 焰==绿 蜡 一 株 才 吐 焰	红 绡 半 卷 渐 抽 花	窗 前 映 月 人 无 寐	疑 是 银 灯 透 碧 纱
绳 床 - 安 排 - 葛 藤 - 手 椎 - 绳 床==三 绕 绳 床 眼 未 开	起 模 画 样 为 安 排	葛 藤 椿 子 如 成 就	自 有 龙 天 出 手 椎
天 际 - 清 浅 - 独 立 - 数 声 - 遥 山==遥 山 天 际 敛 眉 峰	清 浅 溪 边 淡 粉 容	薄 暮 寺 桥 人 独 立	一 灯 明 灭 数 声 钟
惨 淡 - 自 安 - 篱 落 - 风 吹 - 惨 淡==岁 阴 惨 淡 不 可 出	竹 榻 地 炉 聊 自 安	黄 叶 满 山 篱 落 晚	北 风 吹 雨 湿 荒 寒
虚 空 - 花 影 - 黄 昏 - 珊 瑚 - 虚 空==虚 空 迸 裂 海 乾 枯	人 在 沤 花 影 裹 居	合 眼 黄 昏 开 眼 昼	月 明 何 许 上 珊 瑚
落 霞 - 猿 啼 - 一 叶 - 风 微 - 落 霞==翠 竹 山 茶 映 落 霞	猿 啼 鹊 噪 道 谁 夸	一 叶 坠 时 秋 遍 界	春 风 微 动 一 时 花
水 阁 - 倚 栏 - 山 色 - 诗 思 - 水 阁==三 间 水 阁 傍 溪 湄	曾 倚 栏 干 此 赋 诗	山 色 溪 光 还 似 旧	惜 无 诗 思 似 当 时
寂 寂 - 苍 苔 - 几 片 - 带 花 - 春 风==春 风 寂 寂 夜 寥 寥	一 望 苍 苔 雪 影 遥	何 处 幽 香 飞 几 片	只 宜 月 色 带 花 飘
蟠 山 - 水 气 - 图 画 - 倚 栏 - 蟠 山==万 竹 蟠 山 喉 不 乾	两 龙 潜 水 气 犹 寒	郡 斋 见 说 真 图 画	公 退 何 妨 一 倚 栏
关 情 - 入 夜 - 峰 下 - 断 肠 - 关 情==此 心 未 歇 最 关 情	那 更 猿 声 入 夜 频	从 此 飞 来 峰 下 寺	又 添 多 少 断 肠 人
三 弄 - 一 声 - 明 月 - 归 梦 - 三 弄==没 弦 琴 三 弄 五 弄	无 孔 笛 一 声 两 声	明 月 浮 空 天 似 水	长 安 归 梦 恰 三 更
新 开 - 花 枝 - 花 枝 - 故 人 - 新 开==寄 花 寄 酒 喜 新 开	左 把 花 枝 右 把 杯	欲 问 花 枝 与 杯 酒	故 人 何 得 不 同 来
邻 鸡 - 饮 福 - 治 聋 - 明 年 - 邻 鸡==邻 鸡 未 动 晓 骖 催	又 向 录 台 饮 福 杯	自 笑 治 聋 知 不 足	明 年 强 健 更 重 来
幽 怀 - 一 杯 - 未 吐 - 欢 伯 - 幽 怀==愁 边 无 处 寄 幽 怀	拟 傍 梅 花 把 一 杯	玉 靥 含 香 浑 未 吐	尝 携 欢 伯 为 重 来
云 低 - 千 顷 - 画 船 - 绿 杨 - 云 低==秋 云 低 结 乱 山 愁	千 顷 银 波 疑 不 流	堤 畔 画 船 堤 上 马	绿 杨 风 里 两 悠 悠
倒 影 - 沙 鸥 - 江 南 - 归 来 - 倒 影==松 树 倒 影 半 溪 寒	数 个 沙 鸥 似 水 安	曾 买 江 南 千 本 画	归 来 一 笔 不 中 看
笔 端 - 江 南 - 春 归 - 横 斜 - 笔 端==笔 端 造 化 出 天 巧	写 出 江 南 雪 压 枝	谁 道 春 归 无 觅 处	横 斜 全 似 越 溪 时
溪 山 - 今 古 - 金 丹 - 长 生 - 溪 山==莫 道 溪 山 阅 世 长	溪 山 今 古 几 兴 亡	金 丹 大 药 皆 虚 妄	别 有 长 生 不 死 方
风 骚 - 鸟 外 - 二 门 - 松 下 - 风 骚==人 间 近 遇 风 骚 匠	鸟 外 曾 逢 心 印 师	除 此 二 门 无 别 妙	水 边 松 下 独 寻 思
水 国 - 仙 葩 - 成 如 - 覆 地 - 水 国==水 国 春 阴 护 板 扉	仙 葩 合 与 饲 蚕 肥	茧 成 如 瓮 丝 如 血	不 数 猩 红 覆 地 衣
水 仙 - 团 团 - 故 人 - 前 村 - 水 仙==碧 潭 四 绕 水 仙 坟	老 桂 团 团 荫 绿 尊	拚 与 故 人 偿 一 醉	梅 花 吹 梦 过 前 村
幅 巾 - 无 人 - 晓 风 - 高 荷 - 幅 巾==小 立 层 台 岸 幅 巾	除 莺 作 伴 更 无 人	晓 风 草 草 君 知 麽	不 为 高 荷 惜 水 银
穿 针 - 月 落 - 为 觅 - 支 床 - 穿 针==儿 女 穿 针 夜 向 分	楼 头 月 落 尚 炉 薰	凭 谁 为 觅 机 边 石	留 取 支 床 卧 白 云
佳 人 - 春 风 - 金 玉 - 龙 吟 - 佳 人==更 有 佳 人 在 空 谷	能 唱 春 风 天 上 曲	何 时 得 上 金 玉 堂	一 声 飞 度 龙 吟 竹
紫 府 - 扫 月 - 枝 碧 - 李 子 - 沉 沉==紫 府 沉 沉 掩 夜 关	竹 阴 清 扫 月 中 坛	岁 星 偷 得 桃 枝 碧	董 奉 栽 成 李 子 丹
闭 门 - 头 便 - 知 时 - 夕 阳 - 闭 门==闭 门 入 圃 太 周 遮	一 唤 回 头 便 到 家	良 遂 知 时 人 不 委	海 山 空 映 夕 阳 斜
颖 丛 - 午 阴 - 榆 钱 - 狼 藉 - 颖 丛==叠 颖 丛 条 以 欲 流	午 阴 浓 处 听 鸣 鸠	儿 童 赌 罢 榆 钱 去	狼 藉 春 风 漫 不 收
绕 屋 - 桃 花 - 桃 花 - 幽 事 - 鳞 鳞==溪 水 绕 屋 初 鳞 鳞	溪 边 桃 花 正 迎 人	桃 花 迎 人 可 复 奈	幽 事 如 许 难 具 陈
不 寝 - 五 日 - 相 思 - 望 尽 - 不 寝==他 寝 此 时 吾 不 寝	近 秋 三 五 日 逢 晴	相 思 唯 有 霜 台 月	望 尽 孤 光 见 却 生
天 外 - 明 月 - 春 归 - 南 来 - 天 外==夜 郎 天 外 怨 离 居	明 月 楼 中 音 信 疏	北 雁 春 归 看 欲 尽	南 来 不 得 豫 章 书
迢 迢 - 三 千 - 黄 花 - 猿 声 - 去 路==去 路 迢 迢 入 两 当	三 千 三 百 到 华 阳	黄 花 川 上 黄 花 驿	千 百 猿 声 断 客 肠
花 底 - 长 安 - 文 章 - 不 堪 - 花 底==琼 林 花 底 散 游 鞭	回 首 长 安 十 八 年	羞 把 文 章 对 年 少	老 夫 衣 瓶 不 堪 傅
龙 孙 - 娟 娟 - 疏 影 - 月 庭 - 袅 袅==龙 孙 袅 袅 初 辞 箨	凤 尾 娟 娟 拟 受 风	疏 影 向 人 翩 欲 舞	梦 残 依 约 月 庭 空
买 花 - 在 天 - 歌 舞 - 开 船 - 买 花==客 来 不 惜 买 花 钱	客 醉 青 楼 月 在 天	欲 尽 樽 前 歌 舞 意	湖 头 已 有 早 开 船
松 杉 - 应 是 - 潇 洒 - 昂 藏 - 松 杉==万 万 松 杉 万 竹 枝	人 间 应 是 少 人 知	数 僧 潇 洒 相 逢 处	一 鹤 昂 藏 独 立 时
溪 边 - 桃 花 - 东 君 - 暖 日 - 溪 边==溪 边 嫩 柳 条 条 绿	陌 上 桃 花 树 树 红	勿 谓 东 君 无 管 带	更 加 暖 日 与 和 风
风 吹 - 冷 香 - 纸 帐 - 是 月 - 西 风==西 风 吹 梦 过 钱 塘	独 上 孤 山 叩 冷 香	纸 帐 四 垂 灯 影 薄	觉 来 疑 是 月 错 黄
北 斗 - 春 时 - 留 题 - 士 诗 - 北 斗==北 斗 回 杓 欲 建 寅	宫 嫔 排 备 立 春 时	镌 花 贴 子 留 题 处	只 待 金 銮 学 士 诗
池 通 - 小 拍 - 板 桥 - 上 采 - 通 幽==池 通 幽 涧 碧 如 油	试 水 新 鹅 小 拍 浮	行 过 板 桥 花 片 落	被 风 邀 上 采 菱 舟
数 点 - 浥 露 - 诗 思 - 得 一 - 弄 晴==檐 前 数 点 弄 晴 光	浥 露 庭 花 枕 簟 香	池 草 梦 回 诗 思 杳	吟 窗 分 得 一 边 凉
虚 空 - 薜 萝 - 诗 料 - 皎 皎 - 盘 旋==静 虚 空 阔 深 盘 旋	松 挂 薜 萝 笼 紫 烟	尝 引 我 来 寻 诗 料	和 残 皎 皎 白 驹 篇
日 落 - 金 屋 - 空 庭 - 梨 花 - 黄 昏==纱 窗 日 落 渐 黄 昏	金 屋 无 人 见 泪 痕	寂 寞 空 庭 春 欲 晚	梨 花 满 地 不 开 门
门 前 - 息 授 - 玲 珑 - 走 盘 - 门 前==影 略 门 前 倒 刹 竿	个 中 消 息 授 传 难	玲 珑 侍 者 能 相 委	盘 走 明 珠 珠 走 盘
疗 饥 - 人 胜 - 枝 上 - 不 愁 - 疗 饥==香 馥 清 晨 可 疗 饥	饱 人 胜 食 斋 房 芝	便 好 架 巢 枝 上 宿	不 愁 无 酒 呼 愁 诗
纵 横 - 日 日 - 夜 清 - 爽 气 - 纵 横==纵 横 忧 患 满 人 间	颇 怪 先 生 日 日 闲	昨 夜 清 风 眼 北 牖	朝 来 爽 气 在 西 山
荒 村 - 梦 中 - 早 起 - 烧 香 - 荒 村==清 卧 荒 村 绝 点 尘	疏 钟 敲 月 梦 中 闻	山 僧 早 起 知 何 事	当 户 烧 香 礼 白 云
後 朝 - 秋 清 - 幽 寂 - 柳 外 - 朝 阴==雨 後 朝 阴 到 午 晴	空 斋 孤 坐 纳 秋 清	一 蝉 也 解 怜 幽 寂	柳 外 飞 来 叶 底 鸣
牡 丹 - 四 枝 - 青 眼 - 偷 暇 - 牡 丹==君 家 牡 丹 今 盛 开	二 十 四 枝 为 一 栽	主 人 果 然 青 眼 待	正 忙 亦 须 偷 暇 来
天 孙 - 太 古 - 百 年 - 无 人 - 蚕 茧==天 孙 锦 段 冰 蚕 茧	太 古 盘 铭 苍 颉 文	三 百 年 来 消 息 绝	无 人 为 酬 杜 陵 坟
柴 门 - 天 台 - 莫 是 - 满 袖 - 柴 门==野 老 柴 门 不 惯 开	有 僧 飞 锡 自 天 台	前 身 莫 是 寒 山 子	携 得 清 诗 满 袖 来
玉 墀 - 风 吹 - 神 仙 - 五 色 - 玉 墀==朝 罢 群 仙 退 玉 墀	天 风 吹 绉 六 铢 衣	左 慈 闲 戏 神 仙 术	五 色 霞 杯 绕 洞 飞
矶 边 - 柳 花 - 一 声 - 白 浪 - 矶 边==贡 鹤 矶 边 晚 渡 时	柳 花 风 急 片 帆 飞	一 声 长 笛 鱼 龙 舞	白 浪 中 山 不 肯 归
白 云 - 往 还 - 我 是 - 依 旧 - 白 云==白 云 堆 里 看 青 山	猿 鸟 为 邻 日 往 还	黄 绮 後 身 应 我 是	再 来 依 旧 一 生 闲
老 树 - 茅 亭 - 鹭 鸶 - 飞 去 - 数 株==数 株 老 树 半 无 叶	一 个 茅 亭 终 日 空	惟 有 鹭 鸶 尝 到 此	飞 来 飞 去 送 残 红
纷 纷 - 三 山 - 西 掖 - 丹 陛 - 纷 纷==玉 后 案 吏 去 纷 纷	舟 到 三 山 有 几 人	西 掖 文 章 推 得 步	早 归 丹 陛 演 经 纶
迎 凉 - 诗 思 - 年 光 - 船 恣 - 迎 凉==饯 腊 迎 凉 竟 未 休	无 端 诗 思 动 沧 洲	年 光 付 与 花 光 送	准 拟 觥 船 恣 拍 浮
佳 人 - 生 游 - 柴 东 - 多 情 - 佳 人==曩 译 佳 人 奇 遇 成	每 生 游 想 涉 空 冥	从 今 不 羡 柴 东 海	枉 被 多 情 惹 薄 情
石 头 - 万 里 - 渔 人 - 未 消 - 石 头==石 头 城 下 看 春 潮	天 堑 长 江 万 里 遥	渔 人 网 得 沉 江 锁	犹 似 当 年 铁 未 消
失 意 - 峰 为 - 忘 记 - 轻 生 - 失 意==雁 入 穷 南 失 意 多	以 峰 为 记 誓 毋 过	宁 无 忘 记 蹉 过 去	彼 自 轻 生 独 奈 何
车 马 - 掩 扉 - 梅 花 - 带 香 - 车 马==江 都 车 马 满 斜 晖	争 赴 城 南 未 掩 扉	要 识 梅 花 无 尽 藏	人 人 襟 袖 带 香 归
拜 扫 - 新 开 - 长 路 - 一 杯 - 拜 扫==郭 裹 人 家 拜 扫 回	新 开 醪 酒 荐 青 梅	日 长 路 好 城 门 近	借 我 茅 亭 暖 一 杯
塞 北 - 四 时 - 疆 界 - 万 里 - 塞 北==塞 北 烟 尘 终 载 静	江 南 花 木 四 时 荣	不 须 特 地 分 疆 界	万 里 山 河 似 掌 平
沙 头 - 谁 家 - 知 人 - 残 梦 - 沙 头==沙 头 落 月 照 蓬 低	杜 宇 谁 家 树 底 啼	舟 子 不 知 人 未 起	载 将 残 梦 上 青 溪
归 来 - 清 气 - 双 双 - 个 个 - 归 来==吴 蜀 归 来 兴 寄 遐	天 将 清 气 与 贫 家	双 双 蝶 舞 宜 男 草	个 个 蜂 衔 附 子 花
乔 木 - 枕 上 - 更 重 - 飞 去 - 乔 木==邃 岩 乔 木 夏 藏 寒	床 下 云 溪 枕 上 看	台 殿 渐 多 山 更 重	却 令 飞 去 即 应 难
映 日 - 袅 袅 - 伤 心 - 归 路 - 映 日==映 日 初 花 隔 槛 明	春 风 袅 袅 透 寒 轻	伤 心 怕 听 枝 头 鸟	莫 向 王 孙 归 路 鸣
缕 金 - 春 城 - 冲 风 - 鸿 毛 - 万 缕==万 缕 金 长 暖 絮 萦	雪 乾 云 困 遍 春 城	冲 风 力 尽 飞 应 怯	试 与 鸿 毛 较 重 轻
香 销 - 梦 回 - 轻 烟 - 南 浦 - 香 销==晓 帐 香 销 闲 画 烛	梦 回 山 断 屏 风 曲	轻 烟 细 雨 客 情 多	南 浦 草 随 新 涨 绿
万 叠 - 处 处 - 送 月 - 两 腋 - 雨 晴==万 叠 春 山 积 雨 晴	新 茶 处 处 煮 车 声	不 应 独 送 月 团 片	偏 与 卢 仝 两 腋 生
梅 子 - 芭 蕉 - 日 长 - 柳 花 - 梅 子==梅 子 留 酸 软 齿 牙	芭 蕉 分 绿 与 窗 纱	日 长 睡 起 无 情 思	闲 看 儿 童 捉 柳 花
氤 氲 - 空 自 - 苍 烟 - 数 声 - 氤 氲==雨 声 欲 断 气 氤 氲	小 阁 浮 空 自 吐 吞	古 木 苍 烟 何 处 寺	数 声 青 板 报 黄 昏
横 槊 - 年 年 - 三 略 - 青 旗 - 横 槊==横 槊 不 为 万 骑 先	传 杯 把 笔 过 年 年	怀 中 黄 石 闲 三 略	道 上 青 旗 漫 百 篇
半 黄 - 柳 照 - 风 光 - 雁 来 - 城 外==城 外 秋 荷 一 半 黄	尚 余 疏 柳 照 回 塘	江 南 底 许 风 光 好	塞 雁 来 时 未 有 霜
叠 叠 - 霏 霏 - 必 便 - 诗 人 - 叠 叠==川 云 叠 叠 密 如 鳞	山 雨 霏 霏 细 似 尘	未 必 便 为 耕 陇 喜	天 公 分 付 与 诗 人
安 年 - 牡 丹 - 露 冷 - 月 中 - 春 残==长 安 年 少 惜 春 残	争 认 慈 恩 紫 牡 丹	别 有 玉 盘 乘 露 冷	无 人 起 就 月 中 看
清 明 - 西 郊 - 桃 李 - 梨 花 - 清 明==梁 州 一 别 几 清 明	常 忆 西 郊 信 马 行	桃 李 成 尘 总 闲 事	梨 花 杨 柳 最 关 情
雉 羹 - 营 营 - 三 山 - 一 日 - 非 啜==尧 寿 元 非 啜 雉 羹	秦 皇 汉 武 却 营 营	有 心 去 采 三 山 药	何 似 归 休 一 日 兵
溪 山 - 一 笑 - 淡 薄 - 风 流 - 溪 山==溪 山 对 雨 起 呼 酒	一 笑 还 披 万 里 图	疏 树 远 山 秋 淡 薄	飘 风 流 水 尽 模 糊
四 海 - 胶 漆 - 红 尘 - 林 间 - 四 海==四 海 萍 逢 两 弟 兄	百 年 胶 漆 几 张 陈	红 尘 陌 上 相 逢 子	华 发 林 间 偶 坐 身
风 雨 - 萧 条 - 三 月 - 随 车 - 风 雨==夜 来 风 雨 掠 余 春	晏 起 萧 条 一 病 身	三 月 长 安 泥 浩 浩	懒 随 车 马 作 游 人
万 叠 - 值 此 - 黄 鹂 - 花 梢 - 万 叠==一 寸 柔 肠 万 叠 萦	那 堪 更 值 此 春 情	黄 鹂 知 我 无 情 绪	飞 过 花 梢 禁 不 声
雨 晴 - 红 叶 - 独 步 - 人 归 - 雨 晴==雨 晴 烟 渚 白 鸥 乱	风 过 霜 林 红 叶 稀	独 步 幽 吟 心 正 苦	却 怜 明 月 照 人 归
带 雪 - 香 气 - 藐 姑 - 风 霜 - 带 雪==嚼 蕊 和 花 带 雪 餐	清 香 气 味 沁 脾 肝	藐 姑 不 食 人 间 火	饱 受 风 霜 炼 玉 颜
随 风 - 斜 阳 - 斜 阳 - 虚 明 - 随 风==莫 要 随 风 上 下 狂	空 将 闲 影 傍 斜 阳	斜 阳 西 去 还 催 去	自 在 虚 明 一 带 窗
西 湖 - 高 阁 - 江 山 - 不 老 - 西 湖==见 说 西 湖 又 一 新	小 楼 高 阁 巧 相 萦	江 山 何 待 人 妆 点	堪 笑 吴 儿 不 老 成
弥 天 - 洋 洋 - 正 气 - 凤 凰 - 弥 天==匝 地 弥 天 日 用 常	寂 然 不 动 已 洋 洋	但 令 正 气 无 参 杂	立 见 岐 山 叫 凤 凰
樵 子 - 山 行 - 无 心 - 归 时 - 樵 子==金 仙 洞 头 樵 子 多	负 薪 出 山 行 且 歌	仙 家 棋 局 无 心 看	只 恐 归 时 烂 斧 柯
落 落 - 风 过 - 睡 思 - 片 时 - 参 天==参 天 落 落 复 青 青	风 过 笙 竽 得 细 听	睡 思 莫 将 茶 料 理	只 须 卧 此 片 时 醒
深 山 - 烟 浓 - 看 花 - 松 门 - 深 山==深 山 别 是 一 乾 坤	春 谷 烟 浓 树 树 昏	正 好 看 花 立 溪 口	雨 来 催 我 进 松 门
怒 震 - 消 魂 - 乘 风 - 潮 生 - 怒 震==蓦 地 波 涛 怒 震 霆	整 冠 危 坐 肯 消 魂	乘 风 更 驾 飞 帆 去	要 看 夜 潮 生 海 门
西 风 - 无 人 - 突 前 - 敲 推 - 黄 叶==西 风 黄 叶 北 门 街	有 句 无 人 为 翦 裁	冲 突 前 驱 公 会 否	要 求 一 语 定 敲 推
东 风 - 浮 云 - 知 人 - 带 烟 - 东 风==思 君 又 是 东 风 起	楼 倚 浮 云 目 千 里	芳 草 不 知 人 断 肠	带 烟 带 雨 连 春 水
世 味 - 惟 诗 - 风 月 - 万 里 - 世 味==世 味 渐 阑 如 嚼 蜡	惟 诗 直 恐 死 方 休	四 时 风 月 元 无 尽	万 里 江 山 更 拟 游
云 峰 - 十 年 - 无 成 - 屠 龙 - 云 峰==乱 云 峰 顶 紫 田 翁	二 十 年 前 辇 寺 逢	怪 我 无 成 头 白 早	千 金 散 尽 学 屠 龙
云 静 - 幽 兰 - 梨 花 - 春 风 - 云 静==云 静 烟 飞 降 蕊 渊	幽 兰 比 格 锦 为 篇	伤 心 赚 梦 梨 花 月	闲 锁 春 风 听 杜 鹃
洛 水 - 碧 山 - 风 细 - 莺 啼 - 洛 水==洛 水 桥 南 学 士 家	青 林 遥 对 碧 山 斜	春 风 细 雨 柴 门 闭	一 树 莺 啼 杏 子 花
垂 柳 - 隔 岸 - 莲 花 - 罗 裙 - 垂 柳==六 桥 垂 柳 两 边 分	日 暮 吴 歌 隔 岸 闻	祇 解 莲 花 如 粉 面	不 知 荷 叶 是 罗 裙
明 月 - 百 里 - 长 夜 - 碧 玉 - 清 风==明 月 清 风 渡 两 桥	相 随 百 里 不 辞 遥	共 怜 话 别 无 长 夜	红 烛 清 樽 碧 玉 箫
金 花 - 两 行 - 冰 肌 - 柳 绿 - 金 花==一 股 金 花 擘 断 钗	两 行 玉 筋 界 香 腮	近 来 自 觉 冰 肌 瘦	柳 绿 春 衫 放 窄 裁
三 月 - 惜 醉 - 花 上 - 人 归 - 溪 头==溪 头 三 月 草 菲 菲	城 畔 春 游 惜 醉 稀	莫 信 杜 鹃 花 上 鸟	人 归 犹 道 不 如 归
天 工 - 游 蜂 - 把 酒 - 闲 客 - 天 工==天 工 剪 刻 为 谁 妍	抱 蕊 游 蜂 自 作 团	把 酒 惜 春 都 是 梦	不 如 闲 客 此 闲 看
无 人 - 终 年 - 日 欣 - 秋 风 - 无 人==苦 无 人 事 扰 闲 居	赢 得 终 年 学 著 书	今 日 欣 然 出 门 去	秋 风 吹 意 满 芙 蕖
清 江 - 雁 声 - 车 已 - 客 愁 - 清 江==驿 外 清 江 十 里 秋	雁 声 初 到 荻 花 洲	征 车 已 驾 晨 窗 白	残 烛 依 然 伴 客 愁
参 差 - 铺 锦 - 薰 风 - 夜 雨 - 参 差==高 擎 万 柄 绿 参 差	匹 练 横 铺 锦 一 机	喜 对 薰 风 描 写 得	秋 风 夜 雨 不 敢 知
花 雨 - 倚 阑 - 江 月 - 清 凉 - 风 花==絮 风 花 雨 一 春 残	未 厌 兹 亭 夜 倚 阑	隐 隐 三 山 抱 江 月	清 凉 境 界 露 松 寒
雨 过 - 流 水 - 一 石 - 夕 阳 - 六 月==雨 过 山 村 六 月 凉	田 田 流 水 稻 花 香	松 边 一 石 平 如 榻	坐 听 风 蝉 送 夕 阳
日 晶 - 将 归 - 黄 花 - 拂 衣 - 霜 日==霜 日 晶 荧 水 尚 肥	顺 风 一 舸 送 将 归	黄 花 笑 我 犹 寄 俗	得 似 渊 明 勇 拂 衣
凄 凉 - 荷 叶 - 正 愁 - 人 烟 - 客 路==凄 凉 客 路 趁 长 川	荷 叶 无 衣 柳 不 绵	日 暮 正 愁 无 宿 处	乱 鸦 飞 下 有 人 烟
江 上 - 水 边 - 遗 音 - 幽 咽 - 江 上==浔 阳 江 上 谱 无 传	化 作 沙 汀 越 水 边	一 段 遗 音 人 不 识	夜 深 幽 咽 下 滩 泉
朝 云 - 万 木 - 造 化 - 芳 菲 - 蔼 蔼==朝 云 蔼 蔼 弄 春 晖	万 木 欣 欣 暖 尚 微	造 化 未 尝 私 一 物	各 随 妍 丑 自 芳 菲
杨 柳 - 客 舍 - 春 来 - 杏 花 - 一 丝==愁 兼 杨 柳 一 丝 丝	客 舍 江 南 暮 雨 时	自 入 春 来 才 思 减	杏 花 开 过 不 题 诗
江 南 - 诗 句 - 今 宵 - 烟 雨 - 江 南==闽 越 江 南 此 地 分	鲍 娘 诗 句 尚 能 存	客 怀 未 觉 今 宵 好	家 住 壶 山 烟 雨 村
文 彩 - 吴 山 - 行 色 - 石 桥 - 文 彩==文 彩 全 彰 拄 杖 头	吴 山 楚 水 兴 悠 悠	江 声 一 夜 催 行 色	踏 断 石 桥 方 始 休
人 情 - 波 浪 - 山 川 - 泉 无 - 可 畏==可 畏 人 情 与 世 途	险 如 波 浪 起 江 湖	岂 知 荆 楚 山 川 地	坎 井 泓 泉 无 处 无
枫 叶 - 冷 淡 - 繁 华 - 秋 来 - 枫 叶==枫 叶 飘 林 竹 隔 墙	偏 于 冷 淡 逞 浓 妆	天 教 不 趁 繁 华 月	要 是 秋 来 独 耐 霜
玉 山 - 梨 花 - 仙 袂 - 淡 香 - 野 亭==玉 山 佳 处 野 亭 分	千 树 梨 花 白 似 云	仙 袂 倚 风 林 下 得	淡 香 和 月 夜 深 闻
清 风 - 秋 色 - 修 心 - 千 般 - 清 风==明 月 清 风 宗 炳 社	夕 阳 秋 色 庾 公 楼	修 心 未 到 无 心 地	万 种 千 般 逐 水 流
归 期 - 万 里 - 门 前 - 枝 叶 - 归 期==行 人 犹 未 有 归 期	万 里 初 程 日 暮 时	唯 爱 门 前 双 柳 树	枝 枝 叶 叶 不 相 离
枫 丹 - 约 住 - 沙 鸥 - 飞 去 - 枫 丹==万 松 不 掩 一 枫 丹	烟 怕 山 狂 约 住 山	却 被 沙 鸥 恼 人 损	作 行 飞 去 略 无 还
风 急 - 新 竹 - 卷 残 - 荼 蘼 - 风 急==飘 风 急 雨 燕 初 泥	新 竹 成 阴 小 阁 西	数 卷 残 书 香 篆 息	园 花 落 尽 到 荼 蘼
碧 瓦 - 声 高 - 肠 断 - 残 月 - 碧 瓦==檐 欹 碧 瓦 拂 倾 梧	玉 井 声 高 转 辘 轳	肠 断 西 楼 惊 稳 梦	半 留 残 月 照 啼 乌
古 木 - 书 空 - 浅 深 - 无 人 - 江 亭==古 木 江 亭 懒 不 开	书 空 自 笑 兴 悠 哉	苍 台 一 径 浅 深 遍	知 道 无 人 向 此 来
杨 柳 - 探 春 - 晓 来 - 枝 头 - 杨 柳==杨 柳 宫 前 忽 地 春	在 先 惊 动 探 春 人	晓 来 唯 欠 骊 山 雨	洗 却 枝 头 绿 上 尘
落 叶 - 有 秋 - 年 年 - 新 绿 - 疏 疏==落 叶 疏 疏 似 雨 鸣	莫 疑 春 晚 有 秋 声	抽 条 易 叶 年 年 事	看 取 一 翻 新 绿 成
彩 凤 - 萧 条 - 冶 生 - 花 开 - 彩 凤==彩 凤 连 翩 小 作 群	萧 条 门 巷 独 留 春	莫 因 繁 冶 生 轻 鄙	岁 岁 花 开 见 主 人
白 马 - 东 城 - 金 丸 - 春 深 - 雕 鞍==白 马 雕 鞍 艳 绮 罗	东 城 南 陌 遍 经 过	金 丸 且 莫 轻 抛 掷	绿 树 春 深 乳 雀 多
拒 霜 - 花 开 - 疑 是 - 西 风 - 一 树==拒 霜 一 树 碧 丛 丛	两 色 花 开 迥 不 同	疑 是 酒 边 西 子 在	半 醒 半 醉 立 西 风
缥 缈 - 仙 仗 - 草 忽 - 昭 仪 - 缥 缈==卿 云 缥 缈 覆 长 安	仙 仗 凌 霄 颂 百 官	芝 草 忽 生 涵 德 殿	昭 仪 捧 出 侍 臣 看
扁 舟 - 似 画 - 倚 楼 - 丹 青 - 扁 舟==扁 舟 江 上 几 曾 经	山 崦 层 楼 似 画 屏	岂 料 今 为 倚 楼 客	谁 能 添 我 入 丹 青
西 风 - 瘦 马 - 动 地 - 杀 故 - 黄 叶==西 风 黄 叶 满 江 村	瘦 马 来 穿 渡 口 云	动 地 传 呼 逢 醉 尉	谁 何 禁 杀 故 将 军
飞 花 - 宫 殿 - 百 年 - 舞 衣 - 飞 花==人 似 飞 花 去 不 归	兰 昌 宫 殿 几 斜 晖	百 年 只 有 云 容 姊	留 得 当 时 旧 舞 衣
西 湖 - 荷 花 - 佳 句 - 荷 花 - 烟 霞==西 湖 幽 处 卧 烟 霞	湖 里 荷 花 匝 四 涯	何 事 先 生 得 佳 句	荷 花 却 不 似 梅 花
百 年 - 不 生 - 来 往 - 传 灯 - 纵 横==百 年 抛 却 任 纵 横	只 履 西 归 表 不 生	来 往 本 无 常 湛 寂	心 心 相 印 号 传 灯
君 子 - 胸 中 - 著 紫 - 精 神 - 君 子==仲 宾 笔 底 招 君 子	廷 玉 胸 中 敬 正 人	更 著 紫 阳 虚 叟 句	两 公 炯 炯 见 精 神
春 暮 - 诗 成 - 头 畔 - 日 昏 - 春 暮==羞 云 敛 惨 伤 春 暮	细 缕 诗 成 织 意 深	头 畔 枕 屏 山 掩 恨	日 昏 尘 暗 玉 窗 琴
春 光 - 去 时 - 无 人 - 作 花 - 春 光==懊 恼 春 光 欲 断 肠	来 时 长 缓 去 时 忙	落 红 满 路 无 人 惜	蹈 作 花 泥 透 脚 香
堤 畔 - 楼 台 - 山 色 - 十 年 - 堤 畔==苏 公 堤 畔 采 莲 船	蘸 碧 楼 台 动 管 弦	山 色 湖 光 宛 如 昔	心 情 不 似 十 年 前
高 卧 - 芰 荷 - 嫌 无 - 始 怜 - 高 卧==高 卧 洞 庭 三 十 春	芰 荷 香 里 独 垂 纶	莫 嫌 无 事 闲 销 日	有 事 始 怜 无 事 人
少 欢 - 酒 壶 - 别 鹤 - 泪 滴 - 少 欢==织 绡 泉 底 少 欢 娱	更 劝 萧 郎 尽 酒 壶	愁 见 玉 琴 弹 别 鹤	又 将 清 泪 滴 真 珠
黄 尘 - 盆 池 - 落 日 - 橹 声 - 黄 尘==黄 尘 投 老 倦 匆 匆	故 绕 盆 池 种 水 红	落 日 欹 眠 何 所 忆	江 湖 秋 梦 橹 声 中
泪 痕 - 倚 栏 - 何 处 - 春 寒 - 泪 痕==春 衫 曾 着 泪 痕 斑	才 到 年 时 怕 倚 栏	何 处 飞 来 双 燕 子	傍 人 还 欲 诉 春 寒
双 林 - 法 身 - 春 风 - 千 载 - 双 林==双 林 示 灭 诳 何 人	无 际 真 空 净 法 身	活 向 春 风 裹 埋 了	万 年 千 载 不 成 尘
软 红 - 水 光 - 深 处 - 斜 阳 - 软 红==笑 脱 尘 衫 扑 软 红	杖 藜 徙 倚 水 光 中	最 怜 林 叶 深 深 处	遮 尽 斜 阳 不 碍 风
风 流 - 更 长 - 九 曲 - 必 问 - 风 流==风 流 不 比 贺 家 狂	潇 洒 黄 冠 意 更 长	自 有 武 夷 溪 九 曲	鉴 湖 何 必 问 君 王
垂 象 - 丹 书 - 紫 文 - 题 诗 - 精 思==巍 然 垂 象 隐 精 思	著 述 丹 书 与 世 违	真 得 紫 文 无 上 道	业 成 遗 迹 是 题 诗
山 林 - 万 壑 - 记 荒 - 能 琴 - 山 林==秋 云 放 雨 静 山 林	万 壑 崩 湍 共 一 音	欲 记 荒 寒 无 善 画	赖 传 悲 壮 有 能 琴
安 贫 - 报 国 - 心 期 - 瑟 瑟 - 安 贫==乐 退 安 贫 知 是 分	成 家 报 国 亦 何 惭	到 还 僧 院 心 期 在	瑟 瑟 澄 鲜 百 丈 潭
南 涧 - 南 溪 - 殷 勤 - 僧 乞 - 南 涧==南 涧 先 生 归 几 时	南 溪 如 泛 未 传 诗	君 行 为 我 殷 勤 录	并 问 茶 山 僧 乞 碑
倾 城 - 明 月 - 陇 头 - 夫 未 - 灯 火==春 风 灯 火 倾 城 醉	明 月 花 枝 满 地 寒	不 是 陇 头 新 麦 绿	田 夫 未 肯 远 来 看
古 庙 - 苍 龙 - 有 稽 - 梅 花 - 峨 峨==古 庙 峨 峨 拥 衮 裳	苍 龙 千 载 锁 飞 梁	向 来 更 有 稽 山 穴	谁 把 梅 花 荐 一 觞
月 影 - 荡 漾 - 清 凉 - 小 桥 - 月 影==密 干 参 差 笼 月 影	轻 波 荡 漾 蘸 烟 条	暑 天 要 此 清 凉 地	欲 往 何 辞 度 小 桥
无 声 - 雨 余 - 独 坐 - 山 鸟 - 无 声==铃 索 无 声 讼 牒 稀	雨 余 四 野 竞 扶 犁	小 亭 独 坐 心 无 事	满 地 绿 阴 山 鸟 啼
隐 几 - 只 疑 - 柴 门 - 疾 来 - 隐 几==隐 几 南 窗 万 念 灰	只 疑 土 木 是 形 骸	柴 门 不 用 常 关 著	怕 有 文 殊 问 疾 来
松 风 - 万 里 - 独 坐 - 壮 怀 - 萧 萧==松 风 一 榻 雨 萧 萧	万 里 封 疆 夜 寂 寥	独 坐 瑶 琴 悲 世 虑	君 恩 犹 恐 壮 怀 消
把 酒 - 登 临 - 一 片 - 品 题 - 临 风==临 风 把 酒 此 何 时	白 首 登 临 亦 暮 迟	一 片 湖 光 寒 日 里	品 题 都 是 北 来 诗
天 凉 - 翻 嫌 - 山 川 - 向 灯 - 天 凉==愁 多 却 讶 天 凉 早	思 倦 翻 嫌 夜 漏 迟	何 处 山 川 孤 馆 里	向 灯 弯 尽 一 双 眉
斜 风 - 泪 痕 - 欲 语 - 风 雨 - 斜 风==急 雨 斜 风 颤 晓 荷	娇 羞 花 面 泪 痕 多	向 人 欲 语 竟 不 语	风 雨 无 情 花 奈 何
徘 徊 - 一 杯 - 半 山 - 火 云 - 徘 徊==俗 归 停 驭 重 徘 徊	破 费 林 间 雪 一 杯	留 取 半 山 看 未 了	火 云 时 节 约 重 来
清 秋 - 丹 枫 - 故 人 - 汀 洲 - 一 年==清 秋 又 是 一 年 新	满 眼 丹 枫 映 白 苹	海 内 故 人 书 断 绝	汀 洲 鸥 鹭 却 心 亲
新 竹 - 读 书 - 道 人 - 西 山 - 新 竹==新 竹 修 修 绿 过 墙	读 书 门 外 亦 阴 凉	道 人 清 福 不 肯 受	却 入 西 山 看 夕 阳
当 时 - 谪 仙 - 余 庆 - 至 今 - 气 拥==当 时 骑 气 拥 函 关	奕 代 清 才 擅 谪 仙	鼻 祖 婵 嫣 有 余 庆	至 今 名 世 更 生 贤
春 雨 - 离 鸿 - 水 落 - 无 语 - 春 雨==伤 春 雨 泪 湿 鲛 绡	别 雁 离 鸿 去 影 遥	流 水 落 花 多 少 恨	日 斜 无 语 立 红 桥
西 湖 - 风 光 - 无 穷 - 荷 花 - 西 湖==毕 竟 西 湖 六 月 中	风 光 不 与 四 时 同	接 天 莲 叶 无 穷 碧	映 日 荷 花 别 样 红
茅 舍 - 姓 名 - 传 神 - 争 先 - 竹 篱==竹 篱 茅 舍 养 吾 清	正 恐 人 间 识 姓 名	毛 颍 传 神 偶 相 似	争 先 快 睹 辄 倾 城
一 气 - 龙 法 - 地 脉 - 真 人 - 一 气==一 气 东 南 王 斗 牛	祖 龙 法 潜 为 子 忧	金 陵 地 脉 何 曾 断	不 觉 真 人 已 姓 刘
山 林 - 山 浅 - 薄 暮 - 隐 约 - 山 林==昌 园 梅 树 占 山 林	山 浅 村 深 烟 日 昏	薄 暮 东 风 几 篱 落	雪 涛 隐 约 万 龙 奔
解 何 - 手 报 - 衲 僧 - 五 家 - 问 我==有 人 问 我 解 何 宗	只 堪 摇 手 报 伊 聋	灵 利 衲 僧 须 瞥 地	何 劳 更 说 五 家 宗
银 烛 - 锦 城 - 对 影 - 履 霜 - 银 烛==银 烛 檀 槽 醉 海 棠	老 来 非 复 锦 城 狂	疏 梅 对 影 太 清 淡	为 拂 焦 桐 弹 履 霜
坐 钓 - 朝 衣 - 绿 阴 - 一 片 - 清 江==只 合 清 江 坐 钓 矶	等 闲 谁 遣 着 朝 衣	绿 阴 门 巷 青 绳 路	心 逐 南 云 一 片 飞
小 红 - 盘 中 - 秋 光 - 香 清 - 小 红==数 滴 瓶 泉 花 小 红	丝 丝 禅 供 翠 盘 中	秋 光 坐 对 蒲 塘 晚	一 种 香 清 到 色 空
童 年 - 归 鸿 - 从 谢 - 浩 荡 - 学 露==我 亦 童 年 学 露 蛩	老 来 留 眼 送 归 鸿	自 从 谢 绝 曹 刘 后	浩 荡 春 光 满 太 空
爽 气 - 万 里 - 倒 倾 - 胸 中 - 爽 气==津 津 爽 气 贯 眉 目	十 五 男 儿 万 里 身	笔 下 倒 倾 三 峡 水	胸 中 别 作 一 家 春
面 目 - 几 茎 - 得 一 - 随 风 - 面 目==此 君 面 目 甚 分 明	曲 曲 斜 斜 是 几 茎	但 得 一 回 亲 见 后	不 随 风 雨 听 虚 声
平 芜 - 游 人 - 寥 落 - 花 开 - 漠 漠==平 芜 漠 漠 失 楼 台	昔 日 游 人 乱 后 来	寥 落 墙 匡 春 欲 暮	烧 残 官 树 有 花 开
风 流 - 飞 花 - 玉 人 - 下 帘 - 风 流==灵 和 殿 里 最 风 流	三 月 飞 花 雪 御 楼	换 得 玉 人 眉 样 巧	一 春 浑 不 下 帘 钩
谁 家 - 柳 线 - 昨 夜 - 杏 花 - 谁 家==谁 家 临 水 亚 朱 扉	楼 外 风 闲 柳 线 垂	昨 夜 濛 濛 春 雨 小	杏 花 开 到 背 阴 枝
孙 枝 - 玉 指 - 荧 荧 - 此 时 - 孙 枝==桐 孙 枝 有 海 潮 音	玉 指 初 调 万 簌 沉	烛 影 荧 荧 锁 窗 底	此 时 端 欲 见 琴 心
树 阴 - 海 气 - 笑 语 - 谁 家 - 树 阴==参 横 天 末 树 阴 收	风 响 芦 根 海 气 浮	笑 语 渐 闻 灯 渐 近	谁 家 江 上 早 归 舟
山 色 - 一 鉴 - 水 晶 - 此 轩 - 雨 余==雨 余 山 色 千 螺 翠	风 定 湖 光 一 鉴 明	我 是 水 晶 宫 里 客	暂 来 犹 爱 此 轩 清
寂 寂 - 萧 萧 - 无 人 - 石 桥 - 寂 寂==园 庙 深 关 春 寂 寂	雨 杉 风 桧 翠 萧 萧	山 中 旧 事 无 人 说	碎 叠 唐 碑 补 石 桥
年 老 - 金 屋 - 东 风 - 羲 和 - 年 老==白 发 催 年 老 病 身	可 堪 金 屋 备 词 臣	东 风 是 处 花 开 落	谁 识 羲 和 酿 得 春
真 率 - 屠 苏 - 新 岁 - 惜 旧 - 真 率==真 率 会 居 同 社 长	屠 苏 酒 让 一 家 先	垂 髫 孙 各 欣 新 岁	华 发 翁 偏 惜 旧 年
风 云 - 题 桥 - 得 意 - 贤 哲 - 风 云==汉 朝 卿 相 尽 风 云	司 马 题 桥 众 又 闻	何 事 不 如 杨 得 意	解 搜 贤 哲 荐 明 君
诗 情 - 辽 野 - 北 海 - 风 流 - 诗 情==诗 情 不 惯 吏 尘 器	心 事 偏 辽 野 趣 幽	纵 使 酒 尊 空 北 海	客 来 一 笑 也 风 流
悲 风 - 泪 残 - 窥 人 - 云 锦 - 秋 宵==悲 风 鸣 叶 秋 宵 冷	寒 丝 萦 手 泪 残 妆	微 烛 窥 人 悉 断 肠	机 翻 云 锦 妙 成 章
人 情 - 绊 身 - 灰 心 - 问 侬 - 人 情==老 景 人 情 一 羽 轻	绊 身 何 用 尚 浮 名	备 尝 世 事 灰 心 久	更 问 侬 当 作 麽 生
芙 蓉 - 看 花 - 花 边 - 两 行 - 傍 水==傍 水 芙 蓉 未 著 霜	看 花 酌 酒 坐 渔 庄	花 边 折 得 芭 蕉 叶	醉 写 新 词 一 两 行
插 云 - 水 平 - 桑 柘 - 绿 阴 - 门 前==门 前 山 树 插 云 青	雨 足 山 前 稻 水 平	桑 柘 半 空 蚕 事 了	绿 阴 深 处 啭 残 莺
孤 帆 - 五 湖 - 江 南 - 岭 外 - 孤 帆==一 片 孤 帆 无 四 邻	北 风 吹 过 五 湖 滨	相 看 尽 是 江 南 客	独 有 君 为 岭 外 人
危 峰 - 瀑 声 - 鸟 啼 - 青 青 - 危 峰==千 朵 危 峰 杳 霭 间	石 房 长 带 瀑 声 寒	鸟 啼 花 发 寻 常 事	松 本 青 青 雪 里 看
梅 花 - 清 香 - 风 露 - 知 人 - 梅 花==我 爱 梅 花 不 忍 摘	清 香 却 解 逐 人 来	风 露 肌 肤 随 处 好	不 知 人 世 有 尘 埃
归 路 - 春 光 - 应 相 - 满 袖 - 东 风==莫 管 东 风 归 路 长	但 将 绮 句 答 春 光	候 门 儿 女 应 相 讶	满 袖 离 骚 草 木 香
离 离 - 风 清 - 闻 广 - 玉 树 - 一 帘==一 帘 竹 影 画 离 离	月 白 风 清 花 气 吹	梦 里 似 曾 闻 广 乐	醒 来 玉 树 弄 阶 墀
如 膏 - 催 花 - 薄 暮 - 西 山 - 轻 红==如 膏 细 雨 沐 轻 红	更 有 催 花 少 女 风	薄 暮 浓 云 横 汉 外	西 山 数 点 有 无 中
奔 湍 - 喷 云 - 通 天 - 乘 槎 - 奔 湍==一 派 奔 湍 响 迅 雷	喷 云 翻 雪 绕 琼 台	应 通 天 上 银 潢 路	准 拟 乘 槎 八 月 来
门 前 - 白 发 - 今 喜 - 盆 池 - 门 前==门 前 唤 担 买 芳 菲	白 发 犹 堪 插 一 枝	旧 厌 蛙 声 今 喜 听	墙 阴 特 地 作 盆 池
远 岫 - 晴 岚 - 珍 重 - 秀 色 - 远 岫==近 山 远 岫 不 知 重	暖 翠 晴 岚 只 满 空	珍 重 主 人 将 好 手	尽 驱 秀 色 入 楼 中
离 披 - 精 神 - 西 风 - 黄 花 - 离 披==菰 叶 离 披 藕 叶 欹	精 神 得 似 未 秋 时	西 风 坐 断 群 芳 路	不 属 黄 花 更 属 谁
轻 明 - 徘 徊 - 江 梅 - 驿 使 - 轻 明==一 点 轻 明 照 雪 开	六 花 惊 妒 亦 徘 徊	清 香 不 在 江 梅 后	底 事 全 无 驿 使 来
拂 地 - 浅 浅 - 花 吹 - 春 风 - 拂 地==一 把 轻 丝 拂 地 垂	柔 梢 浅 浅 抹 燕 脂	絮 花 吹 尽 枝 方 长	却 恨 春 风 未 得 知
三 山 - 琼 楼 - 花 下 - 春 色 - 碧 海==遥 闻 碧 海 有 三 山	云 锁 琼 楼 日 月 间	花 下 玉 颜 常 不 老	也 应 春 色 胜 人 间
疏 帘 - 青 苔 - 风 前 - 出 海 - 疏 帘==睡 起 疏 帘 一 半 开	更 无 人 迹 过 青 苔	须 臾 苍 狗 风 前 变	雷 雨 驱 潮 出 海 来
延 寿 - 黄 金 - 万 里 - 生 春 - 通 神==毛 延 寿 画 欲 通 神	忍 为 黄 金 不 为 人	马 上 琵 琶 行 万 里	汉 宫 长 有 隔 生 春
虎 踞 - 星 光 - 东 西 - 头 阮 - 虎 踞==虎 踞 龙 蹲 纵 复 横	星 光 渐 减 雨 痕 生	不 须 并 碍 东 西 路	哭 杀 厨 头 阮 步 兵
意 态 - 无 尘 - 风 月 - 玉 人 - 意 态==并 舞 连 歌 意 态 新	水 晶 宫 里 向 无 尘	一 时 风 月 谁 能 许	要 是 君 家 两 玉 人
云 水 - 春 山 - 行 客 - 残 红 - 云 水==芳 草 连 云 水 拍 溪	春 山 树 树 子 规 啼	东 风 何 事 催 行 客	偏 遣 残 红 趁 马 蹄
森 森 - 五 枝 - 六 逸 - 麟 儿 - 森 森==森 森 兰 玉 出 庭 闱	突 过 燕 山 桂 五 枝	六 逸 风 流 谁 得 似	君 家 个 个 是 麟 儿
马 乳 - 芳 樽 - 吾 事 - 菜 园 - 马 乳==马 乳 三 年 隔 大 官	羊 羔 今 日 倒 芳 樽	浅 基 低 唱 非 吾 事	醉 梦 惟 应 踏 菜 园
山 林 - 清 江 - 看 山 - 边 试 - 山 林==不 向 山 林 不 背 村	清 江 东 畔 邑 东 门	雨 馀 徐 步 看 山 罢	植 杖 沙 边 试 水 痕
含 青 - 名 园 - 呜 咽 - 劫 火 - 含 青==半 熟 含 青 市 百 枚	名 园 高 树 曲 城 隈	山 翁 呜 咽 言 情 事	曾 见 黄 巢 劫 火 灰
新 岁 - 春 幡 - 东 风 - 贺 岁 - 新 岁==莫 将 新 岁 便 为 新	彩 仗 春 幡 不 动 陈	未 转 东 风 犹 是 腊	明 朝 贺 岁 莫 通 宾
太 乙 - 生 涯 - 归 去 - 碧 桃 - 太 乙==太 乙 峰 前 是 我 家	满 床 书 史 足 生 涯	春 深 带 酒 不 归 去	老 却 碧 桃 无 限 花
莺 声 - 窗 棂 - 浓 如 - 解 醒 - 莺 声==晓 枕 莺 声 带 梦 听	忽 看 淡 日 满 窗 棂	闲 愁 谁 遣 浓 如 酒	醉 过 残 春 不 解 醒
暮 冬 - 太 守 - 使 平 - 濯 缨 - 暮 冬==征 衣 穷 塞 暮 冬 时	读 尽 龙 城 太 守 诗	若 使 平 生 诗 尽 在	濯 缨 无 泪 为 君 垂
醉 红 - 明 月 - 蛾 眉 - 有 无 - 返 照==满 天 返 照 醉 红 殷	未 到 生 明 月 已 弯	好 是 蛾 眉 无 点 恨	盈 盈 淡 扫 有 无 间
缟 素 - 剪 刀 - 孤 灯 - 十 年 - 沈 沈==缟 素 沈 沈 抱 所 天	死 心 已 在 剪 刀 前	主 家 楼 上 孤 灯 泪	同 洒 秋 风 四 十 年
火 树 - 翠 幄 - 解 佩 - 青 楼 - 火 树==火 树 灯 山 高 入 云	红 筵 翠 幄 自 成 春	游 女 有 时 还 解 佩	青 楼 何 处 不 留 人
纵 横 - 天 王 - 旂 直 - 凤 阙 - 纵 横==齐 鲁 纵 横 豺 虎 群	天 王 亲 拜 大 将 军	牙 旂 直 卷 狼 山 雪	金 印 还 瞻 凤 阙 云
吟 诗 - 横 秋 - 茅 檐 - 凌 云 - 苦 吟==自 叹 苦 吟 诗 不 老	羡 君 词 气 凛 横 秋	争 如 兀 坐 茅 檐 下	得 见 凌 云 五 凤 楼
井 梧 - 随 风 - 五 声 - 梦 回 - 井 梧==井 梧 和 雨 下 银 床	梁 燕 随 风 别 画 堂	二 十 五 声 秋 漏 永	梦 回 各 自 耐 思 量
阶 前 - 烟 迷 - 黄 莺 - 春 愁 - 久 雨==久 雨 阶 前 铺 绿 衣	烟 迷 竹 树 影 稀 移	黄 莺 交 坐 窗 前 语	说 尽 春 愁 来 往 飞
到 中 - 绝 顶 - 烟 含 - 日 照 - 中 峰==君 到 中 峰 力 不 加	却 疑 绝 顶 事 皆 夸	烟 含 晚 市 微 分 塔	日 照 邻 州 近 隔 沙
万 里 - 来 往 - 西 风 - 目 断 - 万 里==家 在 琼 崖 万 里 遥	此 身 来 往 似 孤 舟	夜 来 梦 趁 西 风 去	目 断 家 山 空 泪 流
浮 云 - 千 岁 - 花 落 - 闻 雪 - 浮 云==浮 云 万 事 不 到 眼	千 岁 人 间 心 尚 孩	屏 风 叠 下 看 花 落	扇 子 峡 中 闻 雪 来
天 寒 - 楚 水 - 少 妇 - 一 行 - 天 寒==凉 霜 八 月 塞 天 寒	飞 度 衡 阳 楚 水 宽	少 妇 楼 头 初 掩 瑟	一 行 先 向 夕 阳 看
百 雉 - 亭 亭 - 感 慨 - 秋 风 - 百 雉==都 城 百 雉 晓 云 空	四 塔 亭 亭 倚 望 中	自 是 老 怀 多 感 慨	一 襟 清 泪 湿 秋 风
阴 浓 - 繁 花 - 春 归 - 弦 管 - 阴 浓==杏 梅 成 实 夏 阴 浓	波 面 繁 花 刺 眼 红	莫 为 春 归 减 欢 兴	共 将 弦 管 乐 薰 风
入 楚 - 春 风 - 不 言 - 有 容 - 入 楚==息 亡 身 入 楚 王 家	回 首 春 风 一 面 花	感 旧 不 言 长 掩 泪	只 应 翻 恨 有 容 华
西 湖 - 十 年 - 题 诗 - 梅 花 - 西 湖==不 到 西 湖 今 几 时	十 年 双 鬓 欲 如 丝	难 寻 和 靖 题 诗 处	空 见 梅 花 成 老 枝
眈 眈 - 长 松 - 云 寒 - 桥 边 - 眈 眈==眈 眈 卧 石 熊 当 道	矫 矫 长 松 龙 上 天	不 怕 雪 云 寒 到 骨	唤 僧 扶 杖 立 桥 边
解 愁 - 花 开 - 黄 花 - 一 片 - 解 愁==老 子 平 生 不 解 愁	花 开 酒 熟 万 缘 休	更 教 不 为 黄 花 醉	枉 却 今 年 一 片 秋
流 泉 - 仙 山 - 山 中 - 薄 雾 - 流 泉==绕 砌 流 泉 响 佩 环	翘 鸱 宫 殿 隐 仙 山	老 难 遍 踏 山 中 胜	且 看 轻 云 薄 雾 间
莺 声 - 春 色 - 花 落 - 风 卷 - 莺 声==掷 谷 莺 声 向 此 沉	绕 坟 春 色 为 谁 深	纸 钱 灰 冷 桐 花 落	已 被 愁 风 卷 到 心
烟 冷 - 江 流 - 片 云 - 夜 半 - 烟 冷==烟 冷 隋 宫 草 木 秋	屏 山 分 翠 接 江 流	片 云 不 隔 长 芦 寺	夜 半 钟 声 敲 客 愁
病 骨 - 秋 风 - 萧 然 - 清 香 - 病 骨==病 骨 栾 栾 瘦 转 加	秋 风 怯 傍 小 窗 纱	萧 然 丈 室 维 摩 观	一 炷 清 香 到 日 斜
草 色 - 一 川 - 老 天 - 柔 风 - 黄 草==柳 色 黄 黄 草 色 微	一 川 新 渌 两 红 衣	老 天 也 信 还 家 好	淡 日 柔 风 送 客 归
一 区 - 夭 桃 - 花 繁 - 馨 香 - 一 区==墙 里 一 区 谁 氏 宅	照 墙 不 作 夭 桃 色	翠 条 乞 怪 玉 花 繁	馨 香 借 与 新 诗 力
风 前 - 月 下 - 清 宵 - 秋 色 - 风 前==风 前 散 袂 能 忘 扇	月 下 题 诗 不 用 灯	万 士 清 宵 鏖 棘 庑	一 年 秋 色 满 桐 城
相 惊 - 白 两 - 王 副 - 得 一 - 相 见==亲 朋 相 见 忽 相 惊	绿 发 朝 来 白 两 茎	若 比 商 州 王 副 使	预 先 才 得 一 年 生
芳 气 - 三 复 - 寂 寞 - 花 间 - 芳 气==芳 气 时 时 侵 鼻 观	令 人 三 复 柳 州 诗	非 因 寂 寞 耽 幽 意	醉 倒 花 间 未 必 知
枝 上 - 山 中 - 春 风 - 法 度 - 枝 上==合 昏 枝 上 数 花 白	领 略 山 中 每 日 看	阅 历 春 风 人 眼 恕	相 传 此 法 度 荒 寒
听 雨 - 老 鬓 - 晴 窗 - 听 雨 - 听 雨==听 雨 思 君 泪 欲 流	檐 声 滴 老 鬓 边 秋	何 时 过 我 晴 窗 下	共 话 思 君 听 雨 愁
归 路 - 山 鸡 - 新 春 - 华 池 - 万 里==万 里 峰 峦 归 路 迷	未 判 容 彩 借 山 鸡	新 春 定 有 将 雏 乐	阿 阁 华 池 两 处 栖
春 早 - 香 车 - 丁 宁 - 归 来 - 月 余==春 早 持 斋 一 月 余	罗 衣 初 试 觅 香 车	丁 宁 夫 婿 严 斋 禁	顶 上 归 来 始 破 除
水 合 - 朝 天 - 居 高 - 日 月 - 水 合==水 合 众 流 同 赴 海	山 分 一 岭 独 朝 天	居 高 素 以 谦 为 德	日 月 倾 心 斗 极 边
汉 庭 - 萧 疏 - 苍 生 - 幽 居 - 汉 庭==汉 庭 得 谢 久 县 车	松 竹 萧 疏 护 葺 庐	争 奈 苍 生 待 霖 雨	未 容 安 石 爱 幽 居
霜 重 - 水 寒 - 马 嘶 - 夜 月 - 霜 重==霜 重 榆 关 下 角 鹰	水 寒 蒲 类 半 成 冰	马 嘶 部 落 征 笳 动	夜 月 穹 庐 泣 李 陵
残 腊 - 寒 梅 - 英 轻 - 月 明 - 残 腊==欲 驱 残 腊 变 春 风	自 有 寒 梅 作 选 锋	莫 把 疏 英 轻 门 雪	好 藏 清 艳 月 明 中
名 园 - 扬 州 - 千 金 - 一 朵 - 名 园==西 洛 名 园 堕 劫 灰	扬 州 风 物 更 堪 哀	纵 携 买 笑 千 金 去	难 唤 能 行 一 朵 来
青 松 - 春 风 - 岂 能 - 栽 培 - 茯 苓==青 松 未 结 茯 苓 英	杞 菊 春 风 亦 已 生	药 物 岂 能 增 大 数	栽 培 扶 我 暮 龄 行
故 人 - 县 令 - 贤 礼 - 拜 赐 - 故 人==不 是 故 人 供 禄 米	初 非 县 令 给 猪 肝	养 贤 礼 厚 隆 三 簋	拜 赐 恩 深 艳 一 箪
蒙 蒙 - 东 篱 - 黄 花 - 后 诗 - 蒙 蒙==世 事 蒙 蒙 醉 不 知	南 山 秋 意 满 东 篱	黄 花 何 故 无 颜 色	应 为 元 嘉 以 后 诗
云 烟 - 积 翠 - 海 市 - 明 灭 - 云 烟==云 烟 缥 缈 郁 孤 台	积 翠 浮 空 雨 半 开	想 见 之 罘 观 海 市	绛 宫 明 灭 是 蓬 莱
仙 家 - 风 来 - 异 香 - 秋 光 - 仙 家==自 是 仙 家 别 样 妆	风 来 疑 解 舞 霓 裳	异 香 只 许 蟾 官 采	不 与 秋 光 作 伴 黄
雨 余 - 风 送 - 夜 凉 - 鸣 蛙 - 雨 余==雨 余 遥 翠 抹 飞 霞	风 送 蛟 龙 恰 到 家	一 夜 凉 侵 蕲 竹 簟	最 宜 欹 枕 听 鸣 蛙
芙 蓉 - 安 排 - 天 趣 - 游 人 - 芙 蓉==杨 柳 芙 蓉 旧 日 栽	近 来 堂 宇 更 安 排	湖 光 接 得 全 天 趣	莫 遣 游 人 鼓 吹 来
驻 马 - 凌 波 - 香 罗 - 开 元 - 驻 马==万 骑 西 行 驻 马 嵬	凌 波 曾 此 堕 尘 埃	谁 知 一 掬 香 罗 小	踏 转 开 元 宇 宙 来
和 露 - 花 下 - 高 楼 - 教 齐 - 香 尘==香 尘 和 露 踏 成 泥	花 下 风 寒 鬓 脚 低	夜 静 高 楼 有 人 听	起 头 一 句 唱 教 齐
幻 差 - 焚 香 - 衰 草 - 洛 阳 - 来 过==梦 眼 由 来 过 幻 差	焚 香 祗 好 诵 南 华	云 深 汉 殿 犹 衰 草	风 贤 洛 阳 无 旧 花
鸭 绿 - 芙 蓉 - 日 长 - 天 魔 - 鸭 绿==鸭 绿 微 生 太 液 波	芙 蓉 杨 柳 受 风 多	日 长 供 奉 传 新 谱	教 舞 天 魔 队 子 歌
夜 色 - 花 市 - 欲 动 - 东 西 - 夜 色==细 雨 春 灯 夜 色 新	酒 楼 花 市 不 胜 春	和 风 欲 动 千 门 月	醉 杀 东 西 南 北 人
重 重 - 逼 入 - 欲 动 - 烟 中 - 重 重==天 家 观 阙 玉 重 重	逼 入 春 皇 一 信 风	生 意 无 边 青 欲 动	微 茫 淡 霭 暖 烟 中
春 水 - 柳 条 - 鸳 鸯 - 日 色 - 春 水==春 江 沉 沉 春 水 满	柳 条 拂 水 蒲 芽 短	鸳 鸯 睡 美 不 畏 人	日 色 迟 迟 素 沙 暖
嫩 绿 - 压 枝 - 细 草 - 两 朵 - 桐 阴==嫩 绿 桐 阴 夹 道 遮	烂 红 野 果 压 枝 斜	日 烘 细 草 香 无 价	况 有 三 枝 两 朵 花
潺 湲 - 三 更 - 欹 枕 - 轻 舟 - 潺 湲==潺 湲 十 里 响 流 湍	唤 醒 三 更 客 梦 阑	欹 枕 何 人 眠 不 得	轻 舟 疑 傍 子 陵 滩
徘 徊 - 金 丹 - 归 去 - 风 雷 - 徘 徊==谪 君 尘 世 意 徘 徊	炼 尽 金 丹 待 鹤 来	归 去 神 霄 朝 玉 帝	依 前 命 我 掌 风 雷
侵 云 - 狰 狞 - 白 日 - 黄 昏 - 侵 云==寺 中 荆 棘 老 侵 云	恶 木 狰 狞 野 外 村	原 上 狐 狸 走 白 日	水 边 魑 魁 立 黄 昏
归 来 - 御 炉 - 凤 凰 - 白 书 - 归 来==上 国 归 来 路 几 千	浑 身 犹 带 御 炉 烟	凤 凰 山 下 敲 篷 咏	惊 起 山 翁 白 书 眠
野 云 - 高 楼 - 渴 睡 - 双 飞 - 平 野==无 山 平 野 云 天 阔	有 月 高 楼 烟 水 微	渴 睡 车 中 莺 一 啭	愁 吟 路 上 蝶 双 飞
无 尘 - 百 紫 - 野 草 - 惜 花 - 幕 天==幕 天 无 日 地 无 尘	百 紫 千 红 占 得 春	野 草 自 花 还 自 落	落 时 还 有 惜 花 人
朝 天 - 高 楼 - 雪 浪 - 金 城 - 朝 天==出 峡 朝 天 第 一 州	使 君 重 敞 最 高 楼	蜀 江 雪 浪 初 平 处	楚 国 金 城 欲 尽 头
纷 纷 - 芳 菲 - 春 风 - 一 醉 - 纷 纷==为 惜 纷 纷 作 雪 飞	忍 看 桃 李 便 芳 菲	小 瓶 留 得 春 风 面	尚 可 携 壶 一 醉 归
雨 湿 - 道 士 - 搜 诗 - 此 时 - 雨 湿==霏 霏 小 雨 湿 松 株	疑 是 初 成 道 士 图	我 亦 搜 诗 要 穷 底	此 时 幽 思 不 枝 梧
人 事 - 断 肠 - 柳 色 - 离 人 - 人 事==人 事 好 乖 当 语 离	龙 眠 貌 出 断 肠 诗	渭 城 柳 色 关 何 事	自 是 离 人 作 许 悲
清 秋 - 戍 楼 - 无 尘 - 夜 深 - 蟾 光==蟾 光 如 水 浸 清 秋	防 塞 将 军 在 戍 楼	千 里 无 尘 烽 火 寂	夜 深 犹 起 看 旄 头
池 边 - 风 寒 - 柳 叶 - 李 花 - 池 边==池 边 弄 水 手 犹 冰	藕 臂 风 寒 更 粟 生	柳 叶 春 深 槐 叶 浅	桃 花 夜 暗 李 花 明
烟 波 - 风 月 - 远 近 - 武 陵 - 烟 波==烟 波 与 客 同 樽 酒	风 月 全 家 上 采 舟	莫 问 台 前 花 远 近	试 看 何 以 武 陵 游
岁 华 - 钗 斜 - 梅 香 - 春 风 - 岁 华==帘 底 临 鸾 惜 岁 华	鬓 云 慵 掠 宝 钗 斜	落 梅 香 断 无 消 息	一 树 春 风 属 杏 花
漠 漠 - 溪 边 - 何 处 - 江 南 - 轻 烟==轻 烟 漠 漠 锁 晴 岚	野 水 溪 边 小 驻 骖	日 暮 征 鸿 落 何 处	似 将 风 景 过 江 南
独 立 - 海 门 - 苍 茫 - 落 日 - 吴 山==独 立 吴 山 望 越 山	海 门 人 去 几 时 还	故 乡 犹 隔 苍 茫 外	一 点 征 愁 落 日 间
雨 浥 - 生 香 - 高 眠 - 昼 长 - 雨 浥==雨 浥 蒲 风 晚 更 凉	数 花 檐 卜 净 生 香	高 眠 深 稳 清 无 梦	尽 觉 人 间 白 昼 长
明 月 - 两 岸 - 停 桡 - 若 为 - 明 月==巴 东 明 月 巴 西 歌	两 岸 梅 花 羌 笛 多	一 曲 停 桡 双 泪 落	猿 声 三 峡 若 为 过
鸿 雁 - 片 云 - 昨 夜 - 千 山 - 鸿 雁==鸿 雁 惊 秋 海 上 还	片 云 孤 月 蓟 门 关	无 端 昨 夜 西 窗 梦	不 道 千 山 与 万 山
江 水 - 长 江 - 一 樽 - 扁 舟 - 悠 悠==锁 江 水 下 水 悠 悠	只 锁 长 江 不 锁 愁	但 存 一 樽 浇 旅 思	图 教 沉 醉 泛 扁 舟
谈 笑 - 阿 那 - 相 笑 - 垂 泪 - 谈 笑==留 君 谈 笑 且 从 容	白 发 红 尘 阿 那 中	踉 跄 行 藏 莫 相 笑	枯 鱼 垂 泪 恨 无 从
饱 食 - 一 瓯 - 绳 床 - 风 送 - 饱 食==饱 食 缓 行 新 睡 觉	一 瓯 新 茗 侍 儿 煎	脱 巾 斜 倚 绳 床 坐	风 送 水 声 来 耳 边
凛 凛 - 弥 天 - 鸳 鹭 - 层 峦 - 清 风==清 风 凛 凛 字 人 官	堪 对 弥 天 释 道 安	不 日 归 朝 狎 鸳 鹭	也 须 音 问 寄 层 峦
小 雪 - 花 然 - 融 和 - 雨 露 - 小 雪==甲 子 徒 推 小 雪 天	刺 梧 犹 绿 槿 花 然	融 和 长 养 无 时 歇	却 是 炎 洲 雨 露 偏
氤 氲 - 片 片 - 万 里 - 五 色 - 氤 氲==金 鸡 旭 照 气 氤 氲	片 片 晴 霞 布 彩 纹	万 里 沧 波 联 锦 绮	干 坤 五 色 绘 奇 文
清 绝 - 冰 霜 - 轻 明 - 前 身 - 幽 人==此 花 清 绝 似 幽 人	苦 耐 冰 霜 不 爱 春	蜡 蕊 轻 明 香 万 斛	黄 姑 端 的 是 前 身
