下 帘 - 夜 长 - 一 树 - 秘 书 - 下 帘==下 帘 深 与 意 商 量	无 酒 何 如 此 夜 长	一 树 木 丝 仙 有 发	依 然 只 作 秘 书 香
万 仞 - 带 月 - 通 天 - 自 安 - 万 仞==路 绕 崖 悬 万 仞 头	檐 泉 带 月 几 时 休	个 中 拨 转 通 天 窃	人 自 安 间 水 自 流
三 日 - 岁 华 - 里 清 - 和 雨 - 三 日==霜 晴 三 日 不 胜 佳	忽 作 阴 霖 送 岁 华	客 里 清 愁 自 无 奈	却 教 和 雨 看 梅 花
行 吟 - 麻 衣 - 五 陵 - 戏 马 - 行 吟==草 泽 行 吟 赋 楚 骚	青 麻 衣 上 俗 尘 多	五 陵 年 少 休 相 笑	戏 马 台 前 载 酒 过
太 阿 - 倚 无 - 松 筠 - 踏 遍 - 太 阿==君 以 高 标 比 太 阿	方 将 试 用 倚 无 何	肯 来 访 我 松 筠 里	踏 遍 崇 冈 与 断 坡
亭 边 - 迢 迢 - 黄 昏 - 春 愁 - 亭 边==洛 尾 亭 边 淮 汴 交	来 波 去 浪 恨 迢 迢	无 端 更 洒 黄 昏 雨	吹 作 春 愁 不 肯 消
酒 醒 - 藕 花 - 游 人 - 一 片 - 酒 醒==酒 醒 湖 光 生 嫩 凉	卧 船 吹 笛 藕 花 香	游 人 尽 逐 莺 花 去	一 片 闲 情 在 夕 阳
功 名 - 白 发 - 花 心 - 归 与 - 有 意==壮 时 尝 有 意 功 名	不 觉 星 星 白 发 生	眼 亦 渐 花 心 更 短	归 与 犹 可 事 农 耕
黄 昏 - 光 涵 - 文 不 - 平 平 - 黄 昏==黄 昏 潮 落 南 沙 明	月 光 涵 沙 秋 雪 清	水 文 不 上 烟 不 荡	平 平 玉 田 冷 空 旷
云 淡 - 江 边 - 流 水 - 翠 色 - 云 淡==浓 似 春 云 淡 似 烟	参 差 绿 到 大 江 边	斜 阳 流 水 推 蓬 坐	翠 色 随 人 欲 上 船
满 野 - 淑 气 - 草 木 - 一 叶 - 溶 溶==浮 阳 满 野 白 溶 溶	泽 底 山 椒 淑 气 通	草 木 岂 能 知 造 化	一 华 一 叶 尽 天 功
乡 人 - 年 丰 - 今 至 - 青 青 - 得 乡==闻 得 乡 人 说 刺 桐	花 如 后 发 始 年 丰	我 今 至 此 忧 民 切	只 爱 青 青 不 爱 红
风 烟 - 沦 落 - 参 差 - 江 州 - 风 烟==塞 外 风 烟 能 记 否	天 涯 沦 落 自 心 知	眼 中 风 物 参 差 是	只 欠 江 州 司 马 诗
呼 晴 - 角 鸣 - 雨 不 - 唇 舌 - 呼 晴==鸠 能 唤 雨 复 呼 晴	日 日 长 从 屋 角 鸣	晴 雨 不 应 关 汝 事	强 饶 唇 舌 效 君 卿
流 水 - 洛 滨 - 翠 蛾 - 画 船 - 鳞 鳞==曲 池 流 水 细 鳞 鳞	高 会 传 觞 似 洛 滨	红 粉 翠 蛾 应 不 要	画 船 来 往 胜 於 人
如 烟 - 桃 李 - 道 人 - 新 茶 - 如 烟==陇 麦 如 烟 水 满 塘	路 边 桃 李 问 柔 桑	道 人 不 作 渊 明 调	笑 碾 新 茶 看 瑞 香
后 山 - 烟 收 - 吟 鞭 - 楼 上 - 路 转==路 转 前 山 复 后 山	宿 烟 收 尽 薄 生 寒	吟 鞭 忽 指 松 梢 月	绝 胜 城 中 楼 上 看
酒 樽 - 雨 湿 - 穿 花 - 风 流 - 酒 樽==人 去 残 英 满 酒 樽	不 堪 细 雨 湿 黄 昏	夜 寒 那 得 穿 花 蝶	知 是 风 流 楚 客 魂
白 云 - 知 音 - 风 雨 - 相 思 - 白 云==锦 笺 牙 轴 白 云 词	君 外 知 音 更 有 谁	一 榻 何 时 对 风 雨	与 君 联 臂 话 相 思
鼓 角 - 三 更 - 鸡 唱 - 天 明 - 鼓 角==严 城 鼓 角 送 钟 声	顷 刻 三 更 四 五 更	却 是 邻 家 鸡 唱 准	不 差 消 息 已 天 明
东 风 - 酒 家 - 草 木 - 春 色 - 风 吹==东 风 吹 著 便 成 花	妆 点 园 林 卖 酒 家	田 野 可 栽 闲 草 木	十 分 春 色 在 桑 麻
江 梅 - 零 落 - 李 花 - 前 村 - 江 梅==只 道 江 梅 发 不 迟	最 先 零 落 使 人 悲	从 今 秾 李 花 千 树	未 抵 前 村 雪 一 枝
通 津 - 江 南 - 龙 舟 - 杨 柳 - 雪 消==雪 消 冰 动 看 通 津	草 长 江 南 岸 岸 春	莫 唱 龙 舟 五 更 曲	扬 州 杨 柳 解 愁 人
潮 生 - 江 头 - 终 年 - 挂 鱼 - 潮 生==潮 生 鱼 扈 得 鱼 多	生 小 江 头 狎 水 波	但 愿 终 年 风 信 少	七 鲲 身 里 挂 鱼 蓑
玉 堂 - 零 落 - 春 风 - 一 年 - 一 树==白 玉 堂 前 一 树 梅	为 谁 零 落 为 谁 开	唯 有 春 风 最 相 惜	一 年 一 度 一 归 来
漫 漫 - 春 风 - 出 篱 - 淡 烟 - 漫 漫==起 看 重 雾 白 漫 漫	略 见 春 风 在 树 间	傍 水 出 篱 犹 未 快	淡 烟 微 雨 又 青 山
驱 人 - 爬 搔 - 山 石 - 荷 插 - 薄 宦==薄 宦 驱 人 不 亦 劳	久 纡 章 服 碍 爬 搔	何 时 归 卧 钟 山 石	荷 插 长 随 手 种 桃
衔 花 - 过 始 - 五 百 - 老 卢 - 衔 花==百 鸟 衔 花 未 足 奇	直 须 透 过 始 方 知	五 百 众 中 谁 委 悉	碓 头 私 许 老 卢 锥
柳 絮 - 照 月 - 家 妇 - 梨 花 - 因 风==柳 絮 因 风 淡 远 空	海 棠 照 月 雾 香 蒙	莫 愁 强 字 卢 家 妇	闭 影 梨 花 芳 雪 中
泥 泥 - 下 舂 - 炊 软 - 颓 慵 - 一 年==泥 泥 水 水 一 年 农	收 拾 将 来 碓 下 舂	炊 软 香 分 千 钵 饭	肚 皮 参 饱 放 颓 慵
牡 丹 - 锦 色 - 江 南 - 无 人 - 牡 丹==牡 丹 红 豆 艳 春 天	檀 板 朱 丝 锦 色 笺	头 白 江 南 一 尊 酒	无 人 知 是 李 龟 年
水 云 - 竹 里 - 雨 晴 - 东 西 - 水 云==碧 空 一 片 水 云 飞	竹 里 人 家 午 唱 鸡	江 路 雨 晴 芳 草 润	杖 藜 行 遍 水 东 西
胧 胧 - 鸡 声 - 感 慨 - 别 离 - 胧 胧==前 山 树 暗 月 胧 胧	马 色 鸡 声 共 晓 风	不 为 逢 秋 多 感 慨	只 缘 身 在 别 离 中
推 车 - 百 川 - 万 物 - 白 日 - 推 车==雷 公 推 车 电 施 鞭	飞 腾 九 泽 舞 百 川	须 臾 开 晴 万 物 鲜	仰 视 白 日 当 青 天
牡 丹 - 秋 风 - 三 月 - 神 仙 - 牡 丹==牡 丹 未 及 开 时 节	况 是 秋 风 莫 近 前	留 待 来 年 二 三 月	一 枝 和 露 压 神 仙
花 开 - 万 里 - 迎 客 - 船 中 - 花 开==花 开 南 北 一 般 红	路 过 江 淮 万 里 通	飞 盖 靓 妆 迎 客 笑	鲜 鱼 白 酒 醉 船 中
看 月 - 双 飞 - 举 酒 - 佳 句 - 看 月==仰 头 看 月 见 新 鸿	形 影 双 飞 玉 监 中	呼 我 作 卿 方 举 酒	更 烦 佳 句 赏 高 度
水 晶 - 炎 蒸 - 翰 林 - 赐 冰 - 宫 殿==宫 殿 钩 帘 看 水 晶	时 当 三 仗 炽 炎 蒸	翰 林 学 士 知 谁 直	今 日 傅 宣 与 赐 冰
人 事 - 抱 乡 - 三 千 - 一 杯 - 人 事==人 事 如 何 只 好 乖	即 今 怀 抱 乡 谁 开	短 檠 阅 罢 三 千 牍	遥 夜 相 望 把 一 杯
景 曜 - 东 湖 - 一 片 - 潇 湘 - 未 晡==景 曜 当 空 日 未 晡	无 端 雷 雨 暗 东 湖	谁 将 一 片 晴 江 色	写 作 潇 湘 烟 雨 图
渔 舟 - 芦 花 - 垂 丝 - 钓 竿 - 瑞 气==月 皎 渔 舟 瑞 气 旋	芦 花 深 处 夜 涛 寒	可 怜 无 限 垂 丝 者	随 例 忙 忙 失 钓 竿
香 粳 - 秋 天 - 鸣 琴 - 黄 叶 - 香 粳==野 菜 香 粳 乐 晚 年	疏 林 晴 日 好 秋 天	风 瓢 满 耳 鸣 琴 筑	黄 叶 深 窝 得 宴 眠
扶 疏 - 造 化 - 一 点 - 健 妇 - 扶 疏==小 竹 扶 疏 大 竹 枯	笔 端 真 有 造 化 炉	人 间 俗 气 一 点 无	健 妇 果 胜 大 丈 夫
正 始 - 红 蕖 - 游 人 - 年 丰 - 正 始==绿 绮 新 调 正 始 音	红 蕖 小 放 上 元 灯	游 人 莫 诮 遨 头 懒	只 愿 年 丰 岁 事 登
水 外 - 玲 珑 - 闲 坐 - 拂 拂 - 水 外==百 一 十 城 烟 水 外	玲 珑 八 面 自 天 开	等 闲 坐 断 东 西 北	无 限 薰 风 拂 拂 来
维 摩 - 枝 斜 - 窗 间 - 桃 花 - 维 摩==画 取 维 摩 室 中 物	小 瓶 春 色 一 枝 斜	梦 回 映 月 窗 间 见	不 是 桃 花 与 李 花
湖 海 - 经 年 - 间 惟 - 岁 余 - 湖 海==湖 海 相 忘 日 自 疏	经 年 不 作 一 行 书	世 间 惟 有 韩 康 伯	肯 为 渊 源 住 岁 余
联 珠 - 悲 秋 - 烦 恼 - 新 诗 - 联 珠==缀 玉 联 珠 辱 见 投	要 知 词 客 解 悲 秋	侬 家 韦 自 无 烦 恼	却 被 新 诗 嫁 许 愁
柳 色 - 画 眉 - 年 羞 - 琵 琶 - 柳 色==燕 子 楼 边 柳 色 新	画 眉 人 去 镜 生 尘	来 年 羞 结 空 床 梦	闲 拨 琵 琶 过 一 春
兴 亡 - 舞 蝶 - 别 浦 - 高 山 - 兴 亡==吟 蛩 不 管 兴 亡 事	舞 蝶 那 分 梦 觉 身	别 浦 连 墙 归 远 客	高 山 小 径 过 樵 人
双 骨 - 日 新 - 人 不 - 今 古 - 双 骨==夷 齐 双 骨 已 成 尘	独 有 清 名 日 日 新	饿 死 沟 中 人 不 识	可 怜 今 古 几 何 人
野 花 - 桑 麻 - 垂 柳 - 个 个 - 野 花==两 日 山 寻 尽 野 花	今 晨 水 眺 如 桑 麻	春 风 娇 得 千 垂 柳	恰 限 身 才 个 个 斜
静 坐 - 寂 寥 - 西 风 - 寒 雁 - 静 坐==山 堂 静 坐 夜 无 言	寂 寂 寥 寥 本 自 然	何 事 西 风 动 林 野	一 声 寒 雁 唳 长 天
柳 色 - 桃 花 - 春 风 - 春 日 - 柳 色==草 色 青 青 柳 色 黄	桃 花 零 落 杏 花 香	春 风 不 解 吹 愁 却	春 日 偏 能 惹 恨 长
听 经 - 金 炉 - 春 雪 - 僧 床 - 听 经==听 经 看 画 绕 虚 廊	风 拂 金 炉 待 赐 香	丞 相 未 来 春 雪 密	暂 偷 闲 卧 老 僧 床
日 观 - 横 影 - 红 影 - 一 线 - 日 观==至 日 观 书 不 几 行	梅 梢 横 影 月 昏 黄	汉 家 红 影 无 人 见	未 必 曾 添 一 线 长
承 露 - 效 颦 - 一 水 - 冷 翠 - 承 露==蒲 茸 承 露 有 佳 色	茭 叶 束 烟 如 效 颦	盈 盈 一 水 不 得 渡	冷 翠 遗 香 愁 向 人
新 声 - 东 风 - 中 曲 - 一 曲 - 新 声==暗 将 罗 扇 递 新 声	巧 似 东 风 柳 树 莺	唱 彻 梨 园 谱 中 曲	内 中 一 曲 最 关 情
黄 昏 - 药 炉 - 花 落 - 寒 猿 - 黄 昏==到 此 黄 昏 飒 飒 风	岩 头 只 见 药 炉 空	不 堪 花 落 烟 飞 处	又 听 寒 猿 哭 晦 翁
青 精 - 碧 涧 - 两 腋 - 功 名 - 青 精==青 精 饭 熟 思 留 客	碧 涧 芹 香 可 厌 君	睡 起 茶 瓯 风 两 腋	功 名 何 啻 等 池 云
红 锦 - 花 枝 - 饮 酒 - 桃 花 - 楼 外==楼 外 桃 花 红 锦 披	当 花 把 酒 映 花 枝	慈 亲 饮 酒 看 儿 笑	记 摘 桃 花 洗 面 时
夜 半 - 龙 膏 - 一 点 - 花 开 - 夜 半==夜 半 兰 房 春 守 宫	龙 膏 香 浥 紫 金 筒	封 绡 一 点 春 无 已	几 度 花 开 不 减 红
西 风 - 梦 回 - 分 明 - 荷 花 - 西 风==一 夜 西 风 玉 凉 枕	梦 回 明 月 在 横 塘	分 明 记 得 相 逢 地	笑 隔 荷 花 唤 阿 郎
东 篱 - 惊 心 - 馨 香 - 银 瓶 - 黄 花==东 篱 九 日 富 黄 花	节 物 惊 心 祗 自 嗟	尽 日 馨 香 留 我 醉	银 瓶 索 酒 不 须 赊
霏 霏 - 恓 遑 - 随 阳 - 无 家 - 霏 霏==秋 风 飒 飒 雨 霏 霏	愁 杀 恓 遑 一 布 衣	辞 君 且 作 随 阳 鸟	海 内 无 家 何 处 归
开 门 - 气 自 - 天 籁 - 黄 昏 - 开 门==山 居 终 日 不 开 门	室 有 南 窗 气 自 温	人 籁 暂 休 天 籁 息	月 华 将 冷 照 黄 昏
明 月 - 菱 花 - 似 月 - 瑶 阶 - 明 月==昔 看 明 月 不 如 郎	同 照 菱 花 伴 晓 妆	别 后 郎 情 宁 似 月	瑶 阶 随 影 度 孤 房
学 语 - 未 全 - 到 老 - 人 事 - 学 语==少 时 学 语 苦 难 圆	只 道 工 夫 半 未 全	到 老 始 知 非 力 取	三 分 人 事 七 分 天
江 上 - 渡 江 - 江 东 - 是 愁 - 江 上==江 上 相 留 不 肯 留	渡 江 沿 岸 却 回 头	汉 江 东 去 人 西 去	不 见 高 城 始 是 愁
朵 朵 - 看 霓 - 风 情 - 太 常 - 桃 花==仙 苑 桃 花 朵 朵 香	曾 于 天 上 看 霓 裳	刘 郎 老 去 风 情 减	闲 把 音 容 问 太 常
雁 声 - 月 下 - 秋 风 - 千 里 - 水 村==雁 声 低 度 水 村 深	中 有 人 敲 月 下 门	满 屋 秋 风 灯 欲 暗	江 山 千 里 故 园 心
如 霜 - 酒 杯 - 西 风 - 清 商 - 如 水==甲 光 如 水 戟 如 霜	御 酒 杯 浮 菊 半 黄	东 日 西 风 满 天 仗	萧 韶 一 部 奏 清 商
雪 花 - 吟 诗 - 陇 头 - 寄 梅 - 雪 花==燕 山 雪 花 大 如 席	马 上 吟 诗 无 纸 笔	他 时 若 遇 陇 头 人	折 寄 梅 枝 须 一 一
清 溪 - 野 人 - 风 劲 - 枫 叶 - 一 带==一 带 清 溪 浅 洋 沙	松 桥 横 渡 野 人 家	平 林 尽 日 霜 风 劲	枫 叶 翻 丹 似 落 花
漫 漫 - 清 明 - 归 心 - 酒 家 - 漫 漫==漫 漫 村 塘 水 没 沙	清 明 初 过 已 无 花	春 寒 欲 雨 归 心 急	懒 住 扁 舟 问 酒 家
望 月 - 望 月 - 时 得 - 传 书 - 望 月==一 回 望 月 一 回 悲	望 月 月 移 人 不 移	何 时 得 见 汉 朝 使	为 妾 传 书 斩 画 师
仙 经 - 珍 重 - 春 光 - 百 花 - 不 易==陆 羽 仙 经 不 易 夸	诗 家 珍 重 寄 禅 家	松 恨 石 上 春 光 里	瀑 水 烹 来 斗 百 花
日 晶 - 将 归 - 黄 花 - 拂 衣 - 霜 日==霜 日 晶 荧 水 尚 肥	顺 风 一 舸 送 将 归	黄 花 笑 我 犹 寄 俗	得 似 渊 明 勇 拂 衣
别 离 - 送 春 - 归 去 - 垂 杨 - 别 离==作 恶 情 怀 是 别 离	老 夫 懒 作 送 春 诗	东 君 归 去 无 踪 迹	试 问 垂 杨 便 可 知
无 穷 - 斜 阳 - 无 心 - 游 蜂 - 无 穷==世 变 无 穷 客 恨 长	栏 干 遍 倚 怕 斜 阳	满 篱 黄 菊 无 心 看	付 与 游 蜂 自 在 忙
萧 萧 - 似 前 - 云 林 - 一 幅 - 萧 萧==行 李 萧 萧 担 一 肩	有 人 踪 迹 似 前 贤	倩 渠 摹 得 云 林 笔	一 幅 溪 藤 淡 墨 传
题 诗 - 日 上 - 松 阴 - 渡 水 - 题 诗==拾 叶 题 诗 愧 不 才	袖 遮 微 日 上 层 台	山 僧 分 我 松 阴 坐	隔 岸 花 香 渡 水 来
午 夜 - 看 月 - 归 去 - 天 霜 - 午 夜==双 成 午 夜 约 飞 玉	齐 驾 经 鸾 看 月 明	缥 缈 碧 云 归 去 晓	洞 天 霜 冷 玉 箫 清
青 青 - 离 恨 - 送 别 - 春 风 - 一 树==青 青 一 树 伤 心 色	曾 入 几 人 离 恨 中	为 近 都 门 多 送 别	长 条 折 尽 减 春 风
百 年 - 荒 烟 - 富 贵 - 人 争 - 百 年==水 秀 山 明 几 百 年	一 朝 城 市 化 荒 烟	朱 门 富 贵 已 如 此	犹 有 人 争 旧 墓 田
声 娇 - 何 处 - 寸 心 - 东 西 - 声 娇==歌 声 娇 带 晓 莺 啼	何 处 糟 糠 更 有 妻	脉 脉 寸 心 和 酒 闷	明 朝 还 恐 两 东 西
溪 边 - 不 种 - 红 莲 - 更 啜 - 溪 边==尽 日 溪 边 艇 子 斜	治 生 不 种 邵 平 瓜	已 分 邻 舍 红 莲 米	更 啜 僧 房 紫 笋 茶
日 月 - 青 鬓 - 流 年 - 溪 头 - 日 月==老 去 惟 思 日 月 迟	更 堪 青 鬓 总 成 丝	无 端 催 取 流 年 去	最 恨 溪 头 布 谷 儿
谪 仙 - 饮 酒 - 君 慨 - 尝 出 - 谪 仙==昔 日 曾 闻 李 谪 仙	饮 酒 一 斗 诗 百 篇	感 君 慨 赐 无 悭 吝	贫 衲 保 尝 出 口 涎
花 气 - 春 风 - 灞 桥 - 垂 杨 - 旌 旗==凤 城 花 气 浥 旌 旗	又 见 春 风 上 马 时	不 是 灞 桥 难 话 别	垂 杨 空 折 去 年 技
西 风 - 小 艇 - 酒 尽 - 烟 雨 - 啼 鸟==春 寒 啼 鸟 怯 西 风	小 艇 江 波 湿 雾 中	并 坐 短 蓬 樽 酒 尽	片 帆 烟 雨 到 城 东
春 风 - 楼 台 - 一 声 - 玉 栏 - 春 风==九 天 宫 阕 春 风 满	陆 地 楼 台 夜 月 寒	铁 笛 一 声 吹 雁 落	片 云 不 到 玉 栏 干
西 风 - 晚 云 - 屈 曲 - 稻 花 - 西 风==两 鬓 西 风 客 帽 斜	晚 云 横 岭 月 笼 沙	桑 畴 屈 曲 人 踪 绝	萤 火 飞 来 照 稻 花
新 荷 - 瑟 瑟 - 天 姿 - 水 深 - 新 荷==踏 溪 分 藕 养 新 荷	钿 盖 斜 临 瑟 瑟 波	自 是 天 姿 不 汙 著	水 深 泥 浊 奈 君 何
夜 飞 - 五 更 - 水 晶 - 独 坐 - 夜 飞==三 鼓 出 门 乌 夜 飞	五 更 还 家 星 宿 希	水 晶 楼 角 几 时 暖	独 坐 待 君 归 不 归
花 日 - 栩 栩 - 纷 纷 - 幽 人 - 花 日==落 尽 庭 花 日 未 西	枝 间 栩 栩 定 为 谁	遥 知 城 市 纷 纷 际	正 是 幽 人 睡 足 时
更 深 - 寒 生 - 枝 上 - 自 把 - 招 提==路 入 招 提 晚 更 深	万 山 秋 老 薄 寒 生	芙 容 枝 上 无 多 雨	自 把 孤 怀 滴 到 明
梅 花 - 飘 飘 - 无 力 - 黏 须 - 梅 花==吟 入 梅 花 倚 树 腰	不 知 声 撼 雪 飘 飘	山 翁 只 道 春 无 力	半 日 黏 须 未 肯 消
微 风 - 落 日 - 明 何 - 玉 人 - 微 风==微 风 吹 颊 酒 初 醒	落 日 舟 横 杜 若 汀	水 秀 山 明 何 所 似	玉 人 临 镜 晕 螺 青
芭 蕉 - 随 日 - 无 生 - 今 朝 - 芭 蕉==芭 蕉 无 耳 闻 雷 开	葵 华 无 眼 随 日 转	释 迦 老 子 亦 无 生	每 岁 今 朝 浴 一 遍
月 影 - 荡 漾 - 清 凉 - 小 桥 - 月 影==密 干 参 差 笼 月 影	轻 波 荡 漾 蘸 烟 条	暑 天 要 此 清 凉 地	欲 往 何 辞 度 小 桥
两 岸 - 雨 暗 - 荆 州 - 江 头 - 清 江==一 派 清 江 两 岸 平	湿 云 将 雨 暗 柴 荆	十 年 一 觉 荆 州 梦	通 济 江 头 沌 里 行
谈 天 - 青 青 - 步 占 - 江 湖 - 太 史==太 史 谈 天 术 转 灵	相 看 犹 自 眼 青 青	步 占 若 上 清 台 去	莫 说 江 湖 有 客 星
西 山 - 愁 容 - 动 地 - 车 马 - 爽 气==西 山 爽 气 不 谁 何	政 恐 愁 容 积 渐 多	动 地 边 声 入 河 珑	未 妨 车 马 断 经 过
秋 风 - 气 清 - 广 寒 - 含 情 - 秋 风==桂 枝 不 逐 秋 风 老	水 影 长 随 夜 气 清	曾 是 广 寒 宫 里 客	旧 游 重 访 更 含 情
一 叶 - 水 墨 - 寒 林 - 栖 乌 - 一 叶==树 无 一 叶 万 梢 枯	活 底 秋 江 水 墨 图	幸 自 寒 林 俱 淡 笔	却 将 浓 墨 点 栖 乌
云 母 - 迟 诗 - 梅 花 - 来 不 - 屏 风==云 母 屏 风 只 暂 依	金 乡 公 主 嫁 迟 诗	宁 论 鲍 照 梅 花 恨	不 及 从 来 不 惜 辞
辅 臣 - 麒 麟 - 如 画 - 云 台 - 辅 臣==妪 貌 何 妨 至 辅 臣	猴 形 亦 有 上 麒 麟	伏 波 眉 目 空 如 画	不 是 云 台 剑 佩 人
梅 花 - 茅 屋 - 好 景 - 无 语 - 梅 花==梅 花 雪 岸 去 舟 单	茅 屋 水 田 白 鹭 寒	好 景 几 回 吟 不 得	重 来 无 语 立 阑 干
短 长 - 竹 绝 - 秋 色 - 万 亩 - 短 长==三 向 稚 松 争 短 长	西 偏 老 竹 绝 炎 凉	千 寻 以 上 有 秋 色	万 亩 之 间 无 夕 阳
着 鞭 - 轻 烟 - 皇 景 - 近 前 - 着 鞭==晓 日 殷 勤 为 着 鞭	微 风 逐 旋 约 轻 烟	东 皇 景 胜 浑 如 旧	西 子 妆 浓 许 近 前
杲 杲 - 璞 玉 - 平 生 - 风 扫 - 杲 杲==太 孤 太 赊 日 杲 杲	璞 玉 浑 金 恶 种 草	无 负 平 生 雪 此 冤	不 如 一 阵 香 风 扫
似 秋 - 沙 鸥 - 矶 头 - 东 风 - 似 秋==离 离 双 鬓 似 秋 蓬	惯 逐 沙 鸥 与 断 鸿	漂 母 矶 头 春 水 阔	扁 舟 何 处 系 东 风
浩 浩 - 水 远 - 人 不 - 若 自 - 春 风==春 风 浩 浩 水 横 波	水 远 滩 长 可 奈 何	送 尽 碧 云 人 不 见	折 兰 采 若 自 行 歌
幻 差 - 焚 香 - 衰 草 - 洛 阳 - 来 过==梦 眼 由 来 过 幻 差	焚 香 祗 好 诵 南 华	云 深 汉 殿 犹 衰 草	风 贤 洛 阳 无 旧 花
走 马 - 零 落 - 天 低 - 梨 花 - 走 马==走 马 寻 春 西 复 东	夭 桃 零 落 委 残 红	可 怜 日 暮 天 低 处	但 有 梨 花 弄 晚 风
游 鱼 - 游 鱼 - 人 稀 - 金 钩 - 游 鱼==一 寒 游 鱼 不 可 见	春 暖 游 鱼 初 见 面	渊 清 人 稀 鱼 可 游	劝 鱼 切 勿 亲 金 钩
君 子 - 未 足 - 叫 月 - 平 原 - 君 子==西 征 君 子 化 为 猿	似 觉 獐 头 未 足 伦	叫 月 三 声 万 松 外	可 能 浅 草 走 平 原
风 和 - 金 钿 - 笑 语 - 轻 盈 - 风 和==好 是 风 和 景 物 妍	野 花 盘 髻 胜 金 钿	乍 闻 笑 语 来 天 半	番 女 轻 盈 戏 渺 绵
屐 齿 - 柴 门 - 篱 菊 - 木 落 - 屐 齿==屐 齿 休 令 破 紫 苔	柴 门 无 客 不 须 开	雨 余 篱 菊 埋 光 去	木 落 前 山 献 体 来
着 物 - 花 梢 - 春 思 - 一 枝 - 无 私==东 风 着 物 本 无 私	红 入 花 梢 特 地 奇	想 得 霜 台 春 思 满	一 枝 聊 遣 博 新 诗
腊 后 - 霜 欺 - 枝 上 - 新 年 - 腊 后==萧 条 腊 后 复 春 前	雪 压 霜 欺 未 放 妍	昨 日 倚 栏 枝 上 看	似 留 芳 意 入 新 年
玉 宇 - 浮 图 - 今 宵 - 瑶 台 - 玉 宇==湖 迥 山 明 玉 宇 澄	浮 图 绝 顶 快 高 登	天 负 吹 我 今 宵 梦	多 在 瑶 台 十 二 层
岭 上 - 远 山 - 茅 檐 - 水 生 - 烟 云==岭 上 烟 云 作 伴 行	远 山 凝 绿 向 谁 横	醉 来 睡 足 茅 檐 雨	三 十 六 滩 春 水 生
竹 窗 - 衡 阳 - 落 日 - 松 风 - 竹 窗==诗 困 权 时 卧 竹 窗	梦 闲 随 雁 到 衡 阳	觉 来 落 日 窥 帘 影	茶 鼎 松 风 泼 鼻 香
江 水 - 月 色 - 六 宫 - 照 山 - 江 水==章 华 台 前 楚 江 水	月 色 堕 烟 乌 欲 起	六 宫 不 敢 解 罗 衣	猎 火 照 山 君 未 归
西 湖 - 芳 草 - 宝 陀 - 慰 伏 - 西 湖==钱 唐 西 湖 三 百 寺	芳 草 画 桥 烟 霭 中	宝 陀 大 士 本 无 相	一 亭 聊 慰 伏 蛇 功
擎 雨 - 傲 霜 - 一 年 - 黄 橘 - 擎 雨==荷 尽 已 无 擎 雨 盖	菊 残 犹 有 傲 霜 枝	一 年 好 景 君 须 记	正 是 橙 黄 橘 绿 时
花 开 - 浅 绿 - 结 子 - 筇 竹 - 深 红==春 花 开 尽 见 深 红	夏 叶 始 繁 明 浅 绿	只 知 结 子 熟 秋 霖	不 识 来 时 有 筇 竹
如 云 - 流 水 - 盘 石 - 松 花 - 如 云==二 天 封 部 稼 如 云	流 水 清 寒 出 洞 门	更 爱 林 间 盘 石 上	松 花 飘 落 羽 人 樽
石 磴 - 流 水 - 无 人 - 五 里 - 石 磴==路 绕 山 根 石 磴 斜	小 桥 流 水 树 交 加	柴 门 半 掩 无 人 到	五 里 牌 边 三 四 家
归 来 - 知 得 - 稚 子 - 刺 绣 - 归 来==战 罢 归 来 朋 再 盈	悬 知 得 失 击 心 旌	应 门 稚 子 占 蛛 信	刺 绣 佳 人 听 鹊 声
重 阳 - 宾 朋 - 边 新 - 可 人 - 重 阳==别 来 五 度 见 重 阳	草 草 宾 朋 共 此 觞	听 得 酒 边 新 句 子	可 人 负 味 故 难 忘
新 岁 - 破 腊 - 花 枝 - 轻 寒 - 新 岁==故 岁 犹 长 新 岁 晚	东 君 破 腊 便 回 春	花 枝 稍 稍 暗 红 上	已 觉 轻 寒 不 著 人
照 水 - 泽 国 - 朱 颜 - 昨 夜 - 枝 枝==照 水 枝 枝 蜀 锦 囊	年 年 泽 国 为 谁 芳	朱 颜 自 得 西 风 意	不 管 清 秋 昨 夜 霜
芙 蓉 - 水 边 - 风 流 - 一 缕 - 芙 蓉==映 水 芙 蓉 簇 绛 霞	水 边 开 宴 坐 临 花	秋 娘 老 去 风 流 尽	系 臂 犹 悬 一 缕 纱
一 径 - 出 城 - 无 力 - 春 风 - 一 径==带 水 依 城 一 径 微	出 城 桃 杏 雨 来 枝	最 怜 杨 柳 身 无 力	付 与 春 风 自 在 吹
宫 莺 - 千 牛 - 龙 尾 - 临 轩 - 宫 莺==花 里 宫 莺 晓 未 啼	千 牛 仗 下 报 班 齐	银 袍 五 百 趋 龙 尾	天 子 临 轩 赐 御 题
江 边 - 沙 平 - 眠 渠 - 消 多 - 江 边==江 边 犊 子 喜 新 晴	草 软 沙 平 满 意 春	自 食 自 眠 渠 自 乐	不 消 多 费 牧 牛 人
狂 风 - 酒 尽 - 沧 海 - 白 头 - 狂 风==十 日 狂 风 桃 柳 休	常 因 酒 尽 觉 春 愁	泰 山 为 肉 酿 沧 海	料 得 人 昌 无 白 头
朱 甍 - 花 舫 - 第 宅 - 芳 菲 - 碧 瓦==朱 甍 碧 瓦 粉 墙 围	花 舫 回 光 洞 户 辉	自 是 故 家 开 第 宅	乔 林 景 物 两 芳 菲
压 柳 - 杖 藜 - 伐 木 - 绵 蛮 - 压 柳==湖 边 春 压 柳 丝 低	云 淡 风 轻 一 杖 藜	伐 木 诗 亡 交 道 绝	绵 蛮 宽 为 尽 情 啼
盈 盈 - 风 雨 - 微 酸 - 幽 恨 - 盈 盈==残 梅 昨 日 尚 盈 盈	一 夜 溪 桥 风 雨 声	不 是 微 酸 注 香 蒂	个 中 幽 恨 即 验 平
轻 生 - 利 名 - 青 史 - 分 明 - 轻 生==几 多 砺 节 与 轻 生	犹 有 丝 毫 在 利 名	青 史 千 年 惟 豫 子	诚 心 大 义 最 分 明
乘 兴 - 白 云 - 仙 子 - 新 诗 - 乘 兴==乘 兴 来 寻 杜 使 君	乱 山 矗 矗 白 云 深	武 夷 仙 子 能 知 已	谩 写 新 诗 诉 此 心
桥 下 - 夕 照 - 来 往 - 西 风 - 潺 湲==灞 陵 桥 下 水 潺 湲	人 影 离 披 夕 照 间	来 往 总 怜 车 马 好	西 风 破 帽 独 南 还
荔 枝 - 今 岁 - 青 青 - 日 照 - 荔 枝==去 年 一 笑 荔 枝 园	今 岁 重 来 是 墓 门	纵 有 青 青 旧 时 树	已 看 斜 日 照 黄 昏
森 罗 - 四 时 - 无 语 - 见 毗 - 森 罗==万 象 森 罗 具 一 尘	小 庵 花 木 四 时 春	客 来 相 对 默 无 语	亲 见 毗 耶 彼 上 人
流 泉 - 田 头 - 春 来 - 犁 锄 - 流 泉==竹 外 流 泉 绕 屋 鸣	田 头 有 水 不 忧 晴	春 来 岂 问 芳 菲 事	只 办 犁 锄 要 早 耕
在 天 - 风 摧 - 有 迹 - 明 月 - 在 天==祖 师 坟 塔 在 天 台	雨 坏 风 摧 事 可 哀	香 火 无 人 空 有 迹	夜 深 明 月 照 苍 苔
云 锦 - 酒 家 - 狂 夫 - 琵 琶 - 云 锦==千 株 云 锦 照 江 沙	沙 上 青 旗 卖 酒 家	莫 怪 狂 夫 狂 得 彻	吴 姬 玉 手 好 琵 琶
东 西 - 金 钱 - 落 帽 - 搜 诗 - 东 西==对 花 懒 举 玉 东 西	孤 负 金 钱 满 绿 枝	短 发 不 堪 重 落 帽	枯 肠 何 可 强 搜 诗
青 山 - 大 河 - 熙 春 - 望 宋 - 一 片==落 日 青 山 一 片 愁	大 河 东 注 不 还 流	若 为 长 得 熙 春 在	时 上 高 层 望 宋 州
扁 舟 - 对 此 - 佳 句 - 留 诗 - 扁 舟==扁 舟 斗 转 急 如 飞	对 此 令 人 忆 退 之	不 但 郴 江 有 佳 句	叉 鱼 祷 雨 尽 留 诗
五 更 - 千 门 - 舞 袖 - 秋 风 - 五 更==五 更 先 起 玉 阶 东	渐 入 千 门 万 户 中	总 向 高 楼 吹 舞 袖	秋 风 还 不 及 春 风
北 风 - 蛾 眉 - 蟠 桃 - 江 南 - 北 风==北 风 吹 我 上 金 台	忍 见 蛾 眉 堕 马 嵬	宴 罢 蟠 桃 王 母 去	江 南 肠 断 贺 方 回
尘 埃 - 风 月 - 碧 树 - 红 莲 - 两 岸==两 岸 尘 埃 终 不 到	四 檐 风 月 冷 无 声	路 从 碧 树 阴 中 断	人 向 红 莲 影 里 行
旧 游 - 陌 上 - 片 帆 - 风 流 - 旧 游==旧 游 回 首 意 苍 凉	负 尔 花 间 陌 上 香	好 着 片 帆 重 送 我	风 流 苏 小 访 钱 塘
南 北 - 骑 马 - 风 月 - 门 前 - 南 北==南 北 东 西 老 赵 州	见 人 骑 马 也 骑 牛	清 风 月 下 寻 归 路	夫 子 门 前 问 孔 丘
衡 门 - 归 时 - 寒 食 - 霏 霏 - 衡 门==衡 门 一 别 梦 难 稀	人 欲 归 时 不 得 归	长 忆 去 年 寒 食 夜	杏 花 零 落 雨 霏 霏
春 色 - 枝 枝 - 何 处 - 故 园 - 春 色==湖 边 春 色 十 分 深	恨 满 枝 枝 被 雨 淋	羌 笛 一 声 何 处 曲	等 闲 惊 起 故 园 心
光 寒 - 分 明 - 九 重 - 卷 帘 - 月 光==玉 天 无 滓 月 光 寒	霁 色 分 明 在 露 盘	一 夜 九 重 全 不 寐	时 教 中 使 卷 帘 看
重 阳 - 潇 潇 - 登 高 - 篱 菊 - 重 阳==去 去 重 阳 越 夕 间	潇 潇 风 雨 作 轻 寒	心 知 又 负 登 高 兴	篱 菊 留 来 过 后 看
曲 槛 - 红 雪 - 春 来 - 买 笑 - 曲 槛==暖 映 垂 杨 曲 槛 边	一 堆 红 雪 罩 轻 烟	春 来 自 得 风 流 伴	榆 荚 休 抛 买 笑 钱
老 树 - 山 村 - 竹 边 - 造 化 - 老 树==老 树 生 苔 冻 欲 枯	山 村 雪 意 晚 模 糊	一 梢 横 打 竹 边 过	造 化 工 成 水 墨 图
思 归 - 故 乡 - 何 事 - 空 山 - 思 归==君 若 思 归 可 便 归	故 乡 只 在 锦 江 西	不 知 何 事 留 君 住	却 向 空 山 日 夜 啼
待 船 - 梅 花 - 清 绝 - 江 南 - 待 船==待 船 聊 复 驻 征 骖	手 撚 梅 花 望 翠 岚	花 似 若 人 清 绝 俗	故 从 江 北 寄 江 南
鸭 绿 - 芙 蓉 - 日 长 - 天 魔 - 鸭 绿==鸭 绿 微 生 太 液 波	芙 蓉 杨 柳 受 风 多	日 长 供 奉 传 新 谱	教 舞 天 魔 队 子 歌
黄 金 - 年 年 - 乌 飞 - 泰 山 - 金 日==黄 金 日 日 销 还 铸	仙 桂 年 年 折 又 生	兔 走 乌 飞 如 未 息	路 尘 终 见 泰 山 平
北 斗 - 逐 月 - 一 声 - 万 里 - 低 垂==北 斗 低 垂 挂 戍 楼	黄 河 不 逐 月 西 流	一 声 长 笛 冲 沙 起	散 作 边 人 万 里 愁
拂 水 - 细 腰 - 无 人 - 东 风 - 长 条==津 亭 拂 水 最 长 条	折 赠 夫 君 挽 细 腰	如 今 花 落 无 人 管	闲 逐 东 风 过 六 桥
第 一 - 青 楼 - 多 情 - 芙 蓉 - 第 一==歌 舞 当 年 第 一 流	姓 名 赢 得 满 青 楼	多 情 未 了 身 先 死	化 作 芙 蓉 也 并 头
秋 霜 - 低 飞 - 游 蜂 - 百 花 - 秋 霜==轻 绡 剪 翅 约 秋 霜	点 水 低 飞 恋 野 塘	忽 趁 游 蜂 过 墙 去	可 怜 不 识 百 花 香
喜 气 - 白 云 - 金 带 - 草 堂 - 喜 气==今 春 喜 气 满 乾 坤	应 有 蒲 轮 辗 白 云	恩 与 内 分 金 带 赤	草 堂 焉 敢 更 移 文
风 流 - 天 涯 - 文 章 - 天 边 - 风 流==才 子 风 流 是 当 家	曾 传 旧 语 到 天 涯	文 章 烂 漫 铺 江 锦	合 向 天 边 弄 彩 霞
目 晴 - 诗 情 - 落 花 - 啼 鸟 - 晴 峦==满 目 晴 峦 总 是 诗	诗 情 飞 絮 逐 游 丝	雨 肥 碧 涧 落 花 水	风 瘦 青 松 啼 鸟 枝
傍 水 - 紫 霄 - 阑 干 - 大 江 - 傍 水==画 堂 清 傍 水 南 桥	烟 气 如 炊 掩 紫 霄	十 二 阑 干 成 独 倚	橹 声 风 隔 大 江 遥
路 长 - 思 乡 - 烟 霞 - 数 树 - 路 长==孤 戍 迢 迢 蜀 路 长	鸟 鸣 山 馆 客 思 乡	更 看 绝 顶 烟 霞 外	数 树 岩 花 照 夕 阳
杨 柳 - 离 恨 - 春 愁 - 兰 舟 - 杨 柳==莫 折 阊 门 杨 柳 夷	带 将 离 恨 过 枫 桥	向 道 春 愁 不 禁 荡	兰 舟 长 放 橹 轻 摇
箨 龙 - 席 珍 - 春 睡 - 上 更 - 箨 龙==箨 龙 本 是 飞 天 物	养 鳖 宜 充 照 席 珍	一 饭 午 窗 春 睡 起	羲 皇 而 上 更 何 人
日 落 - 声 频 - 江 亭 - 偏 感 - 噪 柳==日 落 秋 蝉 噪 柳 津	为 伤 风 露 烟 声 频	送 晴 送 雨 江 亭 外	偏 感 舟 行 晚 泊 人
玉 墀 - 节 又 - 今 朝 - 万 里 - 玉 墀==同 事 先 皇 立 玉 墀	中 和 旧 节 又 支 离	今 朝 各 自 看 花 处	万 里 遥 知 掩 泪 时
管 弦 - 楼 上 - 皇 侧 - 黄 卷 - 管 弦==清 赏 堂 中 无 管 弦	凤 山 楼 上 有 云 烟	储 皇 侧 畔 何 人 侍	黄 卷 团 栾 是 圣 贤
风 帆 - 远 岸 - 肠 断 - 无 人 - 风 帆==水 树 风 帆 隐 伎 楼	微 明 远 岸 浊 河 流	也 知 一 望 堪 肠 断	暮 雨 无 人 在 上 头
老 去 - 风 清 - 儿 童 - 山 家 - 将 携==老 去 将 携 只 要 轻	况 临 炎 暑 绕 风 清	儿 童 爱 把 承 帘 溜	未 识 山 家 质 素 情
萧 疏 - 山 骨 - 如 铁 - 拍 岸 - 萧 疏==瘦 草 萧 疏 已 似 秋	盘 陀 山 骨 束 江 流	两 崖 若 不 顽 如 铁	争 得 狂 澜 拍 岸 休
文 章 - 风 骚 - 君 子 - 诗 人 - 文 章==古 来 一 代 文 章 事	自 有 风 骚 翰 墨 臣	今 日 苏 门 四 君 子	异 时 邺 下 七 诗 人
江 水 - 月 华 - 黄 叶 - 纷 纷 - 江 水==九 月 湘 江 水 漫 流	沙 边 唯 览 月 华 秋	金 风 浦 上 吹 黄 叶	一 夜 纷 纷 满 客 舟
轩 窗 - 白 日 - 昆 仑 - 青 鸟 - 烟 霞==轩 窗 缥 缈 起 烟 霞	诵 诀 存 思 白 日 斜	闻 道 昆 仑 有 仙 籍	何 时 青 鸟 送 丹 砂
倚 天 - 横 空 - 火 云 - 玲 珑 - 倚 天==背 倚 天 峰 涌 化 宫	横 空 阁 道 拖 双 虹	火 云 六 月 应 奇 绝	青 琐 玲 珑 八 面 风
条 桑 - 半 红 - 知 时 - 捣 衣 - 条 桑==条 桑 初 绿 即 为 别	柿 叶 半 红 犹 未 归	不 如 村 妇 知 时 节	解 为 田 夫 秋 捣 衣
云 山 - 青 山 - 南 北 - 东 西 - 云 山==齐 云 山 与 壁 云 齐	四 顾 青 山 座 座 低	隔 继 往 来 南 北 雁	只 容 日 月 过 东 西
照 眼 - 角 黍 - 秋 晚 - 空 想 - 照 眼==萱 草 榴 花 照 眼 明	水 团 角 黍 满 盘 清	文 殊 问 疾 移 秋 晚	空 想 敲 门 剥 啄 声
潇 潇 - 小 小 - 阑 干 - 一 声 - 潇 潇==西 风 飒 飒 雨 潇 潇	小 小 人 家 短 短 桥	独 倚 阑 干 数 鹅 匹	一 声 孤 雁 在 云 霄
残 花 - 梅 开 - 风 日 - 新 诗 - 残 花==卧 云 庄 上 残 花 笑	香 似 早 梅 开 不 迟	浅 色 春 衫 弄 风 日	遣 来 当 为 作 新 诗
蒲 团 - 林 下 - 一 笑 - 虎 溪 - 蒲 团==蒲 团 出 定 入 玄 微	尽 是 山 间 林 下 诗	安 得 远 公 陪 一 笑	朗 吟 同 过 虎 溪 时
酒 泉 - 击 鼓 - 一 曲 - 座 上 - 剑 舞==酒 泉 太 守 能 剑 舞	高 堂 置 酒 夜 击 鼓	胡 笳 一 曲 断 人 肠	座 上 相 看 泪 如 雨
鸭 绿 - 山 色 - 云 林 - 低 垂 - 鸭 绿==风 皱 波 纹 含 鸭 绿	雨 添 山 色 拥 螺 青	个 中 颇 具 云 林 派	嘉 木 低 垂 一 草 亭
年 光 - 花 开 - 聪 明 - 西 风 - 年 光==依 依 节 物 旧 年 光	人 去 花 开 益 可 伤	圣 主 聪 明 无 色 惑	不 须 西 风 返 魂 香
水 云 - 梅 影 - 欹 枕 - 烟 雨 - 水 云==景 阳 未 下 水 云 乡	梅 影 摇 寒 月 一 处	欹 枕 梦 能 归 故 隐	满 帆 烟 雨 渡 涛 江
篮 舆 - 欲 粘 - 云 压 - 此 时 - 篮 舆==篮 舆 风 紧 揭 心 帘	雨 著 春 衣 润 欲 粘	满 眼 阴 云 压 平 野	此 时 怀 抱 恶 憎 恶
雾 重 - 功 名 - 三 更 - 铁 马 - 雾 重==斗 帐 重 茵 香 雾 重	膏 粱 那 可 共 功 名	三 更 骑 报 河 冰 合	铁 马 何 人 从 我 行
披 风 - 织 女 - 判 知 - 携 手 - 披 风==披 风 听 鸟 长 河 路	临 津 织 女 遥 相 妒	判 知 秋 夕 带 啼 还	那 及 春 朝 携 手 度
落 花 - 茅 斋 - 春 酒 - 客 中 - 风 急==落 花 风 急 野 无 舟	喜 为 茅 斋 几 日 留	却 愧 江 边 春 酒 薄	不 能 慰 子 客 中 愁
阴 灵 - 参 差 - 沧 江 - 万 丈 - 阴 灵==怪 秘 阴 灵 与 护 持	重 丹 复 碧 焕 参 差	沧 江 见 底 应 无 日	万 丈 孤 根 世 不 知
宿 草 - 青 青 - 催 花 - 烧 痕 - 宿 草==暖 气 先 回 宿 草 根	青 青 行 可 藉 芳 尊	耒 须 着 意 催 花 格	且 为 乾 坤 补 烧 痕
洞 庭 - 孤 峰 - 神 仙 - 悠 悠 - 洞 庭==巴 陵 一 望 洞 庭 秋	日 见 孤 峰 水 上 浮	闻 道 神 仙 不 可 接	心 随 湖 水 共 悠 悠
阳 和 - 孤 根 - 年 年 - 酒 樽 - 一 点==不 受 阳 和 一 点 恩	不 嫌 青 女 到 孤 根	年 年 岁 岁 花 相 似	谁 为 陶 潜 买 酒 樽
避 寒 - 远 山 - 行 客 - 双 双 - 避 寒==避 寒 来 热 稻 梁 肥	水 远 山 长 结 伴 稀	已 是 江 湖 远 行 客	双 双 犹 是 同 南 飞
太 液 - 年 年 - 含 仁 - 一 笑 - 数 树==太 液 池 边 数 树 红	年 年 先 得 占 春 风	那 知 万 物 含 仁 义	都 在 君 王 一 笑 中
玉 珂 - 梅 含 - 道 人 - 作 诗 - 玉 珂==冰 散 玉 珂 微 弄 暖	梅 含 金 粉 巧 矜 新	道 人 不 管 年 光 逝	贪 作 诗 章 等 待 人
炉 火 - 风 惊 - 上 方 - 松 声 - 炉 火==地 炉 火 暖 壁 灯 青	虚 阁 风 惊 铎 乱 鸣	门 掩 上 方 山 月 黑	北 窗 危 坐 听 松 声
落 落 - 知 君 - 下 通 - 皎 洁 - 明 珠==落 落 明 珠 骇 暗 投	知 君 所 得 在 无 求	直 须 言 下 通 非 句	识 取 澄 潭 皎 洁 秋
扁 舟 - 仙 游 - 水 石 - 江 山 - 扁 舟==将 从 三 峡 泛 扁 舟	先 向 仙 游 寺 里 游	水 石 却 惊 偏 怪 异	江 山 狂 兴 一 时 休
开 尊 - 理 棹 - 躬 耕 - 高 卧 - 尊 且==开 尊 且 醉 圣 贤 酒	理 棹 时 乘 旦 暮 风	懒 为 躬 耕 咏 梁 甫	敢 将 高 卧 敌 隆 中
丹 凤 - 崎 岖 - 宫 阙 - 南 来 - 丹 凤==丹 凤 楼 头 语 未 终	崎 岖 蜀 道 复 相 逢	太 清 宫 阙 俱 煨 烬	岂 亦 南 来 避 贼 锋
蟾 影 - 一 壶 - 琼 田 - 瑶 台 - 白 玉==蟾 影 寒 升 白 玉 京	浩 然 天 地 一 壶 冰	瘦 筇 肯 倚 琼 田 立	应 念 瑶 台 十 二 层
沿 河 - 杨 柳 - 花 谢 - 天 涯 - 沿 河==京 口 沿 河 卖 酒 家	东 边 杨 柳 北 边 花	柳 摇 花 谢 人 分 散	一 向 天 涯 一 海 涯
柳 暗 - 快 阁 - 南 山 - 暮 云 - 柳 暗==柳 暗 知 津 君 送 我	江 临 快 阁 我 辞 君	君 行 过 我 南 山 塔	为 道 长 怀 日 暮 云
乞 食 - 尘 土 - 东 城 - 泉 声 - 乞 食==能 入 城 中 乞 食 否	莫 辞 尘 土 污 袈 裟	欲 知 住 处 东 城 下	绕 竹 泉 声 是 白 家
牢 盆 - 用 儒 - 草 木 - 一 人 - 牢 盆==通 泰 牢 盆 亘 海 滨	宅 家 专 欲 用 儒 臣	淮 南 草 木 生 颜 色	又 见 龙 头 第 一 人
行 脚 - 无 心 - 竹 窗 - 烟 凝 - 归 来==病 僧 行 脚 归 来 后	万 事 无 心 每 闭 寮	日 射 竹 窗 风 叶 乱	烟 凝 香 鼎 篆 纹 消
堂 堂 - 涉 织 - 照 水 - 花 香 - 堂 堂==堂 堂 日 用 妙 无 痕	才 涉 织 毫 即 是 尘	照 水 银 蟾 沉 夜 魄	恋 花 香 蝶 醉 芳 魂
风 惊 - 日 月 - 笑 语 - 马 头 - 貂 裘==紫 貂 裘 暖 朔 风 惊	潢 水 冰 光 射 日 月	笑 语 同 来 向 公 子	马 头 今 日 向 南 行
佳 声 - 无 尘 - 荔 枝 - 嚼 冰 - 佳 声==微 风 猎 树 有 佳 声	一 榻 无 尘 户 牖 明	已 擘 荔 枝 怜 玉 破	更 开 瓜 碧 嚼 冰 清
墨 云 - 出 途 - 横 陈 - 浊 酒 - 墨 云==墨 云 筛 雨 密 还 疏	欲 出 途 泥 恐 溅 裾	恶 况 横 陈 费 料 理	枯 棋 浊 酒 有 驱 除
江 干 - 一 日 - 生 事 - 晚 菘 - 草 村==林 塘 草 村 接 江 干	一 日 三 回 涉 圃 看	柴 户 反 关 生 事 了	晚 菘 种 尽 雨 漫 漫
长 竿 - 新 诗 - 如 镜 - 渔 人 - 长 竿==抛 却 长 竿 卷 却 丝	手 携 蓑 笠 献 新 诗	果 然 月 照 池 如 镜	不 是 渔 人 下 钓 时
金 波 - 征 鸿 - 夜 深 - 千 岩 - 金 波==潋 滟 金 波 泻 碧 空	隔 霜 寒 影 下 征 鸿	夜 深 一 笛 昭 华 引	吹 满 千 岩 万 壑 中
蔷 薇 - 新 茶 - 低 头 - 残 花 - 蔷 薇==生 危 蔷 薇 插 鬓 斜	闲 随 女 伴 摘 新 茶	回 头 见 客 低 头 笑	却 拾 残 花 帖 面 花
渺 渺 - 怪 石 - 夕 阳 - 千 株 - 春 水==晴 川 渺 渺 停 春 水	怪 石 峨 峨 插 乱 山	最 爱 夕 阳 烟 寺 里	千 株 古 木 伴 僧 闲
树 色 - 明 月 - 寂 寞 - 涕 忆 - 树 色==西 陵 树 色 暮 苍 苍	明 月 相 将 入 御 床	寂 寞 帐 前 歌 舞 歇	几 人 含 涕 忆 君 王
孤 标 - 间 浪 - 清 高 - 山 顶 - 孤 标==雪 立 孤 标 不 受 霾	世 间 浪 蕊 等 浮 埃	清 高 已 是 无 俦 伍	更 向 群 山 顶 上 开
碧 山 - 爽 气 - 斗 大 - 许 多 - 散 步==扶 筇 散 步 碧 山 游	万 壑 千 岩 爽 气 浮	一 个 茅 荠 如 斗 大	如 何 容 得 许 多 秋
凤 阙 - 鳌 头 - 玉 堂 - 润 笔 - 凤 阙==座 主 登 庸 归 凤 阙	门 生 批 诏 立 鳌 头	玉 堂 旧 阁 多 珍 玩	可 作 西 斋 润 笔 不
银 钩 - 红 袂 - 云 脚 - 斜 日 - 银 钩==青 笺 擘 处 银 钩 断	红 袂 分 时 五 箸 悬	云 脚 渐 收 风 色 紧	半 规 斜 日 射 归 船
鸾 飞 - 凤 衔 - 千 门 - 星 回 - 合 欢==青 鸾 飞 入 合 欢 宫	紫 凤 衔 花 出 禁 中	可 怜 今 夜 千 门 里	银 汉 星 回 一 道 通
悠 悠 - 金 铃 - 绿 衣 - 万 岁 - 秦 云==秦 云 越 树 路 悠 悠	锁 掣 金 铃 百 怨 休	中 有 能 言 绿 衣 鸟	还 呼 万 岁 一 回 头
两 川 - 骈 阗 - 春 风 - 绮 罗 - 两 川==从 昔 遨 游 盛 两 川	充 城 人 物 自 骈 阗	万 家 灯 火 春 风 陌	十 里 绮 罗 明 月 天
风 吹 - 青 山 - 霜 林 - 白 云 - 风 吹==天 风 吹 我 落 人 间	暂 入 青 山 又 促 还	待 得 霜 林 收 柿 栗	却 来 重 扣 白 云 关
种 竹 - 潺 潺 - 春 雨 - 过 花 - 种 竹==海 棠 初 种 竹 新 移	流 水 潺 潺 入 小 池	春 雨 乍 晴 风 日 好	一 声 啼 鸟 过 花 枝
卷 地 - 黄 叶 - 青 青 - 梅 花 - 卷 地==卷 地 西 内 促 雨 来	扫 除 黄 叶 满 苍 苔	垂 杨 蚤 有 青 青 眠	只 碍 梅 花 未 敢 开
梵 宫 - 粥 鱼 - 衲 僧 - 曹 溪 - 梵 宫==灵 寿 山 前 古 梵 宫	粥 鱼 斋 鼓 白 云 中	衲 僧 若 会 蒙 泉 意	竟 与 曹 溪 一 径 通
金 门 - 园 中 - 暖 律 - 探 春 - 舒 柳==涌 金 门 外 风 舒 柳	师 子 园 中 日 放 花	何 事 东 皇 催 暖 律	似 迎 西 母 探 春 车
盈 尺 - 山 田 - 灯 火 - 处 处 - 盈 尺==腊 中 平 地 雪 盈 尺	嵩 隗 山 田 麦 尚 乾	不 管 上 元 灯 火 夜	飞 花 处 处 作 春 寒
酿 酒 - 云 外 - 一 长 - 洛 阳 - 酿 酒==松 肪 酿 酒 石 根 醉	槲 叶 作 衣 云 外 行	指 点 人 间 一 长 叹	秋 风 又 到 洛 阳 城
人 情 - 波 浪 - 山 川 - 泉 无 - 可 畏==可 畏 人 情 与 世 途	险 如 波 浪 起 江 湖	岂 知 荆 楚 山 川 地	坎 井 泓 泉 无 处 无
细 腰 - 妖 娆 - 作 杨 - 万 条 - 蜀 国==蜀 国 佳 人 号 细 腰	东 台 御 史 惜 妖 娆	从 今 唤 作 杨 台 柳	舞 尽 春 风 万 万 条
晴 虹 - 千 顷 - 风 月 - 酒 家 - 晴 虹==八 十 丈 晴 虹 卧 影	一 千 顷 碧 玉 无 瑕	几 多 风 月 输 诗 客	无 限 苇 芦 属 酒 家
腊 日 - 僧 窗 - 思 归 - 道 人 - 腊 日==去 年 腊 日 访 孤 山	曾 借 僧 窗 半 日 闲	不 为 思 归 对 妻 子	道 人 有 约 径 须 还
青 山 - 别 离 - 烟 波 - 扁 舟 - 蛾 眉==青 山 是 处 锁 蛾 眉	日 日 湖 边 有 别 离	却 怪 烟 波 三 万 顷	扁 舟 只 许 载 西 施
落 日 - 云 敛 - 倚 阑 - 第 一 - 落 日==落 日 衔 山 山 更 青	间 云 敛 尽 绿 烟 横	危 亭 独 倚 阑 干 遍	又 听 疏 钟 第 一 声
梅 花 - 清 香 - 风 露 - 知 人 - 梅 花==我 爱 梅 花 不 忍 摘	清 香 却 解 逐 人 来	风 露 肌 肤 随 处 好	不 知 人 世 有 尘 埃
乳 燕 - 淡 云 - 无 人 - 一 年 - 乳 燕==乳 燕 啼 鸠 三 月 暮	淡 云 疏 雨 午 时 天	金 雀 花 落 无 人 管	断 送 韶 光 又 一 年
玉 壶 - 一 杯 - 冠 盖 - 必 办 - 徘 徊==玉 壶 亭 上 小 徘 徊	闲 对 残 荷 把 一 杯	冠 盖 交 驰 期 会 急	长 官 未 必 办 频 来
无 心 - 懒 从 - 半 生 - 耕 云 - 无 心==无 心 检 点 笔 头 春	疏 懒 从 教 到 十 分	留 取 半 生 挥 翰 手	崖 前 无 事 学 耕 云
中 秋 - 访 南 - 知 归 - 烟 霞 - 中 秋==中 秋 天 气 随 宜 好	来 访 南 园 会 隐 家	贪 饮 不 知 归 去 晚	水 精 宫 里 宿 烟 霞
赤 脚 - 沉 迷 - 公 卿 - 长 生 - 赤 脚==赤 脚 蓬 头 古 观 旁	沉 迷 人 海 意 茫 茫	公 卿 见 了 无 奇 特	更 说 长 生 别 有 方
三 尺 - 文 章 - 凌 云 - 几 行 - 携 手==携 手 童 乌 三 尺 强	已 知 经 术 胜 文 章	可 怜 不 见 凌 云 日	迸 洒 西 风 泪 几 行
散 漫 - 万 象 - 独 上 - 在 东 - 散 漫==清 霜 散 漫 似 轻 岚	玉 阙 参 差 万 象 涵	独 上 秦 台 最 高 处	旧 山 依 约 在 东 南
陈 迹 - 苍 藤 - 说 精 - 归 艎 - 陈 迹==追 思 陈 迹 故 难 忘	翠 木 苍 藤 水 一 方	闻 说 精 庐 今 更 好	好 随 残 汴 理 归 艎
芳 菲 - 牡 丹 - 风 流 - 春 去 - 芳 菲==柳 芳 菲 二 月 时 后	名 园 剩 有 牡 丹 枝	风 流 杜 牧 还 知 否	莫 恨 寻 春 去 较 迟
月 满 - 羌 笛 - 春 风 - 梅 花 - 月 满==雪 尽 洮 河 月 满 营	胡 儿 羌 笛 奏 边 声	春 风 不 到 单 于 塞	何 事 梅 花 夜 夜 生
乌 角 - 官 身 - 溪 边 - 斜 阳 - 乌 角==父 老 争 看 乌 角 巾	应 缘 曾 现 宰 官 身	溪 边 古 路 三 叉 口	独 立 斜 阳 数 过 人
江 山 - 鼓 箧 - 第 一 - 江 山 - 江 山==第 一 江 山 酒 两 壶	送 君 鼓 箧 入 皇 都	直 须 第 一 收 名 第	莫 使 江 山 擅 美 呼
长 堤 - 小 桥 - 一 缕 - 蓑 笠 - 长 堤==过 雨 长 堤 葱 翠 湿	小 桥 人 静 支 筇 立	一 缕 竿 头 颤 霜 鲫	风 动 青 蒲 见 蓑 笠
酒 泉 - 白 草 - 日 光 - 令 人 - 酒 泉==燕 支 山 西 酒 泉 道	北 风 吹 沙 卷 白 草	长 安 遥 在 日 光 边	忆 君 不 见 令 人 老
寂 寞 - 一 身 - 秋 风 - 枫 叶 - 寂 寞==寂 寞 新 阡 草 未 长	一 身 千 里 路 茫 茫	秋 风 解 染 愁 人 泪	枫 叶 能 红 菊 亦 黄
故 人 - 更 长 - 经 岁 - 递 相 - 江 乡==故 人 漂 泊 客 江 乡	夜 雨 相 思 夜 更 长	经 岁 不 来 来 又 去	端 如 鸿 燕 递 相 望
春 草 - 江 亭 - 苹 花 - 洞 庭 - 春 草==春 水 满 时 春 草 生	春 风 日 日 上 江 亭	苹 花 采 得 从 谁 寄	空 送 沅 湘 入 洞 庭
一 年 - 百 岁 - 明 年 - 明 年 - 一 年==一 年 一 见 最 堪 惜	百 岁 百 夕 能 几 多	纵 有 明 年 似 今 夕	明 年 同 会 复 如 何
花 红 - 柳 外 - 晴 光 - 游 丝 - 花 红==拂 花 红 露 溅 春 衣	柳 外 春 禽 睡 未 知	天 借 晴 光 与 桃 李	更 将 剩 彩 弄 游 丝
一 树 - 点 地 - 女 冠 - 月 明 - 一 树==一 树 笼 松 玉 刻 成	飘 廊 点 地 色 轻 轻	女 冠 夜 觅 香 来 处	唯 见 阶 前 碎 月 明
露 洗 - 层 层 - 西 风 - 待 月 - 露 洗==露 洗 金 虫 一 半 开	层 层 碧 玉 映 楼 台	西 风 昨 夜 吹 香 过	人 在 栏 干 待 月 来
伊 水 - 凉 风 - 诗 句 - 洛 阳 - 伊 水==下 马 闲 行 伊 水 头	凉 风 清 景 胜 春 游	何 事 古 今 诗 句 里	不 多 说 著 洛 阳 秋
折 来 - 馀 音 - 都 官 - 诗 僧 - 折 来==折 来 梅 与 句 争 清	强 和 馀 音 本 不 能	欲 向 都 官 论 一 字	略 无 佳 处 似 诗 僧
文 章 - 佳 句 - 烧 丹 - 第 一 - 文 章==道 德 文 章 满 足 翁	曾 将 佳 句 咏 茅 峰	烧 丹 炼 药 非 吾 事	孝 友 神 仙 第 一 功
梅 花 - 柏 台 - 月 明 - 烈 风 - 梅 花==屋 角 梅 花 枕 鲁 宫	柏 台 借 重 过 江 东	月 明 鸟 定 文 书 静	九 郡 谯 楼 起 烈 风
载 酒 - 庾 楼 - 江 南 - 舟 楫 - 载 酒==何 郎 载 酒 别 贤 侯	更 吐 歌 珠 宴 庾 楼	莫 道 江 南 不 同 醉	即 陪 舟 楫 上 京 游
物 华 - 风 前 - 残 红 - 万 家 - 物 华==投 老 殷 勤 向 物 华	风 前 犹 欲 拾 余 花	更 将 梦 逐 残 红 去	遍 入 长 安 百 万 家
玉 蕊 - 银 山 - 雪 融 - 梅 花 - 万 木==万 木 未 春 先 玉 蕊	千 峰 非 浪 亦 银 山	雪 融 毕 竟 无 踪 迹	依 旧 梅 花 耐 岁 寒
麒 麟 - 月 中 - 寓 目 - 羽 衣 - 麒 麟==天 上 麒 麟 天 下 稀	月 中 几 送 八 姨 归	君 王 寓 目 应 追 悔	误 看 乘 鸾 度 羽 衣
癸 丑 - 兰 亭 - 易 入 - 他 乡 - 癸 丑==十 六 回 更 癸 丑 春	兰 亭 临 本 尚 如 新	学 书 良 易 入 难 学	聊 喜 他 乡 见 似 人
千 叶 - 树 间 - 休 去 - 残 红 - 桃 花==五 出 桃 花 千 叶 绯	团 栾 绕 树 间 芳 菲	攀 来 欲 折 还 休 去	看 到 残 红 教 自 飞
风 枝 - 虎 踞 - 翰 林 - 胸 中 - 风 枝==风 枝 雨 叶 瘠 土 竹	龙 蹲 虎 踞 苍 藓 石	东 坡 老 人 翰 林 公	醉 时 吐 出 胸 中 墨
可 为 - 六 合 - 夜 深 - 乘 月 - 世 间==世 间 无 远 可 为 游	六 合 朝 行 夕 已 周	坛 上 夜 深 风 雨 静	小 仙 乘 月 击 苍 虬
叶 疏 - 松 枝 - 定 知 - 百 里 - 柳 叶==山 柳 叶 疏 容 夜 月	古 松 枝 劲 起 秋 风	定 知 明 日 便 回 首	百 里 牛 矶 烟 雾 中
野 人 - 白 发 - 倒 无 - 山 林 - 野 人==懒 性 如 今 成 野 人	苍 颜 白 发 不 时 新	自 知 潦 倒 无 余 事	乞 取 山 林 放 旷 身
白 头 - 似 冰 - 如 针 - 骨 肉 - 白 头==白 头 白 项 翅 如 银	上 手 观 来 一 似 冰	枣 红 牙 齿 如 针 利	总 无 骨 肉 似 将 军
如 云 - 立 勋 - 千 里 - 无 人 - 如 云==连 营 貔 虎 气 如 云	听 诏 人 人 愿 立 勋	沔 鄂 蕲 黄 一 千 里	更 无 人 说 岳 家 军
君 臣 - 山 河 - 太 平 - 光 辉 - 君 臣==君 臣 庆 会 豁 余 机	百 亿 山 河 尽 贡 归	拈 起 太 平 无 价 宝	乾 坤 何 处 不 光 辉
黯 淡 - 怯 寒 - 裘 羔 - 和 雪 - 匝 地==匝 地 阴 风 黯 淡 天	怯 寒 时 候 只 宜 眠	毡 裘 羔 酒 非 吾 事	自 碾 新 茶 和 雪 煎
一 字 - 到 处 - 石 上 - 面 壁 - 岭 初==葱 岭 初 无 一 字 传	名 山 到 处 即 为 禅	只 今 石 上 留 公 案	面 壁 何 须 更 九 年
浮 云 - 落 花 - 门 梦 - 西 山 - 浮 云==日 与 浮 云 相 往 还	落 花 啼 鸟 总 相 关	初 无 东 观 北 门 梦	只 在 西 山 南 浦 间
应 时 - 师 子 - 败 叶 - 岁 寒 - 应 时==超 谈 胡 饼 应 时 机	遂 块 知 非 师 子 儿	败 叶 霜 风 都 扫 尽	古 松 方 见 岁 寒 枝
白 玉 - 洞 庭 - 分 明 - 知 见 - 白 玉==白 玉 繁 花 五 叶 芳	春 风 吹 尽 洞 庭 霜	河 西 道 眼 分 明 处	识 破 此 中 知 见 香
落 日 - 白 苹 - 苍 梧 - 一 点 - 落 日==落 日 孤 烟 过 洞 庭	黄 陵 祠 畔 白 苹 汀	欲 知 万 里 苍 梧 眼	泪 尽 君 山 一 点 青
鸣 凤 - 鸥 鹭 - 烟 外 - 渔 艇 - 鸣 凤==朝 阳 鸣 凤 国 之 祥	瑞 事 吾 家 鸥 鹭 行	最 爱 几 声 烟 外 响	和 他 渔 艇 独 敲 榔
步 履 - 雨 余 - 黄 犬 - 溪 边 - 步 履==步 履 寻 春 有 好 怀	雨 余 蹄 道 水 如 杯	随 人 黄 犬 搀 前 去	走 到 溪 边 忽 自 回
山 窗 - 江 湖 - 窗 试 - 鱼 龙 - 长 夜==长 夜 山 窗 面 面 开	江 湖 前 后 思 悠 哉	当 窗 试 与 然 高 烛	要 看 鱼 龙 啖 影 来
蝶 梦 - 梦 回 - 松 阴 - 半 夜 - 一 室==蝶 梦 轻 扬 一 室 空	梦 回 谁 识 此 身 同	窗 前 月 冷 松 阴 碎	一 枕 溪 声 半 夜 风
掠 水 - 清 晖 - 江 亭 - 扁 舟 - 掠 水==石 势 浑 如 掠 水 飞	渔 罾 绝 壁 挂 清 晖	俯 江 亭 上 何 人 坐	看 我 扁 舟 望 翠 微
扁 舟 - 轻 烟 - 日 月 - 江 山 - 扁 舟==吴 波 亭 下 击 扁 舟	轻 雨 轻 烟 又 麦 秋	乌 兔 衔 将 日 月 去	江 山 管 定 古 今 愁
精 神 - 无 心 - 事 安 - 鸡 鸣 - 精 神==精 神 有 限 惟 当 啬	造 化 无 心 不 汝 私	此 事 安 须 知 决 择	鸡 鸣 勿 後 老 人 期
蒙 茸 - 向 日 - 白 云 - 千 古 - 成 蹊==蒙 茸 披 尽 自 成 蹊	两 扇 岩 扉 向 日 齐	说 与 白 云 休 锁 钥	留 将 千 古 指 人 迷
游 鱼 - 孝 子 - 乐 事 - 伤 心 - 游 鱼==游 鱼 岂 解 和 人 意	孝 子 精 诚 一 念 深	乐 事 世 间 如 此 少	我 怀 风 木 只 伤 心
酒 楼 - 一 曲 - 一 醉 - 谪 仙 - 酒 楼==长 安 酒 楼 歌 管 新	一 曲 乌 栖 泣 鬼 神	狂 客 解 龟 同 一 醉	人 人 知 是 谪 仙 人
天 台 - 白 云 - 诗 人 - 看 山 - 天 台==久 别 天 台 路 已 迷	眼 前 尚 觉 白 云 低	诗 人 用 笔 求 逋 峭	何 不 看 山 到 浙 西
花 开 - 零 落 - 五 更 - 春 色 - 花 开==小 园 数 树 杂 花 开	零 落 无 声 覆 绿 苔	休 恨 五 更 风 雨 急	明 年 春 色 自 归 来
江 水 - 长 江 - 一 樽 - 扁 舟 - 悠 悠==锁 江 水 下 水 悠 悠	只 锁 长 江 不 锁 愁	但 存 一 樽 浇 旅 思	图 教 沉 醉 泛 扁 舟
载 酒 - 江 梅 - 秋 光 - 带 雨 - 载 酒==落 拓 山 园 载 酒 来	江 梅 含 雪 倚 春 台	花 花 无 藉 秋 光 老	犹 自 离 披 带 雨 开
看 花 - 谁 家 - 争 妍 - 岁 华 - 山 行==蹑 屐 山 行 日 看 花	春 前 桃 李 属 谁 家	千 红 万 紫 争 妍 媚	不 似 青 松 耐 岁 华
门 前 - 九 天 - 寂 寞 - 鼓 吹 - 门 前==忆 瞻 銮 仗 省 门 前	扇 影 鞭 声 下 九 天	寂 寞 嘉 州 迎 诏 处	忽 闻 鼓 吹 却 凄 然
潮 来 - 山 花 - 江 水 - 鲈 鱼 - 潮 来==潮 去 潮 来 洲 渚 春	山 花 如 绣 草 如 茵	严 陵 台 下 桐 江 水	解 钓 鲈 鱼 能 几 人
新 诗 - 松 涛 - 自 觉 - 每 见 - 新 诗==寄 我 新 诗 富 且 优	松 涛 二 十 里 飕 飕	老 来 自 觉 舌 头 短	每 见 长 篇 不 敢 酬
漠 漠 - 天 白 - 江 水 - 时 不 - 漠 漠==漠 漠 轻 阴 晚 自 开	青 天 白 日 映 楼 台	曲 江 水 满 花 千 树	有 底 忙 时 不 肯 来
瑶 池 - 堂 前 - 新 月 - 春 愁 - 瑶 池==汉 宫 早 送 瑶 池 信	荀 令 堂 前 夜 气 浮	凭 仗 花 开 拜 新 月	重 添 新 篆 炷 春 愁
落 日 - 雨 压 - 天 际 - 海 门 - 萧 萧==都 城 落 日 马 萧 萧	雨 压 春 风 暗 柳 条	天 际 归 艎 那 可 望	只 将 心 寄 海 门 潮
顽 云 - 桃 红 - 东 君 - 花 上 - 顽 云==顽 云 痴 雨 霸 春 寒	李 白 桃 红 总 失 欢	试 问 东 君 因 底 事	却 来 花 上 作 艰 难
切 切 - 高 柳 - 夕 阳 - 酒 楼 - 琵 琶==琵 琶 切 切 更 嘈 嘈	高 柳 群 蝉 遂 不 号	一 片 夕 阳 无 限 好	汶 河 西 上 酒 楼 高
雨 后 - 岩 隈 - 溪 头 - 一 日 - 翡 翠==雨 后 西 山 翡 翠 堆	结 亭 直 欲 近 岩 隈	从 今 记 取 溪 头 路	一 日 须 来 一 百 回
秋 风 - 落 木 - 解 组 - 十 年 - 秋 风==剑 壑 秋 风 起 暮 烟	寒 泉 落 木 自 依 然	翻 因 解 组 重 来 日	悔 别 青 山 二 十 年
梅 花 - 岁 华 - 苦 寒 - 无 家 - 梅 花==去 年 马 上 折 梅 花	今 夕 匡 庐 度 岁 华	风 雪 苦 寒 如 北 土	每 因 时 节 恨 无 家
风 树 - 莽 莽 - 归 路 - 竹 坞 - 风 树==一 抹 东 风 树 色 新	牛 羊 莽 莽 散 平 原	微 烟 细 草 知 归 路	竹 坞 人 家 半 掩 门
幽 居 - 月 色 - 有 情 - 夕 照 - 幽 居==幽 居 处 处 映 烟 萝	归 隐 桥 边 月 色 多	蟾 桂 有 情 邻 病 叟	清 光 终 夕 照 酣 歌
山 色 - 花 影 - 红 紫 - 山 花 - 山 色==闭 轿 那 知 山 色 浓	山 花 影 落 水 田 中	水 中 细 数 千 红 紫	点 对 山 花 一 一 同
登 临 - 花 开 - 看 花 - 花 开 - 登 临==词 客 登 临 信 笔 裁	每 于 花 谢 笑 花 开	请 观 世 上 看 花 者	曾 见 花 开 不 谢 来
国 书 - 刺 史 - 醉 客 - 绿 杨 - 国 书==莫 言 鲁 国 书 生 懦	莫 把 杭 州 刺 史 欺	醉 客 请 君 开 眼 望	绿 杨 风 下 有 红 旗
落 日 - 荷 花 - 云 间 - 谁 家 - 青 山==落 日 青 山 影 在 沙	镜 湖 波 净 过 荷 花	云 间 树 底 参 差 屋	借 问 谁 家 是 贺 家
年 年 - 江 畔 - 珍 重 - 送 春 - 年 年==年 年 芳 信 负 红 梅	江 畔 垂 垂 又 欲 开	珍 重 多 情 关 令 尹	直 和 根 拨 送 春 来
万 里 - 身 轻 - 天 涯 - 数 行 - 万 里==羡 伊 万 里 度 晴 虚	自 叹 身 轻 独 不 如	若 到 天 涯 逢 荡 子	可 能 为 报 数 行 书
水 禽 - 斜 斜 - 江 南 - 阳 台 - 漠 漠==湖 光 漠 漠 水 禽 飞	提 柳 斜 斜 带 夕 晖	二 月 江 南 好 天 气	初 阳 台 上 惬 春 衣
连 宵 - 麦 秋 - 十 年 - 金 城 - 飞 雨==连 宵 飞 雨 喜 滂 流	已 入 梅 天 过 麦 秋	二 十 年 前 如 此 晚	金 城 地 抱 却 全 收
仙 班 - 九 华 - 窈 窕 - 翠 微 - 晓 景==朝 下 仙 班 晓 景 迟	步 摇 香 认 九 华 妃	花 藏 窈 窕 知 金 屋	亭 照 回 波 在 翠 微
穿 林 - 听 欹 - 道 人 - 一 簇 - 穿 林==惊 羽 穿 林 看 细 碎	健 舆 绕 石 听 欹 斜	道 人 住 近 茅 峰 北	一 簇 楼 台 五 色 霞
酒 家 - 风 摇 - 沽 酒 - 杏 花 - 酒 家==西 子 湖 头 卖 酒 家	春 风 摇 荡 酒 旗 斜	行 人 沽 酒 唱 歌 去	踏 碎 满 阶 山 杏 花
有 舒 - 何 物 - 千 载 - 齐 人 - 舒 与==汉 朝 独 有 舒 与 黯	何 物 枭 心 欲 食 之	六 经 千 载 无 生 气	断 自 齐 人 作 相 时
早 岁 - 功 名 - 白 头 - 江 湖 - 早 岁==早 岁 元 于 利 欲 轻	但 余 一 念 在 功 名	白 头 不 试 平 戎 策	虚 向 江 湖 过 此 生
黄 昏 - 闭 门 - 倚 栏 - 事 与 - 雨 湿==晚 西 寒 雨 湿 黄 昏	爱 睡 山 僧 已 闭 门	独 自 倚 栏 还 独 笑	男 儿 心 事 与 谁 论
天 白 - 秋 色 - 行 了 - 清 凉 - 白 鸟==渺 渺 江 天 白 鸟 飞	石 城 秋 色 送 僧 归	长 干 古 寺 经 行 了	为 到 清 凉 看 翠 微
犬 吠 - 巢 居 - 饱 饭 - 酣 歌 - 鸣 犬==鸡 鸣 犬 吠 相 闻 地	穴 处 巢 居 上 古 风	饱 饭 不 为 明 日 虑	酣 歌 便 过 百 年 中
秋 千 - 弦 管 - 儿 童 - 买 花 - 秋 千==日 转 秋 千 影 渐 斜	忍 闻 弦 管 在 邻 家	儿 童 不 惯 贫 滋 味	刚 拾 榆 钱 索 买 花
小 至 - 交 加 - 幽 人 - 蔷 薇 - 小 至==小 至 翻 疑 节 候 差	豆 棚 青 翠 漫 交 加	沿 溪 忽 入 幽 人 室	开 遍 蔷 薇 一 架 花
轻 舟 - 阴 凝 - 阡 陌 - 教 一 - 轻 舟==已 办 轻 舟 著 脚 登	笑 渠 河 伯 故 阴 凝	征 车 政 欲 周 阡 陌	赢 得 天 教 一 夜 冰
北 海 - 大 江 - 一 片 - 指 南 - 随 风==几 日 随 风 北 海 游	回 从 扬 子 大 江 头	臣 心 一 片 磁 针 石	不 指 南 方 不 肯 休
挥 汗 - 清 风 - 中 留 - 琉 璃 - 挥 汗==携 筇 挥 汗 别 文 星	匝 地 清 风 耸 百 城	佛 祖 位 中 留 不 住	琉 璃 殿 上 绿 苔 生
西 湖 - 繁 华 - 仙 诗 - 国 色 - 西 湖==谁 将 西 子 比 西 湖	旧 日 繁 华 渐 欲 无	始 信 坡 仙 诗 是 谶	捧 心 国 色 解 亡 吴
垂 垂 - 暗 香 - 钗 头 - 宫 妆 - 瘦 萼==垂 垂 瘦 萼 泫 微 霜	剪 剪 纤 英 锁 暗 香	金 雀 钗 头 金 蛱 蝶	春 风 傅 得 旧 宫 妆
草 荒 - 梅 花 - 吟 魂 - 独 鹤 - 草 荒==木 落 孤 山 墓 草 荒	梅 花 千 古 带 诗 香	吟 魂 仙 去 谁 招 得	独 鹤 一 声 幽 恨 长
夹 道 - 奇 怪 - 枝 垂 - 翠 球 - 长 松==夹 道 长 松 去 去 幽	一 松 奇 怪 独 凌 秋	两 枝 垂 地 却 翻 上	活 走 双 龙 戏 翠 球
古 镜 - 清 光 - 故 人 - 尘 埃 - 古 镜==欲 炼 此 心 成 古 镜	清 光 直 透 太 虚 明	朝 来 一 洒 故 人 泪	依 旧 尘 埃 满 匣 生
含 青 - 名 园 - 呜 咽 - 劫 火 - 含 青==半 熟 含 青 市 百 枚	名 园 高 树 曲 城 隈	山 翁 呜 咽 言 情 事	曾 见 黄 巢 劫 火 灰
瓦 砾 - 路 傍 - 荒 凉 - 芳 菲 - 瓦 砾==池 馆 早 来 瓦 砾 存	路 傍 看 取 故 侯 园	身 前 便 作 荒 凉 计	祇 树 芳 菲 不 树 恩
夜 窗 - 数 竿 - 今 朝 - 秋 声 - 昨 夜==昨 夜 窗 前 风 月 时	数 竿 疏 影 响 书 帏	今 朝 拓 向 溪 藤 上	犹 觉 秋 声 笔 底 飞
晴 沙 - 芒 鞋 - 秋 山 - 桂 花 - 晴 沙==乍 晴 沙 路 软 於 尘	新 看 芒 鞋 更 可 人	谁 道 秋 山 不 宜 客	桂 花 多 处 胜 行 春
杯 盘 - 朱 樱 - 颠 狂 - 醉 人 - 杯 盘==草 草 杯 盘 莫 笑 贫	朱 樱 羊 酪 也 尝 新	灯 前 耳 热 颠 狂 甚	虏 酒 谁 言 不 醉 人
千 官 - 是 起 - 彩 笔 - 太 平 - 千 官==千 官 晓 立 炉 烟 里	立 近 丹 墀 是 起 居	彩 笔 专 书 皇 帝 语	书 成 几 卷 太 平 书
柏 台 - 负 两 - 颠 狂 - 乱 打 - 柏 台==一 自 柏 台 为 御 史	二 年 辜 负 两 京 春	岘 亭 今 日 颠 狂 醉	舞 引 红 娘 乱 打 人
成 愁 - 一 曲 - 翘 足 - 梦 魂 - 文 彩==满 身 文 彩 漫 成 愁	一 曲 清 池 强 滞 留	翘 足 有 时 双 睡 去	梦 魂 依 旧 绕 沧 洲
清 新 - 古 意 - 向 声 - 风 吹 - 清 新==独 唱 清 新 拍 不 同	寥 寥 千 古 意 无 穷	拟 开 眼 向 声 前 听	早 被 风 吹 别 调 中
光 明 - 中 元 - 归 来 - 无 人 - 光 明==本 自 光 明 不 费 灯	个 中 元 不 隔 微 尘	如 何 曾 点 归 来 后	千 古 无 人 解 咏 春
金 枝 - 银 鞍 - 三 日 - 芳 草 - 金 枝==郁 金 枝 拂 郁 金 尊	送 尔 银 鞍 过 远 村	十 里 春 城 三 日 雨	那 禁 芳 草 闭 黄 昏
夜 月 - 一 圭 - 雪 腴 - 新 诗 - 夜 月==万 杵 炼 麋 摇 夜 月	一 圭 分 剂 割 晴 云	雪 腴 半 展 陶 泓 净	改 罢 新 诗 写 赠 君
高 情 - 章 句 - 翦 翅 - 望 仙 - 高 情==身 闲 无 事 称 高 情	已 有 人 间 章 句 名	求 得 鹤 来 教 翦 翅	望 仙 台 下 亦 将 行
四 海 - 当 轩 - 军 赏 - 宝 马 - 四 海==四 海 烟 尘 已 晏 然	当 轩 明 月 照 人 寒	大 功 不 赐 将 军 赏	宝 马 金 枪 顿 懒 观
六 出 - 着 处 - 天 工 - 花 疏 - 霏 霏==六 出 霏 霏 过 小 帘	梅 梢 着 处 似 沾 粘	天 工 底 事 巧 装 点	只 为 花 疏 特 故 添
功 名 - 志 气 - 书 卷 - 只 烦 - 千 年==功 名 直 作 千 年 计	志 气 不 随 双 鬓 衰	书 卷 盈 怀 长 晏 食	只 烦 造 物 为 营 炊
寒 泉 - 清 音 - 蛟 龙 - 苍 生 - 万 古==一 滴 寒 泉 万 古 心	幽 幽 岩 下 弄 清 音	何 如 唤 起 蛟 龙 蛰	散 作 苍 生 万 国 霖
岁 华 - 钗 斜 - 梅 香 - 春 风 - 岁 华==帘 底 临 鸾 惜 岁 华	鬓 云 慵 掠 宝 钗 斜	落 梅 香 断 无 消 息	一 树 春 风 属 杏 花
流 汗 - 明 知 - 连 峰 - 明 年 - 流 汗==木 牛 流 汗 上 青 天	汉 火 明 知 不 可 然	谁 识 连 峰 攒 剑 戟	正 虞 天 啬 孔 明 年
江 上 - 水 村 - 一 声 - 龙 归 - 江 上==江 上 群 峰 泼 黛 浓	水 村 烟 渚 夕 阳 红	一 声 啼 鸟 催 耕 去	何 处 龙 归 急 雨 中
江 南 - 凤 鸣 - 十 月 - 千 秋 - 江 南==楼 船 载 日 下 江 南	吹 凤 鸣 鼍 御 酒 酣	吴 花 十 月 迎 黄 幄	隋 柳 千 秋 映 锦 帆
伤 心 - 江 流 - 东 风 - 鹧 鸪 - 伤 心==伤 心 欲 问 前 朝 事	惟 见 江 流 去 不 回	日 暮 东 风 春 草 绿	鹧 鸪 飞 上 越 王 台
千 日 - 玄 都 - 天 门 - 秋 声 - 千 日==中 山 千 日 酒 初 醒	却 爱 玄 都 夜 景 清	起 坐 天 门 吹 玉 笛	月 中 珠 树 起 秋 声
出 群 - 承 恩 - 年 年 - 落 黄 - 蛾 眉==学 画 蛾 眉 独 出 群	当 时 人 道 便 承 恩	年 年 不 见 君 王 面	花 落 黄 昏 空 掩 门
莎 径 - 月 挂 - 松 风 - 高 挂 - 莎 径==石 门 莎 径 绿 回 环	月 挂 虚 檐 滴 露 寒	自 有 松 风 时 度 曲	我 琴 高 挂 不 须 弹
交 加 - 清 流 - 知 几 - 春 风 - 交 加==台 前 藤 藓 碧 交 加	台 下 清 流 直 又 斜	待 得 丹 成 知 几 日	春 风 随 分 野 桃 花
战 场 - 归 来 - 酒 阑 - 诗 成 - 身 古==七 十 收 身 古 战 场	归 来 八 十 更 康 强	酒 阑 庭 户 秋 光 好	想 见 诗 成 一 缕 香
胜 事 - 黄 云 - 年 罢 - 卒 岁 - 胜 事==我 行 自 喜 有 胜 事	夹 道 黄 云 禾 黍 秋	闻 道 今 年 罢 和 籴	老 农 卒 岁 傥 宽 忧
江 干 - 深 根 - 谋 楚 - 临 危 - 江 干==邓 侯 城 垒 汉 江 干	自 谓 深 根 百 世 安	不 用 三 甥 谋 楚 计	临 危 方 觉 噬 脐 难
荒 凉 - 更 长 - 一 望 - 青 秧 - 山 行==山 行 两 日 厌 荒 凉	田 少 山 多 多 更 长	一 望 不 曾 亏 碧 草	半 分 何 似 借 青 秧
凝 霜 - 妇 人 - 清 思 - 东 风 - 凝 霜==雪 凝 霜 降 不 肯 春	花 神 岂 类 妇 人 仁	肯 留 年 后 供 清 思	分 付 东 风 与 主 人
石 室 - 三 杯 - 百 年 - 何 处 - 石 室==一 语 为 君 评 石 室	三 杯 便 可 博 凉 州	百 年 兀 兀 同 渠 住	何 处 能 生 半 点 愁
三 年 - 一 夕 - 顽 似 - 山 青 - 三 年==章 老 三 年 病 方 死	吴 翁 一 夕 呼 不 醒	独 有 此 身 顽 似 铁	倚 门 常 看 暮 山 青
乌 府 - 林 中 - 水 亭 - 时 染 - 乌 府==鹤 色 纱 蒙 乌 府 寄	裁 衣 不 称 著 林 中	水 亭 君 有 亲 题 处	留 待 他 时 染 碧 笼
影 斜 - 此 著 - 杳 杳 - 晚 花 - 影 斜==细 竹 千 竿 殿 影 斜	龙 颜 曾 此 著 袈 裟	寺 楼 杳 杳 钟 声 过	疑 有 宫 娥 出 晚 花
阴 阴 - 荷 叶 - 燕 新 - 檐 前 - 阴 阴==槐 幄 阴 阴 蔽 绿 扉	池 抽 荷 叶 落 蔷 薇	梁 间 紫 燕 新 雏 弱	来 傍 檐 前 旋 学 飞
庭 院 - 翻 阶 - 玉 堂 - 秋 声 - 庭 院==碧 梧 庭 院 露 华 清	一 叶 翻 阶 鹤 梦 惊	绿 发 方 瞳 玉 堂 客	蝇 头 灯 下 写 秋 声
垂 杨 - 中 流 - 团 扇 - 憔 悴 - 垂 杨==吹 软 垂 杨 两 岸 风	中 流 箫 管 酒 灯 红	也 知 团 扇 谁 描 得	憔 悴 江 湖 一 放 翁
下 仙 - 送 使 - 莫 辞 - 三 年 - 仙 云==日 晴 空 乐 下 仙 云	俱 在 凉 亭 送 使 君	莫 辞 一 盏 即 相 请	还 是 三 年 更 不 闻
深 红 - 树 阴 - 已 伴 - 黄 菊 - 浅 紫==深 红 浅 紫 碎 罗 装	竹 树 阴 中 独 自 芳	已 伴 白 莲 羞 远 供	款 陪 黄 菊 荐 陶 觞
红 叶 - 诗 成 - 流 水 - 月 明 - 题 诗==闲 拈 红 叶 欲 题 诗	待 得 诗 成 又 懒 题	心 事 不 随 流 水 去	月 明 人 在 赤 桥 西
光 明 - 草 树 - 宝 藏 - 暮 雨 - 明 媚==秋 光 明 媚 似 春 光	重 九 尊 前 草 树 香	可 记 前 年 宝 藏 寺	西 山 暮 雨 怨 吴 郎
东 城 - 刺 绣 - 游 夜 - 银 蟾 - 东 城==南 陌 东 城 尽 舞 儿	画 金 刺 绣 满 罗 衣	也 知 爱 惜 春 游 夜	舞 落 银 蟾 不 肯 归
飞 云 - 玉 盘 - 百 尺 - 风 吹 - 飞 云==飞 云 顶 上 阁 阑 干	夜 半 南 溟 出 玉 盘	卷 起 水 帘 三 百 尺	松 风 吹 度 铁 桥 寒
萧 萧 - 清 砧 - 千 愁 - 今 夜 - 荒 草==荒 草 萧 萧 郭 隗 台	清 砧 明 月 两 堪 哀	千 愁 百 感 多 如 雨	今 夜 灯 前 一 并 来
数 声 - 落 照 - 征 鸿 - 春 信 - 数 声==数 声 嘹 唳 渡 榆 关	尽 罢 虚 弦 落 照 间	却 讶 征 鸿 偏 有 胆	又 随 春 信 到 天 山
城 角 - 经 楼 - 入 宫 - 诗 人 - 城 角==城 角 新 居 邻 静 寺	时 从 新 阁 上 经 楼	南 山 泉 入 宫 中 去	先 向 诗 人 门 外 流
刺 史 - 朱 门 - 竹 马 - 竹 马 - 刺 史==昔 日 郎 君 今 刺 史	朱 元 依 旧 守 朱 门	今 朝 竹 马 诸 童 子	尽 是 当 时 竹 马 孙
清 奇 - 扁 舟 - 去 来 - 归 时 - 溪 山==溪 山 雪 夜 本 清 奇	底 事 扁 舟 只 凭 归	谁 识 去 来 皆 兴 耳	归 时 更 好 似 来 时
游 山 - 山 中 - 缨 且 - 桃 李 - 游 山==今 岁 游 山 已 恨 迟	山 中 仍 喜 见 辛 夷	簪 缨 且 免 全 为 累	桃 李 犹 堪 别 作 期
凝 寒 - 春 风 - 东 郊 - 枝 头 - 冰 雪==冰 雪 凝 寒 万 木 空	我 今 正 欲 转 春 风	东 郊 已 和 安 排 计	会 持 枝 头 万 点 红
细 雨 - 冲 烟 - 得 鱼 - 如 飞 - 细 雨==细 雨 霏 霏 下 钓 台	冲 烟 小 艇 截 江 来	不 知 取 得 鱼 多 少	鼓 棹 如 飞 唤 不 回
鼓 吹 - 灯 火 - 传 柑 - 万 户 - 喧 喧==鼓 吹 喧 喧 月 色 新	天 街 灯 火 夜 通 晨	玉 皇 不 赐 传 柑 宴	散 与 千 门 万 户 春
淹 留 - 万 斛 - 归 去 - 凤 凰 - 淹 留==周 南 底 事 苦 淹 留	杯 水 那 容 万 斛 舟	稳 驾 长 风 归 去 好	凤 凰 池 上 醉 遨 游
知 归 - 关 碎 - 东 山 - 千 古 - 知 归==才 呼 小 玉 例 知 归	撞 破 天 关 碎 铁 围	拈 出 东 山 暗 号 子	至 今 千 古 峭 巍 巍
无 根 - 今 朝 - 瓮 非 - 千 岩 - 无 根==客 疾 无 根 莫 浪 忧	今 朝 扫 尽 不 容 留	饭 囊 酒 瓮 非 吾 事	只 贮 千 岩 万 壑 秋
垂 虹 - 远 风 - 辽 海 - 水 晶 - 秋 晚==云 帆 秋 晚 过 垂 虹	落 日 鲸 波 动 远 风	欲 借 仙 家 辽 海 鹤	月 明 吹 笛 水 晶 宫
清 游 - 梅 花 - 阑 干 - 玉 人 - 清 游==昔 同 诗 伴 结 清 游	乱 折 梅 花 当 酒 筹	十 二 阑 干 风 雪 里	玉 人 扶 醉 下 西 楼
头 锦 - 架 上 - 空 庭 - 远 山 - 斑 复==床 头 锦 衾 斑 复 斑	架 上 朱 衣 殷 复 殷	空 庭 明 月 闲 复 闲	夜 长 路 远 山 复 山
午 夜 - 分 明 - 通 天 - 重 重 - 午 夜==午 夜 山 房 月 色 深	十 分 明 白 堕 功 勋	拨 开 向 上 通 天 窍	烟 嶂 重 重 不 见 人
桃 李 - 山 城 - 狐 裘 - 愁 宽 - 桃 李==桃 李 欲 开 天 雨 雪	二 月 山 城 无 奈 寒	赖 尔 狐 裘 来 送 质	更 须 樽 酒 放 愁 宽
楼 台 - 销 魂 - 梅 花 - 千 古 - 楼 台==半 是 楼 台 换 却 村	几 回 独 立 更 销 魂	断 堤 野 水 梅 花 宅	千 古 春 风 月 一 痕
年 光 - 感 旧 - 秋 色 - 初 见 - 年 光==年 光 苒 苒 暗 推 移	坐 惜 流 年 感 旧 期	独 听 早 蝉 秋 色 里	潘 安 初 见 二 毛 时
晴 日 - 啼 鸟 - 芳 径 - 高 楼 - 日 暖==晴 日 暖 风 浑 欲 醉	游 蜂 啼 鸟 累 相 关	闲 来 芳 径 步 幽 草	更 上 高 楼 看 远 山
千 山 - 鸡 犬 - 知 仁 - 十 年 - 千 山==千 山 行 尽 见 平 川	鸡 犬 相 闻 俗 晏 然	父 老 共 知 仁 圣 意	十 年 重 借 使 君 贤
玄 都 - 看 花 - 刘 郎 - 东 风 - 玄 都==乱 后 玄 都 失 故 基	看 花 诗 在 只 堪 悲	刘 郎 也 是 人 间 客	枉 向 东 风 怨 兔 葵
古 道 - 牛 羊 - 尘 埃 - 烟 消 - 古 道==乘 兴 来 游 古 道 场	远 村 落 日 卧 牛 羊	暂 能 摆 脱 尘 埃 念	瓦 鼎 烟 消 柏 子 香
下 帘 - 夜 长 - 寸 心 - 夜 深 - 焚 香==下 帘 宴 坐 自 焚 香	酒 力 醒 时 冬 夜 长	忧 国 寸 心 应 未 炉	夜 深 频 起 看 天 猿
麦 浪 - 岸 上 - 处 处 - 青 青 - 麦 浪==三 月 轻 风 麦 浪 生	黄 河 岸 上 晚 波 平	村 原 处 处 垂 杨 柳	一 路 青 青 到 永 城
萧 萧 - 辇 路 - 金 屋 - 当 熊 - 萧 萧==萧 萧 宫 树 正 秋 风	虎 圈 门 开 辇 路 通	金 屋 阿 娇 心 胆 小	却 嗔 冯 媛 独 当 熊
光 彩 - 胭 脂 - 荒 陂 - 出 海 - 沉 沉==光 彩 沉 沉 万 木 西	青 空 围 出 酿 胭 脂	家 园 正 对 荒 陂 望	恰 似 腾 波 出 海 时
个 个 - 军 中 - 目 士 - 浣 花 - 个 个==生 男 个 个 欲 如 狼	妇 女 军 中 气 不 扬	试 问 争 功 嗔 目 士	几 人 能 敌 浣 花 娘
竹 叶 - 桃 花 - 广 寒 - 衔 杯 - 今 朝==瓮 中 竹 叶 今 朝 熟	鉴 里 桃 花 昨 日 开	为 报 广 寒 攀 桂 客	莫 辞 相 访 共 衔 杯
半 山 - 琴 书 - 笔 架 - 清 幽 - 风 响==夜 半 山 风 响 翠 梧	一 窗 皓 月 翠 琴 书	试 将 笔 架 山 头 屋	问 有 清 幽 似 此 罪
凌 霄 - 森 然 - 大 厦 - 栋 梁 - 耸 壑==耸 壑 凌 霄 色 共 苍	森 然 万 树 约 千 行	刘 郎 大 厦 寻 颠 覆	应 是 其 间 少 栋 梁
杨 花 - 雨 后 - 羌 笛 - 分 明 - 杨 花==广 陵 杨 花 辞 故 枝	各 自 空 条 雨 后 垂	羌 笛 不 知 春 自 去	分 明 一 曲 月 中 吹
池 塘 - 熟 梅 - 载 酒 - 一 树 - 浅 深==乳 鸭 池 塘 水 浅 深	熟 梅 天 气 半 阴 晴	东 园 载 酒 西 园 醉	摘 尽 枇 杷 一 树 金
大 家 - 独 自 - 为 梁 - 鹅 儿 - 大 家==大 家 装 著 门 时 宜	独 自 寻 拂 晓 淡 眉	为 梁 浅 黄 衫 子 色	金 盆 添 水 看 鹅 儿
万 里 - 温 泉 - 穿 云 - 潺 湲 - 万 里==秦 楚 相 望 万 里 天	岂 知 今 夕 宿 温 泉	穿 云 漱 月 无 穷 恨	依 旧 潺 湲 古 县 前
归 田 - 炊 玉 - 短 笛 - 太 平 - 秋 来==秋 来 谁 不 负 归 田	炊 玉 尝 新 喜 欲 颠	乞 我 一 年 横 短 笛	太 平 有 象 是 丰 年
雀 舌 - 解 醒 - 山 家 - 都 官 - 高 名==乘 春 雀 舌 占 高 名	龙 麝 相 资 笑 解 醒	莫 讶 山 家 少 为 送	郑 都 官 谓 草 中 英
池 边 - 风 寒 - 柳 叶 - 李 花 - 池 边==池 边 弄 水 手 犹 冰	藕 臂 风 寒 更 粟 生	柳 叶 春 深 槐 叶 浅	桃 花 夜 暗 李 花 明
叠 叠 - 幽 树 - 无 声 - 神 仙 - 叠 叠==叠 叠 青 山 相 送 迎	绕 溪 幽 树 万 蜩 呜	我 来 场 屋 无 声 字	也 在 神 仙 洞 里 行
春 浅 - 花 深 - 解 作 - 故 园 - 人 密==春 浅 酒 寒 人 密 坐	花 深 雨 细 蝶 移 枝	十 年 未 解 作 归 计	此 恨 故 园 莺 自 知
深 沉 - 奇 花 - 经 岁 - 亭 台 - 深 沉==后 院 深 沉 景 物 幽	奇 花 名 竹 弄 春 柔	翠 华 经 岁 无 游 幸	多 少 亭 台 废 不 修
年 光 - 花 开 - 杜 鹃 - 归 去 - 把 握==把 握 年 光 属 大 钧	花 开 花 落 不 由 春	杜 鹃 若 是 知 机 早	归 去 何 须 苦 劝 人
金 殿 - 凤 池 - 恩 波 - 御 沟 - 金 殿==金 殿 分 来 玉 砌 流	黑 龙 河 撤 凤 池 头	后 庭 花 落 恩 波 断	翻 与 南 塘 作 御 沟
徘 徊 - 一 杯 - 半 山 - 火 云 - 徘 徊==俗 归 停 驭 重 徘 徊	破 费 林 间 雪 一 杯	留 取 半 山 看 未 了	火 云 时 节 约 重 来
一 身 - 来 宾 - 传 否 - 怅 望 - 一 身==早 早 言 归 尚 一 身	秋 空 又 见 雁 来 宾	不 知 近 事 堪 传 否	须 记 西 风 怅 望 人
风 外 - 日 边 - 无 疆 - 一 片 - 风 外==蝉 外 西 风 风 外 叶	雁 边 落 日 日 边 云	诗 仙 世 界 无 疆 场	一 片 青 山 共 子 分
落 木 - 如 画 - 载 书 - 旧 游 - 萧 萧==落 木 萧 萧 古 寺 秋	翠 屏 如 画 雨 实 收	堂 基 千 载 书 香 在	谁 为 机 云 记 旧 游
玉 箫 - 云 敛 - 柳 线 - 烟 雨 - 玉 箫==乘 鸾 人 去 玉 箫 寒	云 敛 巫 山 晓 梦 残	柳 线 不 堪 击 离 别	自 和 烟 雨 搭 阑 干
年 年 - 有 香 - 风 味 - 绛 纱 - 年 年==年 年 梅 里 见 诸 杨	火 齐 堆 盘 更 有 香	风 味 十 分 如 荔 子	何 妨 盛 著 绛 纱 囊
第 一 - 星 斗 - 龙 驹 - 庭 前 - 第 一==幕 府 东 来 第 一 人	姓 名 星 斗 揭 苍 旻	龙 驹 要 踏 浮 云 去	好 向 庭 前 一 问 津
馨 香 - 东 篱 - 微 利 - 殷 勤 - 馨 香==来 从 西 域 馨 香 异	翻 作 东 篱 品 自 新	悟 此 肯 为 微 利 役	殷 勤 来 赏 属 幽 人
扶 桑 - 荷 衣 - 浮 云 - 阴 未 - 扶 桑==海 上 扶 桑 散 晓 晖	荷 衣 共 喜 换 蓑 衣	浮 云 天 外 弄 浓 淡	好 趁 轻 阴 未 雨 归
山 中 - 山 花 - 花 开 - 分 明 - 山 中==昔 年 曾 到 此 山 中	正 见 山 花 满 砌 红	今 日 花 开 还 照 眼	分 明 见 处 本 来 同
何 处 - 先 春 - 送 春 - 孤 城 - 何 处==南 关 何 处 日 孤 征	归 梦 先 春 几 百 程	今 日 送 春 犹 是 客	孤 城 寒 雨 不 胜 情
渺 渺 - 碧 波 - 龙 舟 - 竞 渡 - 渺 渺==渺 渺 金 河 入 禁 垣	渐 台 雨 过 碧 波 翻	共 传 太 液 龙 舟 稳	不 似 南 方 竞 渡 喧
渊 渊 - 来 尝 - 水 鉴 - 作 人 - 渊 渊==清 冽 渊 渊 一 窦 圆	每 来 尝 为 试 茶 煎	又 新 水 鉴 全 然 误	第 作 人 间 十 八 泉
玉 人 - 醒 酒 - 卷 帘 - 飞 絮 - 玉 人==绮 窗 别 后 玉 人 遥	浓 睡 才 醒 酒 未 消	日 午 卷 帘 风 力 软	落 花 飞 絮 满 红 桥
萧 萧 - 白 日 - 禾 稼 - 水 边 - 衰 草==萧 萧 衰 草 傍 墙 生	中 有 寒 虫 白 日 鸣	秋 物 荒 凉 禾 稼 熟	悠 悠 驱 马 水 边 行
雨 后 - 归 去 - 缩 地 - 叠 嶂 - 雨 后==雨 后 沧 波 泯 泯 流	樵 夫 归 去 有 渔 舟	江 郎 缩 地 能 如 此	何 必 双 溪 叠 嶂 游
佳 人 - 生 游 - 柴 东 - 多 情 - 佳 人==曩 译 佳 人 奇 遇 成	每 生 游 想 涉 空 冥	从 今 不 羡 柴 东 海	枉 被 多 情 惹 薄 情
天 山 - 白 云 - 南 山 - 采 采 - 天 山==山 上 青 天 山 下 溪	白 云 流 水 两 相 宜	丹 成 共 尔 南 山 老	采 采 松 枝 亦 疗 饥
天 开 - 屈 曲 - 翠 华 - 佳 哉 - 天 开==慈 泉 地 辟 与 天 开	屈 曲 飞 鸣 声 隐 雷	若 使 翠 华 临 此 地	飞 来 未 必 羡 佳 哉
春 来 - 江 山 - 白 首 - 三 杯 - 春 来==天 上 春 来 谁 报 人	江 山 气 象 一 时 新	懒 将 白 首 簪 幡 胜	寿 酒 三 杯 慰 逐 臣
中 秋 - 今 宵 - 五 岁 - 望 高 - 中 秋==中 秋 无 酒 定 醒 然	清 赏 今 宵 月 已 圆	喜 我 小 儿 才 五 岁	犹 能 倚 户 望 高 天
泪 滴 - 徘 徊 - 春 风 - 桃 花 - 松 楸==泪 滴 松 楸 意 转 哀	欲 归 小 立 更 徘 徊	春 风 不 管 人 间 恨	溪 上 樱 桃 花 自 开
丹 枫 - 半 夜 - 归 心 - 暮 云 - 丹 枫==吴 江 应 已 落 丹 枫	况 说 枫 桥 半 夜 钟	想 见 归 心 成 日 日	暮 云 如 我 忆 江 东
孤 标 - 黄 昏 - 流 水 - 枝 枝 - 孤 标==孤 标 不 肯 结 春 缘	细 雨 黄 昏 腊 正 残	望 断 落 花 流 水 远	枝 枝 点 点 是 微 酸
频 挑 - 空 山 - 多 情 - 东 风 - 灯 火==灯 火 频 挑 只 管 残	雨 声 终 夜 恼 空 山	幸 蒙 晓 月 多 情 白	又 遣 东 风 抵 死 寒
东 风 - 西 湖 - 昨 夜 - 梅 花 - 东 风==消 息 东 风 两 月 前	西 湖 索 莫 老 逋 仙	雪 蓬 昨 夜 还 扶 醉	移 近 梅 花 一 处 眠
天 高 - 心 忆 - 楚 吟 - 风 叶 - 天 高==参 横 月 转 与 天 高	归 士 飞 心 忆 大 刀	故 作 楚 吟 排 滞 思	吟 成 风 叶 更 萧 骚
丹 霞 - 径 斜 - 寻 梅 - 状 元 - 丹 霞==偶 因 祀 事 访 丹 霞	寺 古 山 深 石 径 斜	冲 冻 细 寻 梅 信 息	枝 头 喜 见 状 元 花
春 蝶 - 一 团 - 钗 头 - 惊 飞 - 春 蝶==谁 唱 残 春 蝶 恋 花	一 团 粉 翅 压 枝 斜	美 人 欲 向 钗 头 插	又 恐 惊 飞 鬓 似 鸦
成 桥 - 今 夜 - 秋 声 - 西 风 - 有 无==灵 鹊 成 桥 事 有 无	人 间 今 夜 忆 黄 姑	倚 窗 坐 久 秋 声 动	一 叶 西 风 到 碧 梧
东 风 - 折 镜 - 春 夜 - 待 宫 - 东 风==海 上 东 风 犯 雪 来	腊 前 先 折 镜 湖 梅	遥 思 禁 苑 青 春 夜	坐 待 宫 人 画 诏 回
荷 叶 - 菱 角 - 柳 絮 - 蝶 飞 - 荷 叶==荷 叶 团 团 团 似 镜	菱 角 尖 尖 尖 似 锥	风 吹 柳 絮 毛 扑 走	雨 打 梨 花 蛱 蝶 飞
名 花 - 年 年 - 去 草 - 青 苔 - 名 花==手 种 名 花 梦 亦 随	一 年 年 望 好 花 枝	为 花 去 草 优 饶 处	两 袖 青 苔 十 指 泥
一 夕 - 霁 光 - 芍 药 - 无 力 - 一 夕==一 夕 轻 雷 落 万 丝	霁 光 浮 瓦 碧 差 差	有 情 芍 药 含 春 泪	无 力 蔷 薇 卧 晓 枝
细 细 - 桃 花 - 数 枝 - 千 亩 - 娟 娟==娟 娟 细 细 两 三 丛	却 厌 桃 花 相 近 红	已 有 数 枝 湘 浦 月	不 消 千 亩 渭 川 风
台 榭 - 流 水 - 济 济 - 澄 清 - 巍 峨==巍 峨 台 榭 筑 边 城	碧 海 波 流 水 有 声	济 济 登 临 供 啸 傲	沧 浪 喜 见 一 澄 清
古 殿 - 千 古 - 尘 土 - 欲 飞 - 古 殿==嵯 峨 古 殿 记 飞 来	千 古 传 闻 亦 怪 哉	龙 象 渐 随 尘 土 化	却 疑 神 物 欲 飞 回
汉 苑 - 梅 雨 - 迎 花 - 东 风 - 红 杏==红 杏 花 时 辞 汉 苑	黄 梅 雨 里 上 淮 船	雨 迎 花 送 长 如 此	辜 负 东 风 十 四 年
五 湖 - 小 乔 - 功 名 - 妖 娆 - 五 湖==五 湖 范 蠡 携 西 子	三 国 周 郎 嫁 小 乔	盖 世 功 名 聊 唾 手	何 妨 樽 酒 醉 妖 娆
湖 上 - 冰 霜 - 天 全 - 春 风 - 湖 上==湖 上 无 书 问 老 逋	冰 霜 岩 壑 迥 清 孤	二 更 月 出 天 全 白	转 首 春 风 是 画 图
幽 香 - 钗 头 - 供 燕 - 玉 堂 - 一 轮==一 轮 月 影 涨 幽 香	碧 玉 钗 头 白 玉 妆	持 似 此 花 供 燕 几	玉 堂 端 可 寿 萱 堂
为 裳 - 仍 须 - 梅 花 - 然 全 - 为 裳==木 犀 犹 假 菊 为 裳	兰 也 仍 须 紫 作 章	不 似 梅 花 最 高 洁	温 然 全 是 玉 之 良
绿 杨 - 春 风 - 城 边 - 荒 草 - 绿 杨==津 亭 折 得 绿 杨 枝	更 看 春 风 向 手 吹	建 业 城 边 春 已 老	连 天 荒 草 燕 双 飞
三 白 - 回 风 - 苍 龙 - 击 壤 - 三 白==三 白 从 来 兆 岁 丰	几 看 瑞 雪 舞 回 风	苍 龙 挂 阙 农 祥 正	击 壤 行 歌 我 稼 同
风 流 - 簇 簇 - 牡 丹 - 深 秋 - 富 贵==天 然 富 贵 又 风 流	簇 簇 湘 妃 起 聚 头	唤 做 牡 丹 何 不 可	高 他 一 着 见 深 秋
万 仞 - 当 轩 - 夕 阳 - 晚 风 - 巉 岩==万 仞 巉 岩 插 碧 峰	当 轩 云 树 碧 丛 丛	夕 阳 西 下 湖 光 白	一 棹 歌 声 钓 晚 风
丽 日 - 春 思 - 高 楼 - 谩 遮 - 影 斜==丽 日 烘 帘 幔 影 斜	酒 余 春 思 托 韶 华	高 楼 不 隔 东 南 望	苦 雾 游 云 莫 谩 遮
一 缕 - 千 寻 - 人 间 - 中 秋 - 一 缕==云 无 一 缕 干 明 月	桥 有 千 寻 卧 渌 波	料 得 人 间 无 此 景	中 秋 对 月 兴 如 何
鹤 顶 - 三 尺 - 五 老 - 岁 寒 - 鹤 顶==休 问 霜 林 鹤 顶 丹	空 庭 三 尺 绿 新 攒	从 渠 五 老 掀 髯 笑	我 自 与 师 盟 岁 寒
重 门 - 鹤 舞 - 野 人 - 云 雨 - 重 门==吏 散 重 门 印 不 开	玉 琴 招 鹤 舞 裴 回	野 人 为 此 多 东 望	云 雨 仍 从 海 上 来
半 生 - 独 立 - 明 珠 - 野 藤 - 半 生==半 生 落 魄 已 成 翁	独 立 书 斋 啸 晚 风	笔 底 明 珠 无 处 卖	闲 抛 闲 掷 野 藤 中
碧 玉 - 香 风 - 观 销 - 丈 室 - 碧 玉==蝶 绕 蜂 团 碧 玉 丛	紫 罗 囊 水 透 香 风	自 从 鼻 观 销 烦 恼	疑 在 维 摩 丈 室 中
纵 横 - 随 他 - 圆 明 - 水 生 - 纵 横==万 物 纵 横 在 目 前	随 他 动 静 任 哗 欢	圆 明 定 慧 终 无 染	似 水 生 莲 莲 自 乾
银 烛 - 雪 香 - 春 风 - 一 片 - 银 烛==银 烛 前 头 见 楚 莲	雪 香 轻 袂 掌 中 旋	章 华 台 上 春 风 起	一 片 杨 花 拂 玳 筵
神 仙 - 忠 献 - 诗 句 - 光 华 - 山 水==南 园 山 水 神 仙 窟	上 世 源 充 忠 献 家	昼 锦 堂 中 诗 句 好	因 诗 名 榜 更 光 华
芙 蓉 - 杨 柳 - 何 处 - 月 明 - 芙 蓉==高 僧 夜 滴 芙 蓉 漏	远 客 窗 含 杨 柳 风	何 处 相 逢 话 心 地	月 明 身 在 磬 声 中
有 无 - 山 林 - 云 端 - 神 通 - 有 无==一 声 钟 磬 有 无 中	楼 阁 山 林 本 自 空	不 向 云 端 呈 伎 俩	犹 来 盏 里 现 神 通
梦 蝶 - 穿 花 - 此 时 - 清 明 - 梦 蝶==梦 蝶 庄 周 心 槁 木	入 柳 穿 花 本 无 欲	杯 酒 行 春 当 此 时	忽 遇 清 明 一 百 六
破 屋 - 清 风 - 似 画 - 高 堂 - 破 屋==疾 雷 破 屋 雨 翻 河	一 扫 清 风 未 觉 多	应 似 画 师 吴 道 子	高 堂 巨 壁 写 降 魔
漫 漫 - 声 悲 - 有 恨 - 离 情 - 漫 漫==送 君 无 计 路 漫 漫	玉 笛 声 悲 远 戍 间	自 是 行 人 多 有 恨	离 情 吹 不 到 阳 关
玉 容 - 今 朝 - 出 门 - 半 红 - 玉 容==每 坐 台 前 见 玉 容	今 朝 不 与 昨 朝 同	良 人 一 夜 出 门 宿	减 却 桃 花 一 半 红
日 下 - 宿 鸟 - 夜 半 - 牛 衣 - 村 落==黄 村 落 日 下 山 低	宿 鸟 归 林 亦 倦 飞	夜 半 驱 车 投 北 去	谁 能 慷 慨 泣 牛 衣
林 间 - 雪 开 - 斜 日 - 蹇 驴 - 风 落==林 间 无 叶 供 风 落	溪 上 有 梅 迎 雪 开	斜 日 未 收 门 巷 暖	儿 童 笑 指 蹇 驴 来
成 形 - 威 凤 - 梧 桐 - 高 飞 - 成 形==山 川 蟠 踞 偶 成 形	威 凤 低 回 久 未 行	更 种 梧 桐 真 可 致	高 飞 性 似 伯 夷 清
文 昌 - 朱 门 - 风 月 - 云 雨 - 文 昌==文 昌 星 象 尽 东 来	油 幕 朱 门 次 第 开	且 上 新 楼 看 风 月	会 乘 云 雨 一 时 回
江 楼 - 清 香 - 归 时 - 悠 悠 - 醉 吟==醉 吟 曾 共 倚 江 楼	秾 艳 清 香 万 柄 秋	荡 子 再 归 时 已 暮	暮 鸿 惊 散 水 悠 悠
孤 舟 - 死 身 - 有 情 - 旧 游 - 孤 舟==孤 舟 一 出 广 陵 津	十 五 年 来 未 死 身	我 自 有 情 如 识 面	青 山 宁 忆 旧 游 人
江 天 - 句 句 - 文 章 - 兼 比 - 江 天==当 年 随 意 乐 江 天	句 句 新 诗 尽 可 传	事 业 文 章 两 俱 美	先 生 兼 比 二 公 贤
遗 迹 - 无 生 - 今 夜 - 满 庭 - 遗 迹==欲 寻 遗 迹 强 沾 裳	本 自 无 生 可 得 亡	今 夜 生 公 讲 堂 月	满 庭 依 旧 冷 如 霜
疗 饥 - 人 胜 - 枝 上 - 不 愁 - 疗 饥==香 馥 清 晨 可 疗 饥	饱 人 胜 食 斋 房 芝	便 好 架 巢 枝 上 宿	不 愁 无 酒 呼 愁 诗
望 云 - 碧 海 - 连 天 - 仙 子 - 望 云==遥 观 极 自 望 云 头	碧 海 波 澄 瑞 日 浮	霞 彩 连 天 长 不 断	须 凭 仙 子 叙 踪 由
柳 条 - 粉 墙 - 寂 寞 - 梨 花 - 柳 条==柳 条 金 嫩 不 胜 鸦	青 粉 墙 边 道 蕴 家	燕 子 不 来 春 寂 寞	小 窗 和 雨 梦 梨 花
悠 悠 - 借 阴 - 一 笑 - 佳 名 - 悠 悠==悠 悠 竹 色 蘸 清 尊	更 借 阴 风 荡 午 暄	博 得 亲 颜 开 一 笑	佳 名 须 记 寿 星 轩
锦 绣 - 龙 门 - 凄 凉 - 当 时 - 银 花==万 炬 银 花 锦 绣 围	景 龙 门 外 软 红 飞	凄 凉 但 有 支 头 月	曾 照 当 时 步 辇 归
阑 珊 - 黄 金 - 残 红 - 春 风 - 阑 珊==花 枝 瞥 眼 又 阑 珊	谁 乞 黄 金 反 少 丹	一 院 残 红 堆 不 扫	春 风 开 落 两 回 看
造 化 - 七 弦 - 麒 麟 - 高 山 - 造 化==五 寸 管 能 摹 造 化	七 弦 琴 解 写 人 心	平 生 不 作 麒 麟 梦	且 听 高 山 流 水 音
水 中 - 握 草 - 生 解 - 无 心 - 水 中==水 中 得 火 旨 何 深	握 草 由 来 不 是 金	莫 道 庄 生 解 齐 物	几 人 穷 极 到 无 心
沙 堤 - 逐 臣 - 林 下 - 自 由 - 沙 堤==沙 堤 筑 处 迎 丞 相	驿 吏 催 时 送 逐 臣	到 了 轮 他 林 下 客	无 荣 无 辱 自 由 身
清 明 - 上 苑 - 纸 钱 - 又 随 - 清 明==长 春 门 里 清 明 日	上 苑 兰 风 花 鸟 繁	焚 却 纸 钱 啼 泣 罢	又 随 龙 辇 向 西 园
玉 兔 - 露 井 - 不 语 - 凌 空 - 玉 兔==玉 兔 朝 天 去 不 回	空 馀 露 井 荐 晨 杯	屋 铃 不 语 湖 如 掌	无 复 凌 空 逸 士 来
月 光 - 青 山 - 寒 元 - 花 影 - 月 光==淡 河 斜 浸 月 光 浮	看 尽 青 山 更 倚 楼	残 烛 怕 寒 元 夕 夜	小 栏 花 影 伴 人 愁
春 风 - 池 边 - 游 鱼 - 结 网 - 春 风==池 上 春 风 动 白 苹	池 边 清 浅 见 金 鳞	新 波 已 纵 游 鱼 乐	调 笑 江 头 结 网 人
翠 竹 - 朱 楼 - 春 又 - 清 明 - 翠 竹==白 沙 翠 竹 长 干 寺	绿 水 朱 楼 白 下 城	燕 子 飞 来 春 又 晚	去 年 曾 此 看 清 明
一 片 - 清 吟 - 湖 海 - 茅 屋 - 一 片==一 片 灵 心 著 古 风	清 吟 披 拂 到 衰 翁	从 教 湖 海 相 传 去	知 我 曾 来 茅 屋 中
玉 辇 - 春 风 - 年 年 - 夕 照 - 玉 辇==玉 辇 宸 游 事 已 空	尚 余 奎 藻 绘 春 风	年 年 花 鸟 无 穷 恨	尽 在 苍 梧 夕 照 中
东 堂 - 年 老 - 鸡 唱 - 窗 前 - 岑 寂==东 堂 岑 寂 似 僧 居	年 老 身 闲 不 读 书	病 卧 空 床 鸡 唱 晓	窗 前 饥 雀 啄 寒 蔬
经 年 - 江 山 - 计 相 - 一 纸 - 溪 翁==经 年 不 见 玉 溪 翁	百 里 江 山 万 里 同	无 计 相 从 话 心 曲	时 挥 一 纸 寄 西 风
绿 杨 - 一 望 - 泪 尽 - 归 来 - 陌 上==绿 杨 陌 上 送 行 人	马 去 车 回 一 望 尘	不 觉 别 时 红 泪 尽	归 来 无 泪 可 沾 巾
晚 烟 - 风 前 - 月 明 - 万 里 - 漠 漠==漠 漠 秋 汀 起 晚 烟	半 欹 寒 影 立 风 前	月 明 应 有 芦 花 梦	飞 遍 江 湖 万 里 天
佳 人 - 玉 笛 - 花 心 - 一 枝 - 佳 人==冰 雪 佳 人 貌 最 奇	常 将 玉 笛 向 人 吹	曲 中 无 限 花 心 动	独 许 东 君 第 一 枝
蜀 锦 - 芳 菲 - 天 工 - 翡 翠 - 蜀 锦==蜀 锦 年 来 可 作 衣	西 园 春 色 故 芳 菲	天 工 成 此 新 翻 样	翡 翠 机 中 玉 唾 飞
潺 潺 - 桥 柳 - 黄 莺 - 红 树 - 东 皋==东 皋 纷 绮 水 潺 潺	翠 拂 官 桥 柳 欲 眠	出 谷 黄 莺 终 好 在	辞 风 红 树 稍 萧 然
醉 墨 - 一 樽 - 磊 磊 - 梅 花 - 醉 墨==古 括 人 豪 醉 墨 鲜	一 樽 宁 怯 酒 如 船	新 诗 磊 磊 珠 玑 落	不 记 梅 花 在 眼 前
游 山 - 寂 静 - 不 语 - 满 林 - 游 山==游 山 有 约 爽 秋 时	寂 静 僧 房 花 压 枝	最 是 停 怀 愁 不 语	满 林 啼 鸟 似 催 诗
舞 腰 - 清 声 - 多 情 - 翠 条 - 春 来==仙 乐 春 来 案 舞 腰	清 声 偏 似 傍 娇 饶	应 缘 莺 舌 多 情 赖	长 向 双 成 说 翠 条
凉 风 - 隐 隐 - 积 潦 - 无 声 - 凉 风==凉 风 一 扫 宿 云 轻	隐 隐 收 雷 不 复 惊	试 决 小 池 疏 积 潦	谁 教 蛙 吻 顿 无 声
江 楼 - 燕 语 - 扬 州 - 今 夜 - 江 楼==乱 帆 秋 影 半 江 楼	燕 语 沧 凉 傍 客 舟	便 去 扬 州 且 明 日	故 乡 今 夜 有 人 留
纤 腰 - 春 来 - 原 上 - 长 条 - 纤 腰==枝 斗 纤 腰 叶 斗 眉	春 来 无 处 不 如 丝	霸 陵 原 上 多 离 别	少 有 长 条 拂 地 垂
三 尺 - 菰 叶 - 浙 江 - 震 泽 - 三 尺==三 尺 清 池 窗 外 开	茨 菰 叶 底 戏 鱼 回	雨 声 转 入 浙 江 去	云 影 还 从 震 泽 来
扁 舟 - 南 北 - 一 曲 - 半 生 - 扁 舟==一 琴 一 鹤 一 扁 舟	南 北 东 西 更 九 州	一 曲 湖 山 真 得 计	半 生 交 结 尽 清 流
潮 生 - 药 炉 - 黄 金 - 夜 半 - 潮 生==待 得 潮 生 已 夕 阳	药 炉 无 火 正 凄 凉	傍 人 笑 指 黄 金 骨	夜 半 应 须 解 放 光
何 处 - 万 木 - 蝴 蝶 - 吟 魂 - 前 村==问 言 何 处 是 前 村	万 木 号 寒 雪 障 昏	安 得 梦 为 蝴 蝶 去	花 间 栩 栩 适 吟 魂
风 光 - 春 移 - 知 何 - 及 时 - 风 光==沂 上 风 光 点 独 知	陶 然 宁 复 叹 春 移	吾 人 老 大 知 何 用	仰 止 前 贤 须 及 时
狂 风 - 梦 惊 - 海 门 - 潮 声 - 狂 风==狂 风 横 雨 忽 来 鸣	半 夜 长 亭 客 梦 惊	想 见 海 门 春 涨 争	奔 军 百 万 听 潮 声
凤 凰 - 入 青 - 玉 箫 - 遗 声 - 凤 凰==秦 娥 一 别 凤 凰 台	东 入 青 冥 更 不 回	空 有 玉 箫 千 载 后	遗 声 时 到 世 间 来
郁 郁 - 已 除 - 无 个 - 一 封 - 郁 郁==老 怀 郁 郁 苦 难 舒	忽 报 吾 儿 病 已 除	便 觉 身 心 无 个 事	万 钱 不 抵 一 封 书
眉 头 - 两 岸 - 云 飞 - 残 照 - 眉 头==东 风 吹 恨 上 眉 头	两 岸 桃 花 瞰 碧 流	一 片 红 云 飞 不 起	断 霞 残 照 落 汀 洲
衲 衣 - 腊 月 - 连 延 - 毛 焦 - 衲 衣==衲 衣 下 事 火 烧 山	腊 月 家 贫 彻 骨 寒	堪 笑 连 延 曾 未 息	眉 毛 焦 赤 面 皮 乾
重 重 - 鸣 玉 - 瑶 池 - 月 明 - 重 重==芙 容 作 帐 锦 重 重	比 翼 和 鸣 玉 漏 中	共 道 瑶 池 春 似 海	月 明 飞 下 一 双 鸿
碧 落 - 浮 萍 - 无 穷 - 松 根 - 碧 落==碧 落 当 年 堕 酒 星	醉 中 万 事 一 浮 萍	亦 知 人 世 无 穷 事	一 醉 松 根 不 肯 醒
桃 花 - 雨 打 - 春 光 - 牡 丹 - 桃 花==风 吹 桃 花 西 复 东	雨 打 海 棠 零 乱 红	可 是 春 光 即 消 歇	牡 丹 音 信 未 全 通
悠 悠 - 徘 徊 - 西 风 - 新 霜 - 悠 悠==世 事 悠 悠 酒 几 杯	晴 苍 把 镜 独 徘 徊	西 风 吹 老 梧 桐 树	仍 送 新 霜 两 鬓 来
五 更 - 不 生 - 渔 舟 - 营 营 - 五 更==五 更 催 发 船 无 限	及 此 风 收 浪 不 生	何 事 渔 舟 亦 争 进	始 知 为 利 总 营 营
渺 渺 - 草 茸 - 柳 花 - 城 头 - 渺 渺==春 江 渺 渺 抱 墙 流	烟 草 茸 茸 一 片 愁	吹 尽 柳 花 人 不 见	青 旗 催 日 下 城 头
销 恨 - 野 花 - 枝 头 - 几 度 - 销 恨==蜀 帝 魂 销 恨 不 穷	野 花 开 落 倚 东 风	吻 干 无 复 枝 头 血	几 度 啼 来 染 不 红
玉 环 - 断 肠 - 秦 川 - 飞 燕 - 环 香==锦 囊 留 得 玉 环 香	不 见 佳 人 空 断 肠	北 望 秦 川 烟 草 满	尚 疑 飞 燕 舞 昭 阳
红 英 - 千 株 - 松 窗 - 残 香 - 红 英==红 英 浑 似 识 刘 郎	迎 笑 千 株 夹 路 傍	曙 色 松 窗 留 不 得	断 云 无 处 觅 残 香
黯 黯 - 数 声 - 纱 窗 - 半 夜 - 黯 黯==黯 黯 严 城 罢 鼓 鼙	数 声 相 续 出 寒 栖	不 嫌 惊 破 纱 窗 梦	却 恐 为 妖 半 夜 啼
绿 杨 - 断 霞 - 莺 啼 - 晚 晴 - 闭 户==绿 杨 闭 户 是 谁 家	半 出 红 楼 映 断 霞	无 赖 流 莺 啼 尽 日	晚 晴 门 巷 落 花 多
夜 夜 - 霁 色 - 山 窗 - 暖 气 - 夜 夜==夜 夜 烹 茶 煮 雪 冰	今 霄 霁 色 十 分 澄	山 窗 坐 落 三 更 月	炉 焰 犹 然 暖 气 蒸
风 前 - 双 双 - 传 真 - 不 通 - 风 前==风 前 无 语 立 须 臾	接 得 双 双 锦 鲤 鱼	一 等 是 传 真 的 信	有 通 书 有 不 通 书
第 一 - 凭 栏 - 孤 城 - 落 日 - 第 一==闻 说 淮 南 第 一 山	老 来 方 此 凭 栏 干	孤 城 不 隔 长 安 望	落 日 空 悲 汴 水 寒
晚 风 - 小 寒 - 花 色 - 辈 苍 - 晚 风==窗 竹 悠 悠 度 晚 风	浓 香 醇 酒 小 寒 中	玉 人 尚 作 桃 花 色	我 辈 苍 颜 何 惜 红
造 化 - 红 紫 - 车 马 - 未 必 - 造 化==造 化 从 来 不 负 人	万 般 红 紫 见 天 真	满 城 车 马 空 撩 乱	未 必 逢 春 便 时 春
兰 桡 - 亭 亭 - 莲 子 - 荷 叶 - 兰 桡==兰 桡 回 合 晚 风 过	越 女 亭 亭 立 素 波	莲 子 生 来 悲 较 晚	露 珠 荷 叶 泪 争 多
折 桂 - 文 命 - 东 堂 - 春 风 - 折 桂==名 高 折 桂 方 年 少	心 苦 为 文 命 未 通	闻 说 东 堂 今 有 待	飞 鸣 何 处 及 春 风
萧 萧 - 天 寒 - 桃 李 - 有 恨 - 萧 萧==山 雨 萧 萧 不 肯 住	天 寒 云 愁 光 景 昏	桃 李 红 白 春 风 面	有 恨 无 言 空 泪 痕
高 楼 - 突 兀 - 玉 羽 - 郎 无 - 高 楼==骊 山 六 十 二 高 楼	突 兀 华 清 最 上 头	玉 羽 川 长 湘 浦 暗	三 郎 无 事 更 神 游
冬 冬 - 中 流 - 朝 日 - 春 山 - 冬 冬==急 鼓 冬 冬 下 泗 州	却 瞻 金 塔 在 中 流	帆 开 朝 日 初 生 处	船 转 春 山 欲 尽 头
照 眼 - 江 亭 - 道 人 - 一 日 - 春 光==照 眼 春 光 烂 不 收	江 亭 一 雨 欲 成 秋	道 人 不 是 闲 莺 蝶	肯 为 阴 晴 一 日 愁
中 自 - 凉 露 - 芳 尚 - 夭 桃 - 白 贲==白 贲 黄 中 自 不 群	冷 霜 凉 露 伴 灵 均	集 芳 尚 恨 椒 兰 变	何 况 夭 桃 俗 李 春
扁 舟 - 雨 昏 - 江 上 - 蓼 红 - 晚 风==一 叶 扁 舟 信 晚 风	雨 昏 浑 不 辨 西 东	不 因 再 到 秋 江 上	争 见 芦 花 对 蓼 红
杳 杳 - 深 院 - 燕 语 - 微 雨 - 杳 杳==离 心 杳 杳 思 迟 迟	深 院 无 人 柳 自 垂	日 暮 长 廊 闻 燕 语	轻 寒 微 雨 麦 秋 时
北 风 - 城 头 - 雪 融 - 雪 融 - 北 风==南 风 融 雪 北 风 凝	晚 日 城 头 巳 可 登	莫 道 雪 融 便 无 迹	雪 融 成 水 水 成 冰
塞 北 - 无 人 - 东 堂 - 一 枝 - 塞 北==行 尽 江 南 塞 北 时	无 人 不 诵 鲍 家 诗	东 堂 桂 树 何 年 折	直 至 如 今 少 一 枝
江 湖 - 功 名 - 高 楼 - 白 云 - 江 湖==几 年 宦 迹 浪 江 湖	到 此 功 名 心 已 无	独 上 高 楼 翘 首 望	江 郎 山 下 白 云 孤
车 马 - 阖 扉 - 梅 花 - 带 香 - 车 马==江 郊 车 马 满 斜 晖	争 趁 南 城 未 阖 扉	要 识 梅 花 无 尽 藏	人 人 襟 袖 带 香 归
百 花 - 花 下 - 百 里 - 月 过 - 花 开==吴 王 洲 上 百 花 开	花 下 人 人 劝 酒 杯	醉 卧 春 江 三 百 里	不 知 月 过 海 门 来
江 花 - 笼 烟 - 桃 叶 - 渡 江 - 江 花==江 花 含 笑 欲 争 春	江 水 笼 烟 柳 色 新	商 女 停 舟 唱 桃 叶	东 风 愁 煞 渡 江 人
秋 风 - 竹 簟 - 孤 灯 - 半 夜 - 秋 风==暗 树 秋 风 摆 叶 鸣	桃 枝 竹 簟 冷 逾 清	孤 灯 淡 淡 短 亭 客	半 夜 萧 萧 闻 雨 声
花 萼 - 千 秋 - 倾 城 - 解 愁 - 花 萼==八 月 平 时 花 萼 楼	万 方 同 乐 奏 千 秋	倾 城 人 看 长 竿 出	一 伎 初 成 赵 解 愁
凄 清 - 晚 市 - 何 处 - 人 行 - 凄 清==邑 居 官 寺 两 凄 清	晚 市 都 无 菜 可 羹	何 处 直 能 令 鬼 怕	祗 今 犹 自 有 人 行
祝 融 - 万 重 - 衲 衣 - 白 鹤 - 祝 融==祝 融 高 座 对 寒 峰	云 水 昭 丘 几 万 重	五 月 衲 衣 犹 近 火	起 来 白 鹤 冷 青 松
东 风 - 识 阿 - 归 路 - 太 平 - 东 风==东 风 放 牧 出 长 坡	谁 识 阿 童 乐 趣 多	归 路 转 鞭 牛 背 上	笛 声 吹 老 太 平 歌
腊 雪 - 单 衣 - 无 意 - 林 逋 - 雪 飞==客 子 来 时 腊 雪 飞	出 城 忽 已 试 单 衣	湖 边 移 店 非 无 意	要 共 林 逋 话 别 归
山 水 - 征 鸿 - 魂 销 - 驿 路 - 山 水==影 未 沈 山 水 面 红	遥 天 雨 过 促 征 鸿	魂 销 举 子 不 回 首	闲 照 槐 花 驿 路 中
寸 心 - 得 百 - 家 家 - 处 处 - 太 守==太 守 忧 民 只 寸 心	按 行 安 得 百 其 身	烦 君 为 我 家 家 问	要 使 重 崖 处 处 春
到 处 - 野 花 - 笑 语 - 骆 驼 - 到 处==春 游 到 处 景 堪 夸	厌 戴 名 花 插 野 花	笑 语 懒 行 随 凤 辂	内 官 催 上 骆 驼 车
烛 影 - 更 阑 - 归 来 - 西 风 - 烛 影==蕙 炷 香 销 烛 影 残	御 衣 薰 尽 彻 更 阑	归 来 困 顿 眠 红 帐	一 枕 西 风 梦 里 寒
沧 江 - 白 日 - 杨 柳 - 春 风 - 沧 江==沧 江 城 阔 三 叉 口	白 日 弦 歌 数 亩 宫	犹 有 祠 宫 旧 杨 柳	向 人 离 立 管 春 风
垂 杨 - 解 作 - 似 雪 - 啼 杀 - 垂 杨==垂 杨 无 态 不 堪 夸	犹 有 馀 情 解 作 花	三 月 纷 纷 飞 似 雪	白 门 啼 杀 叛 儿 鸦
十 年 - 白 发 - 诗 情 - 一 曲 - 十 年==三 十 年 前 梦 里 过	重 将 白 发 对 青 蛾	只 应 酒 量 诗 情 在	消 得 筵 前 一 曲 歌
无 力 - 睡 思 - 如 结 - 苍 苔 - 东 风==小 桃 无 力 困 东 风	似 整 残 妆 睡 思 浓	老 子 愁 肠 正 如 结	苍 苔 满 地 点 殷 红
江 南 - 供 诗 - 纷 纷 - 年 蔡 - 江 南==身 落 江 南 不 自 悲	正 欣 梅 也 可 供 诗	纷 纷 桃 李 胡 为 者	政 似 当 年 蔡 克 儿
清 明 - 风 寒 - 恰 恰 - 弄 影 - 寒 食==清 明 寒 食 经 旬 是	笑 问 风 寒 更 几 馀	小 杏 惜 香 春 恰 恰	新 杨 弄 影 午 疏 疏
客 愁 - 杨 子 - 江 南 - 山 色 - 客 愁==客 愁 满 目 政 无 聊	忽 报 船 经 杨 子 桥	未 到 江 南 心 已 喜	隔 江 山 色 碧 相 招
邯 郸 - 欲 熟 - 鸟 迹 - 尚 能 - 邯 郸==邯 郸 四 十 余 年 梦	相 对 黄 粱 欲 熟 时	万 事 只 如 空 鸟 迹	怪 君 强 记 尚 能 追
玉 山 - 新 诗 - 人 争 - 真 娘 - 玉 山==青 盖 红 旗 映 玉 山	新 诗 小 草 落 玄 泉	风 流 使 者 人 争 看	知 有 真 娘 立 道 边
握 手 - 一 水 - 茫 茫 - 持 椒 - 握 手==与 君 握 手 未 经 时	一 水 空 悬 别 后 思	心 事 茫 茫 谁 共 语	自 持 椒 酒 酹 要 离
功 名 - 长 途 - 灯 火 - 读 书 - 功 名==老 去 功 名 意 转 疏	独 骑 瘦 马 取 长 途	孤 村 到 晓 犹 灯 火	知 有 人 家 夜 读 书
如 烟 - 十 年 - 尘 昏 - 萧 然 - 如 烟==干 戈 五 纪 乱 如 烟	吴 越 生 成 八 十 年	遗 像 尘 昏 碑 露 立	三 间 败 屋 独 萧 然
骚 经 - 中 庭 - 子 屡 - 樽 前 - 琅 然==琅 然 醉 读 离 骚 经	一 鹤 闻 之 来 中 庭	童 子 屡 麾 不 肯 去	直 凑 樽 前 侧 顶 听
菩 提 - 大 家 - 逢 道 - 无 价 - 实 见==实 见 菩 提 说 甚 禅	大 家 打 开 过 残 年	相 逢 道 伴 何 言 语	无 价 真 珠 不 用 钱
种 玉 - 翱 翔 - 不 是 - 樊 川 - 种 玉==封 殖 要 当 同 种 玉	翱 翔 端 复 见 停 鸾	此 君 不 是 尘 中 物	岂 减 樊 川 十 万 竿
柳 枝 - 三 月 - 年 年 - 觉 苍 - 柳 枝==醉 折 垂 杨 唱 柳 枝	金 城 三 月 走 金 羁	年 年 为 爱 新 条 好	不 觉 苍 华 也 似 丝
楚 俗 - 流 荇 - 彤 管 - 归 心 - 楚 俗==日 记 采 兰 追 楚 俗	化 孚 流 荇 诵 周 诗	肃 恭 懿 德 垂 彤 管	九 御 归 心 百 福 宜
乘 凉 - 萍 开 - 微 风 - 清 香 - 乘 凉==侵 晓 乘 凉 偶 独 来	不 因 鱼 跃 见 萍 开	卷 荷 忽 被 微 风 触	泻 下 清 香 露 一 杯
重 阳 - 黄 花 - 时 态 - 幽 香 - 重 阳==可 惜 重 阳 已 过 期	黄 花 无 灵 绕 山 篱	政 缘 懒 作 趋 时 态	多 少 幽 香 人 不 知
星 斗 - 一 声 - 小 桥 - 花 深 - 星 斗==千 山 万 山 星 斗 落	一 声 两 声 钟 磬 清	路 入 小 桥 和 梦 过	豆 花 深 处 草 虫 鸣
鸟 迹 - 颠 壑 - 浩 浩 - 酌 酒 - 鸟 迹==飞 雪 蔽 空 无 鸟 迹	长 山 颠 壑 有 人 居	浩 浩 天 地 知 谁 坐	酌 酒 敌 寒 犹 读 书
处 处 - 经 此 - 风 前 - 雪 声 - 处 处==川 上 飞 桥 处 处 横	几 回 经 此 阅 平 生	碧 芦 萧 瑟 风 前 韵	一 似 家 林 霰 雪 声
花 间 - 光 辉 - 青 油 - 雪 飞 - 忘 归==一 到 花 间 一 忘 归	玉 杯 瑶 瑟 减 光 辉	歌 筵 更 覆 青 油 幕	忽 似 朝 云 瑞 雪 飞
梧 桐 - 翠 云 - 黄 金 - 细 雨 - 百 尺==百 尺 梧 桐 画 阁 齐	箫 声 落 处 翠 云 低	平 阳 不 惜 黄 金 埒	细 雨 花 骢 踏 作 泥
桂 花 - 湘 簟 - 银 烛 - 秋 鸿 - 水 精==水 精 帘 动 桂 花 风	湘 簟 凉 生 八 月 中	魄 落 西 窗 银 烛 里	乌 丝 雪 茧 寄 秋 鸿
生 还 - 谈 笑 - 肝 血 - 收 吾 - 生 还==此 生 无 复 望 生 还	一 死 都 归 谈 笑 间	大 地 皆 为 肝 血 污	好 收 吾 骨 首 阳 山
琉 璃 - 光 风 - 盘 中 - 今 朝 - 琉 璃==花 向 琉 璃 地 上 生	光 风 炫 转 紫 云 英	自 从 天 女 盘 中 见	直 至 今 朝 眼 更 明
斜 阳 - 野 人 - 春 色 - 桥 边 - 斜 阳==夕 照 斜 阳 柳 外 鸦	杏 园 衰 谢 野 人 家	欲 寻 春 色 无 寻 处	尽 在 桥 边 野 草 花
九 节 - 铜 瓶 - 自 知 - 清 绝 - 九 节==霜 竹 凝 寒 携 九 节	铜 瓶 浪 锁 千 溪 月	天 上 人 间 不 自 知	行 行 谁 共 分 清 绝
江 边 - 上 山 - 击 鼓 - 中 忧 - 皎 皎==江 边 皎 皎 过 侯 滩	更 上 山 腰 看 打 盘	百 岁 老 儿 亲 击 鼓	城 中 忧 患 不 相 干
将 严 - 朝 献 - 九 重 - 四 海 - 太 室==太 室 裸 将 严 体 荐	景 灵 朝 献 荐 牙 盘	九 重 黼 坐 盘 盂 固	四 海 苍 生 奠 枕 安
五 里 - 未 见 - 杨 柳 - 秋 来 - 五 里==晓 渡 南 冈 五 里 松	精 庐 未 见 已 闻 钟	门 前 拂 地 垂 杨 柳	扫 净 秋 来 过 马 踪
玉 屏 - 好 梦 - 休 人 - 无 力 - 玉 屏==玉 屏 烟 冷 鹧 鸪 斑	翡 翠 帘 遮 好 梦 残	雨 又 未 休 人 又 懒	杏 花 无 力 不 禁 寒
云 华 - 凤 凰 - 区 区 - 成 康 - 云 华==狠 云 华 月 丽 衣 裳	搏 拊 初 登 下 凤 凰	竹 矢 区 区 天 亦 爱	河 图 相 伴 到 成 康
堂 堂 - 点 点 - 清 风 - 梦 中 - 堂 堂==萧 条 冬 事 堂 堂 去	拍 塞 韶 光 点 点 开	明 月 清 风 遮 不 断	暗 香 时 入 梦 中 来
天 台 - 白 花 - 蜂 蝶 - 东 风 - 天 台==酒 旗 犹 写 天 台 红	小 白 花 繁 绿 刺 丛	蜂 蝶 不 来 春 意 静	日 斜 桐 角 奏 东 风
无 尘 - 照 见 - 骑 驴 - 知 孺 - 无 尘==湖 光 如 镜 了 无 尘	照 见 先 生 白 发 新	岁 晚 骑 驴 行 万 里	始 知 孺 子 是 高 人
老 树 - 茅 亭 - 鹭 鸶 - 飞 去 - 数 株==数 株 老 树 半 无 叶	一 个 茅 亭 终 日 空	惟 有 鹭 鸶 尝 到 此	飞 来 飞 去 送 残 红
清 风 - 新 秋 - 渔 翁 - 一 点 - 清 风==明 月 清 风 住 钓 船	新 秋 世 界 落 诗 编	渔 翁 若 遣 骚 人 作	肯 食 人 间 一 点 烟
佳 人 - 团 圆 - 秋 风 - 一 片 - 佳 人==佳 人 失 手 镜 初 分	何 日 团 圆 再 会 君	今 朝 万 里 秋 风 起	山 北 山 南 一 片 云
珍 重 - 分 明 - 洛 下 - 文 章 - 珍 重==珍 重 渠 家 大 小 君	分 明 二 陆 是 前 身	遥 知 洛 下 倾 城 看	锦 样 文 章 玉 样 人
长 歌 - 风 吹 - 明 月 - 照 夜 - 舟 子==舟 子 长 歌 下 急 滩	江 风 吹 我 怯 衣 单	一 轮 明 月 为 谁 好	无 限 清 光 照 夜 寒
天 涯 - 得 一 - 萧 萧 - 荒 山 - 天 涯==行 遍 天 涯 等 断 蓬	作 诗 博 得 一 生 穷	可 怜 老 境 萧 萧 梦	常 在 荒 山 破 驿 中
云 压 - 幽 人 - 敲 冰 - 倚 翠 - 松 枝==云 压 松 枝 拂 石 窗	幽 人 独 坐 鹤 成 双	晚 来 漱 齿 敲 冰 渚	闲 读 仙 书 倚 翠 幢
飞 空 - 随 风 - 天 明 - 寒 声 - 飞 空==飘 烬 飞 空 落 晓 星	随 风 入 草 化 秋 萤	莎 虫 误 认 天 明 子	却 变 寒 声 作 暖 声
人 情 - 绊 身 - 灰 心 - 问 侬 - 人 情==老 景 人 情 一 羽 轻	绊 身 何 用 尚 浮 名	备 尝 世 事 灰 心 久	更 问 侬 当 作 麽 生
古 道 - 烟 霞 - 鱼 堂 - 动 龙 - 丛 林==永 福 丛 林 古 道 场	烟 霞 深 处 白 云 堂	木 鱼 堂 下 常 虚 设	击 动 龙 王 无 处 藏
层 峰 - 阴 阴 - 南 北 - 幽 谷 - 层 峰==湖 外 层 峰 泻 顾 瀑	天 际 阴 阴 长 寒 木	南 北 行 人 望 莫 穷	秋 云 一 片 横 幽 谷
池 通 - 小 拍 - 板 桥 - 上 采 - 通 幽==池 通 幽 涧 碧 如 油	试 水 新 鹅 小 拍 浮	行 过 板 桥 花 片 落	被 风 邀 上 采 菱 舟
淮 水 - 细 雨 - 夜 泊 - 人 烟 - 淮 水==暮 涛 凝 雪 长 淮 水	细 雨 飞 梅 五 月 天	行 子 不 须 愁 夜 泊	绿 杨 多 处 有 人 烟
归 舟 - 雨 打 - 疏 雨 - 梦 中 - 归 舟==归 舟 昔 岁 宿 严 陵	雨 打 疏 篷 听 到 明	昨 夜 茅 檐 疏 雨 作	梦 中 唤 作 打 篷 声
阴 阴 - 日 长 - 风 味 - 南 内 - 阴 阴==竹 殿 阴 阴 间 绿 槐	日 长 棋 罢 看 流 杯	北 窗 风 味 沈 沈 静	南 内 时 新 节 节 来
九 陌 - 看 花 - 丧 非 - 鱼 船 - 处 处==九 陌 初 晴 处 处 春	不 能 回 避 看 花 尘	由 来 得 丧 非 吾 事	本 是 钓 鱼 船 上 人
归 来 - 暑 气 - 一 樽 - 冲 雨 - 归 来==归 来 闻 道 颇 休 闲	蝗 事 今 随 暑 气 残	我 欲 一 樽 供 软 脚	还 能 冲 雨 过 苏 端
晚 潮 - 桔 槔 - 灌 园 - 藜 杖 - 晚 潮==江 边 日 晚 潮 烟 上	树 里 鸦 鸦 桔 槔 响	无 因 得 似 灌 园 翁	十 亩 春 蔬 一 藜 杖
春 老 - 莺 声 - 归 路 - 丹 青 - 春 老==八 九 雨 点 青 春 老	三 两 莺 声 绿 荫 深	眼 界 无 尘 归 路 称	丹 青 难 画 此 中 心
悬 磬 - 相 思 - 黄 花 - 春 风 - 悬 磬==悬 磬 斋 厨 数 米 炊	贫 中 气 味 更 相 思	可 无 昨 日 黄 花 酒	又 是 春 风 柳 絮 时
悠 悠 - 画 楼 - 三 日 - 百 花 - 春 水==官 河 春 水 绿 悠 悠	水 上 人 家 尽 画 楼	买 取 吴 娃 三 日 酒	放 船 直 到 百 花 洲
滚 滚 - 第 一 - 骇 浪 - 汀 洲 - 滚 滚==百 川 滚 滚 到 来 休	此 是 人 间 第 一 流	鲸 鬣 为 君 翻 骇 浪	兰 苕 空 自 满 汀 洲
炙 手 - 趋 炎 - 燃 脐 - 诗 书 - 炙 手==三 生 炙 手 权 门 者	此 日 趋 炎 态 未 除	汝 自 燃 脐 何 所 恨	可 怜 遗 臭 入 诗 书
涧 水 - 杏 花 - 归 来 - 是 去 - 涧 水==去 年 涧 水 今 亦 流	去 年 杏 花 今 又 拆	山 人 归 来 问 是 谁	还 是 去 年 行 春 客
桃 李 - 憔 悴 - 天 涯 - 江 城 - 桃 李==桃 李 村 村 待 发 蒙	孤 芳 憔 悴 不 成 丛	天 涯 一 寸 肠 如 结	吹 断 江 城 晓 角 风
扁 舟 - 千 顷 - 缥 缈 - 白 云 - 明 月==扁 舟 明 月 两 峰 间	千 顷 芦 花 人 未 远	缥 缈 苍 茫 不 可 接	白 云 空 翠 洞 庭 山
吴 江 - 万 里 - 玉 笋 - 龙 吟 - 闲 游==吴 江 楚 泽 闲 游 遍	未 豁 平 生 万 里 心	醉 里 独 携 苍 玉 笋	岳 阳 楼 上 作 龙 吟
金 带 - 三 品 - 山 中 - 春 水 - 荔 枝==红 鞋 金 带 荔 枝 花	三 品 词 林 内 相 家	归 去 山 中 无 个 事	瓦 瓶 春 水 自 煎 茶
霜 姿 - 风 生 - 明 月 - 参 差 - 霜 姿==夫 君 自 是 雪 霜 姿	落 笔 风 生 更 不 疑	留 向 财 前 弄 明 月	桂 枝 相 伴 影 参 差
盖 高 - 篮 舆 - 举 止 - 风 流 - 盖 高==小 盖 高 肩 翼 蔽 无	钟 山 寺 里 换 篮 舆	相 逢 举 止 无 羞 涩	一 段 风 流 似 上 都
地 阔 - 身 即 - 将 驱 - 离 亭 - 多 岐==天 长 地 阔 多 岐 路	身 即 飞 蓬 共 水 萍	匹 马 将 驱 岂 容 易	弟 兄 亲 故 满 离 亭
一 曲 - 塞 上 - 正 发 - 北 风 - 一 曲==闻 君 一 曲 古 梁 州	惊 起 黄 云 塞 上 愁	秦 女 树 前 花 正 发	北 风 吹 落 满 城 秋
南 涧 - 鸥 鸟 - 幽 花 - 高 柳 - 南 涧==春 来 南 涧 水 初 生	鸥 鸟 逢 人 自 不 惊	步 绕 幽 花 随 树 歇	望 寻 高 柳 趁 堤 行
西 湖 - 荷 香 - 山 林 - 梅 花 - 繁 华==西 湖 风 景 绝 繁 华	两 岸 荷 香 十 万 家	除 却 孤 山 林 处 士	后 来 谁 肯 种 梅 花
何 处 - 头 百 - 游 人 - 无 言 - 何 处==春 来 何 处 最 花 繁	湖 水 西 头 百 亩 园	无 限 游 人 折 红 蕊	可 怜 桃 李 自 无 言
云 阴 - 貂 裘 - 不 语 - 书 名 - 云 阴==云 阴 低 重 玉 花 繁	独 拥 貂 裘 对 一 樽	不 语 佳 宾 是 何 物	古 书 名 画 满 西 轩
东 郭 - 高 卧 - 屠 龙 - 千 金 - 东 郭==连 墙 东 郭 倦 追 寻	高 卧 毗 耶 老 病 侵	自 愧 屠 龙 真 拙 技	漫 令 吾 子 费 千 金
朱 颜 - 三 总 - 映 雪 - 风 流 - 朱 颜==朱 颜 绿 鬓 富 春 秋	家 世 才 华 三 总 优	不 用 鹤 裘 兼 映 雪	天 然 标 格 自 风 流
寂 寥 - 手 慵 - 夜 无 - 月 巢 - 寂 寥==霜 重 风 严 景 寂 寥	玉 关 金 锁 手 慵 敲	寒 松 尽 夜 无 虚 籁	老 鹤 移 栖 空 月 巢
前 头 - 残 阳 - 水 石 - 要 假 - 前 头==虎 到 前 头 心 不 惊	残 阳 择 虱 懒 逢 迎	东 林 水 石 未 胜 此	要 假 远 公 方 有 名
城 边 - 客 泪 - 落 花 - 杨 柳 - 城 边==广 武 城 边 逢 暮 春	汶 阳 归 客 泪 沾 巾	落 花 寂 寂 啼 山 鸟	杨 柳 青 青 渡 水 人
橹 声 - 彩 霞 - 船 中 - 安 排 - 橹 声==橹 声 终 日 听 咿 哑	碧 浪 红 旌 动 彩 霞	独 我 船 中 无 一 事	安 排 诗 句 过 桃 花
半 月 - 流 水 - 地 无 - 故 人 - 半 月==半 月 书 斋 淹 病 身	又 随 流 水 下 西 津	重 来 此 地 无 相 识	只 有 钟 山 是 故 人
落 英 - 逐 风 - 夕 阳 - 月 明 - 落 英==上 有 繁 葩 下 落 英	红 波 动 荡 逐 风 行	夕 阳 开 处 犹 光 艳	何 况 今 农 值 月 明
千 株 - 长 乐 - 春 风 - 夜 深 - 千 株==压 沙 寺 後 千 株 雪	长 乐 坊 前 十 里 香	寄 语 春 风 莫 吹 尽	夜 深 留 与 雪 争 光
百 年 - 田 园 - 一 顷 - 屋 二 - 二 百==秦 地 城 池 二 百 年	何 期 如 此 贱 田 园	一 顷 麦 苗 硕 伍 米	三 间 堂 屋 二 千 钱
苍 苍 - 第 芳 - 三 寸 - 一 番 - 江 南==江 南 嘉 木 蔚 苍 苍	能 与 山 梅 次 第 芳	叶 厚 耐 擎 三 寸 雪	飞 初 怯 受 一 番 霜
柔 条 - 万 象 - 门 前 - 不 称 - 柔 条==不 惜 柔 条 折 赠 君	与 君 分 占 万 象 春	祗 愁 五 柳 门 前 景	不 称 三 槐 堂 里 人
夜 灯 - 高 合 - 山 间 - 笑 尘 - 夜 灯==阴 壑 传 闻 炯 夜 灯	几 人 高 合 费 追 寻	山 间 光 景 只 常 事	堪 笑 尘 寰 万 种 心
满 庭 - 倚 栏 - 残 菊 - 一 株 - 满 庭==满 庭 晴 日 破 朝 寒	粥 罢 披 裘 小 倚 栏	残 菊 抱 丛 香 欲 尽	一 株 南 烛 独 如 丹
夕 阳 - 短 篱 - 紫 自 - 暮 蝉 - 夕 阳==槿 华 数 树 夕 阳 时	收 拾 秋 光 在 短 篱	自 紫 自 红 还 自 碧	只 应 独 有 暮 蝉 知
春 来 - 断 肠 - 断 肠 - 花 香 - 入 眼==春 来 百 物 不 入 眼	唯 见 此 花 堪 断 肠	借 问 断 肠 缘 底 事	罗 衣 曾 似 此 花 香
晚 晴 - 星 光 - 飞 去 - 幽 花 - 晚 晴==无 数 舟 航 共 晚 晴	大 星 光 见 月 初 生	背 人 白 鸟 双 飞 去	隔 水 幽 花 一 树 明
风 雨 - 白 发 - 是 元 - 陈 惊 - 雨 过==车 驰 卒 奔 风 雨 过	白 发 故 人 余 一 个	幸 是 元 无 左 阿 君	何 须 不 著 陈 惊 坐
当 贵 - 欲 飞 - 敌 国 - 山 鸟 - 如 龙==卧 如 龙 奋 亮 当 贵	射 可 猿 通 广 欲 飞	谁 料 舟 人 为 敌 国	只 应 山 鸟 怪 儒 衣
三 秋 - 楼 台 - 杵 臼 - 知 更 - 三 秋==三 秋 桂 子 玉 舒 花	天 上 楼 台 出 帝 家	只 许 阿 兔 操 杵 臼	不 知 更 有 玉 虾 蟆
九 节 - 处 处 - 上 山 - 莫 将 - 九 节==一 筇 九 节 添 行 李	用 得 人 间 处 处 尊	只 要 上 山 行 饱 饭	莫 将 风 雪 打 人 门
纷 纷 - 江 上 - 问 扬 - 然 东 - 纷 纷==纷 纷 朝 市 竞 秋 毫	江 上 霜 风 正 怒 号	不 问 扬 澜 与 彭 浪	翩 然 东 下 日 千 艘
堂 前 - 岩 下 - 如 蜜 - 游 山 - 堂 前==云 海 堂 前 饭 鼓 忙	头 陀 岩 下 客 船 香	长 因 笋 蕨 甜 如 蜜	引 得 游 山 潘 孟 阳
英 灵 - 万 里 - 阡 陌 - 苍 生 - 英 灵==英 灵 何 事 卧 云 深	一 举 曾 空 万 里 阴	阡 陌 相 望 苗 就 槁	苍 生 应 待 作 商 霖
洞 府 - 沉 沉 - 碧 桃 - 月 明 - 洞 府==扁 上 金 书 洞 府 名	沉 沉 珠 树 彩 云 轻	碧 桃 风 卷 箫 声 去	弄 玉 乘 鸾 看 月 明
猿 叫 - 夜 半 - 此 时 - 白 云 - 猿 叫==哀 猿 叫 落 中 岩 月	野 客 吟 残 夜 半 灯	此 景 此 时 谁 会 得	白 云 深 处 坐 禅 僧
波 影 - 临 流 - 芳 菲 - 江 花 - 光 华==机 丝 波 影 借 光 华	巴 女 临 流 住 几 家	争 向 芳 菲 偷 锦 样	织 成 平 白 溅 江 花
悠 悠 - 沙 平 - 矶 边 - 危 峰 - 碧 天==碧 天 无 际 日 悠 悠	风 静 沙 平 不 见 洲	彭 浪 矶 边 亦 如 此	危 峰 独 木 系 扁 舟
佳 句 - 诗 成 - 鬼 胆 - 惊 人 - 佳 句==生 来 性 癖 耽 佳 句	吟 得 诗 成 似 有 神	险 语 岂 惟 惊 鬼 胆	直 须 字 字 要 惊 人
水 村 - 闲 倚 - 乡 心 - 残 阳 - 烟 树==水 村 烟 树 与 云 平	闲 倚 孤 舟 念 远 行	无 奈 乡 心 倍 寥 落	残 阳 中 有 鹧 鸪 声
功 名 - 白 日 - 片 云 - 何 处 - 功 名==功 名 碎 啄 与 时 同	譬 似 青 天 白 日 中	不 觉 片 云 随 雨 雹	适 从 何 处 运 神 通
气 蒸 - 烧 丹 - 开 门 - 松 花 - 气 蒸==井 气 蒸 云 湿 石 栏	白 头 道 士 自 烧 丹	开 门 风 带 琴 声 出	一 阵 松 花 满 醮 坛
哀 多 - 揽 衣 - 细 字 - 解 愁 - 哀 多==行 断 哀 多 影 不 留	有 人 中 夜 揽 衣 裘	笔 头 细 字 真 堪 怨	眼 里 长 檠 不 解 愁
月 华 - 江 声 - 半 夜 - 和 雨 - 月 华==月 华 星 彩 坐 来 收	岳 色 江 声 暗 结 愁	半 夜 灯 前 十 年 事	一 时 和 雨 到 心 头
来 去 - 青 山 - 青 山 - 何 处 - 山 中==来 来 去 去 山 中 人	识 得 青 山 便 是 身	青 山 是 身 身 是 我	更 於 何 处 著 根 尘
生 涯 - 岁 华 - 黄 庭 - 风 波 - 生 涯==集 仙 仙 客 问 生 涯	买 得 渔 舟 度 岁 华	案 有 黄 庭 尊 有 酒	少 风 波 处 便 为 家
图 中 - 九 节 - 珍 重 - 林 下 - 画 图==常 瞻 南 极 画 图 中	寿 相 偏 宜 九 节 筇	珍 重 阿 戎 来 寄 我	惭 无 林 下 老 仙 风
阴 阴 - 万 里 - 三 秋 - 十 月 - 白 昼==阴 阴 白 昼 似 昏 黄	平 地 愁 城 万 里 长	稻 卧 三 秋 常 是 雨	菊 残 十 月 尚 无 霜
月 满 - 云 低 - 一 声 - 高 僧 - 月 满==月 满 长 空 树 满 霜	度 云 低 拂 近 檐 床	林 中 夜 半 一 声 磬	卧 见 高 僧 入 道 场
中 秋 - 清 光 - 枕 上 - 强 作 - 中 秋==中 秋 有 约 醉 南 湖	料 此 清 光 已 不 孤	枕 上 不 堪 良 夜 永	起 来 犹 强 作 伊 吾
万 里 - 风 格 - 丹 青 - 佳 人 - 万 里==好 客 精 神 来 万 里	此 君 风 格 耸 双 枝	丹 青 绝 笔 真 难 得	不 似 佳 人 粉 锦 时
烟 花 - 云 脚 - 桃 花 - 芳 草 - 烟 花==烟 花 淡 淡 雨 声 息	云 脚 疏 疏 日 影 红	桃 花 作 雨 梨 花 雪	春 在 绿 杨 芳 草 中
花 木 - 骢 马 - 平 池 - 低 头 - 花 木==山 邮 花 木 似 平 阳	愁 杀 多 情 骢 马 郎	还 似 升 平 池 畔 坐	低 头 向 水 自 看 妆
孤 根 - 枝 上 - 雨 露 - 结 子 - 谢 庭==安 石 孤 根 托 谢 庭	合 欢 枝 上 日 青 青	悬 知 雨 露 深 如 许	结 子 明 朝 似 小 星
宛 转 - 胭 脂 - 剪 彩 - 袅 袅 - 宛 转==宛 转 风 前 不 自 持	妖 娆 微 傅 淡 胭 脂	花 如 剪 彩 层 层 见	枝 似 轻 丝 袅 袅 垂
月 中 - 西 风 - 半 夜 - 挂 玉 - 中 秋==桂 香 吹 老 月 中 秋	人 在 西 风 雁 过 楼	半 夜 枕 寒 清 梦 断	银 河 影 挂 玉 帘 钩
酒 家 - 一 家 - 青 帘 - 霜 风 - 酒 家==一 色 河 边 卖 酒 家	於 中 酒 客 一 家 多	青 帘 不 饮 能 样 醉	弄 杀 霜 风 舞 杀 他
诗 书 - 月 殿 - 洛 阳 - 文 章 - 五 车==饱 学 诗 书 羡 五 车	当 年 月 殿 挺 才 华	洛 阳 自 古 称 多 士	谁 占 文 章 第 一 家
栏 槛 - 玉 蕊 - 一 枝 - 清 香 - 微 凉==薰 风 栏 槛 送 微 凉	洁 白 南 花 玉 蕊 芳	倚 径 一 枝 殊 楚 楚	任 教 蜂 蝶 绕 清 香
年 光 - 送 春 - 何 处 - 东 风 - 年 光==为 惜 年 光 自 不 支	西 楼 谁 唱 送 春 词	出 门 何 处 无 芳 草	欲 倩 东 风 住 少 时
银 烛 - 锦 城 - 对 影 - 履 霜 - 银 烛==银 烛 檀 槽 醉 海 棠	老 来 非 复 锦 城 狂	疏 梅 对 影 太 清 淡	为 拂 焦 桐 弹 履 霜
仍 急 - 无 声 - 千 里 - 黄 昏 - 风 仍==低 云 不 断 风 仍 急	细 雨 无 声 晚 更 稠	千 里 思 君 常 在 眼	黄 昏 天 意 自 春 愁
漠 漠 - 楼 台 - 波 光 - 度 柳 - 漠 漠==漠 漠 轻 云 冒 两 山	楼 台 依 约 有 无 间	画 船 未 出 波 光 定	一 目 新 鸿 度 柳 湾
石 坛 - 红 尘 - 人 迹 - 一 径 - 云 气==云 气 深 深 护 石 坛	红 尘 飞 不 到 阑 干	清 阴 满 地 无 人 迹	一 径 松 风 鹤 梦 寒
冰 玉 - 来 往 - 边 风 - 行 吟 - 溪 山==冰 玉 溪 山 近 与 邻	我 舟 来 往 故 成 频	眼 边 风 物 浑 如 旧	只 欠 行 吟 采 若 人
冰 开 - 风 暖 - 迎 春 - 名 花 - 冰 开==禁 沼 冰 开 跳 锦 鲤	御 林 风 暖 啭 黄 鹂	金 舆 未 下 迎 春 阁	折 遍 名 花 第 一 枝
故 园 - 草 木 - 绕 屋 - 青 山 - 故 园==谁 道 蛮 州 异 故 园	夏 来 草 木 亦 苍 然	扶 疏 绕 屋 平 生 句	有 愧 青 山 啼 杜 鹃
柳 条 - 萧 萧 - 青 山 - 板 桥 - 柳 条==两 岸 人 家 傍 柳 条	玄 晖 遗 迹 自 萧 萧	曾 为 一 夜 青 山 客	未 得 无 情 过 板 桥
碧 天 - 炼 药 - 飞 升 - 百 年 - 碧 天==万 丈 青 山 插 碧 天	真 人 炼 药 石 依 然	功 成 自 此 飞 升 去	屈 指 人 间 八 百 年
江 南 - 一 夜 - 归 晚 - 渔 舟 - 烟 雨==二 月 江 南 烟 雨 多	南 塘 一 夜 涨 春 波	堤 边 游 女 最 归 晚	争 引 渔 舟 作 棹 歌
青 翰 - 荇 花 - 田 田 - 醒 酒 - 徐 夏==青 翰 虚 徐 夏 思 清	愁 烟 漠 漠 荇 花 平	醉 来 欲 把 田 田 叶	尽 裹 当 时 醒 酒 鲭
青 山 - 白 雪 - 养 法 - 白 头 - 青 山==青 山 露 出 本 来 面	白 雪 消 融 清 净 身	松 树 也 知 修 养 法	白 头 翁 作 少 年 人
参 差 - 含 风 - 灯 火 - 残 梦 - 参 差==明 星 惨 澹 月 参 差	万 窍 含 风 各 自 悲	人 散 庙 门 灯 火 尽	却 寻 残 梦 独 多 时
翠 袖 - 一 枝 - 十 年 - 婵 娟 - 翠 袖==翠 袖 无 香 镜 有 尘	一 枝 花 瘦 不 藏 春	十 年 不 识 君 王 面	始 信 婵 娟 解 误 人
无 穷 - 不 息 - 知 瞪 - 莫 着 - 无 穷==天 运 无 穷 成 变 化	水 流 不 息 作 江 淮	须 知 瞪 处 非 无 事	莫 着 仙 人 旧 草 鞋
万 里 - 英 雄 - 拔 山 - 一 笑 - 万 里==万 里 风 中 寄 断 蓬	古 来 虚 死 几 英 雄	拔 山 力 与 回 天 势	不 满 先 生 一 笑 中
岭 梅 - 东 风 - 遗 爱 - 甘 棠 - 三 年==万 里 三 年 醉 岭 梅	东 风 刮 地 马 头 回	心 劳 政 拙 无 遗 爱	惭 向 甘 棠 驿 里 来
冰 壶 - 月 色 - 乘 槎 - 星 汉 - 冰 壶==冰 壶 潋 滟 接 天 浮	月 色 云 光 寸 寸 秋	不 用 乘 槎 厉 东 海	一 江 星 汉 拥 行 舟
茫 茫 - 牧 童 - 尘 少 - 一 点 - 茫 茫==烟 草 茫 茫 楚 泽 秋	牧 童 吹 笛 唤 归 牛	九 衢 不 是 风 尘 少	一 点 能 来 此 地 不
滩 声 - 寒 漏 - 木 落 - 霜 风 - 滩 声==滩 声 吹 浪 城 边 壮	寒 漏 锵 金 枕 畔 摇	庭 树 不 随 群 木 落	霜 风 著 叶 夜 萧 萧
花 萼 - 蒙 蒙 - 金 钱 - 倚 阑 - 花 萼==花 萼 楼 前 春 正 浓	蒙 蒙 柳 絮 舞 晴 空	金 钱 掷 罢 娇 无 力	笑 倚 阑 干 屈 曲 中
蛾 眉 - 歌 声 - 花 万 - 蝶 飞 - 蛾 眉==蛾 眉 对 歌 舞 凉 伊	舞 身 还 逐 歌 声 齐	卷 花 万 段 忽 进 酒	斩 高 蝴 蝶 飞 来 低
桃 花 - 碧 草 - 洞 口 - 青 山 - 武 陵==桃 花 落 尽 武 陵 溪	碧 草 芊 芊 岸 柳 齐	洞 口 主 人 今 不 在	青 山 如 画 鸟 空 啼
棹 歌 - 芦 花 - 风 光 - 得 月 - 渔 唱==棹 歌 渔 唱 泛 蟾 辉	两 岸 芦 花 水 四 围	此 地 风 光 真 赤 壁	满 船 载 得 月 明 皈
宝 攒 - 昆 池 - 珊 瑚 - 珠 玑 - 山 夜==环 宝 攒 山 夜 陆 离	主 家 新 凿 定 昆 池	珊 瑚 未 大 诸 韦 死	多 少 珠 玑 向 月 悲
市 廛 - 青 山 - 突 兀 - 竹 床 - 市 廛==茅 斋 悔 著 市 廛 间	长 与 青 山 面 目 悭	突 兀 小 楼 初 结 就	竹 床 石 枕 卧 看 山
绳 桥 - 堪 闻 - 年 月 - 使 君 - 绳 桥==竹 屋 绳 桥 自 有 村	牛 山 箫 笛 不 堪 闻	碑 前 更 问 何 年 月	为 借 容 州 旧 使 君
疏 花 - 琼 葩 - 人 情 - 黄 梅 - 疏 花==疏 花 早 不 奈 香 何	三 叠 琼 葩 底 用 多	最 是 动 人 情 意 处	黄 梅 已 老 未 逢 荷
商 山 - 古 木 - 会 府 - 江 城 - 玉 山==商 山 路 接 玉 山 深	古 木 苍 然 尽 合 阴	会 府 登 筵 君 最 少	江 城 秋 至 肯 惊 心
碧 落 - 断 红 - 高 眠 - 沉 西 - 千 尺==冲 开 碧 落 松 千 尺	截 断 红 尘 水 一 溪	饱 食 高 眠 人 不 到	日 从 东 出 又 沉 西
双 凤 - 伤 心 - 花 暗 - 罗 裙 - 双 凤==压 髻 慵 簪 双 凤 钗	伤 心 羞 觑 合 欢 鞋	折 花 暗 卜 郎 音 信	旋 击 罗 裙 走 下 阶
荷 衣 - 芦 花 - 月 满 - 鱼 矶 - 西 风==西 风 淅 淅 吹 荷 衣	家 在 芦 花 深 夜 归	明 月 满 江 人 不 见	白 鸥 双 立 钓 鱼 矶
容 易 - 留 侯 - 尔 尔 - 后 人 - 一 夫==一 夫 容 易 缚 淮 阴	辟 谷 留 侯 念 已 深	去 伴 赤 松 聊 尔 尔	后 人 真 向 海 山 寻
风 吹 - 芙 蓉 - 凌 波 - 水 中 - 风 吹==海 风 吹 绉 蔚 蓝 天	山 涌 芙 蓉 月 涌 莲	对 对 凌 波 尘 袜 小	相 逢 多 是 水 中 仙
鬓 霜 - 芍 药 - 江 水 - 洛 阳 - 鬓 霜==南 渡 年 来 两 鬓 霜	牡 丹 芍 药 但 他 乡	即 从 江 水 浮 淮 水	便 上 维 扬 向 洛 阳
夜 月 - 一 段 - 欹 枕 - 故 乡 - 夜 月==谁 家 夜 月 响 秋 砧	一 段 清 愁 不 自 禁	况 是 客 中 欹 枕 听	声 声 捣 碎 故 乡 心
垂 垂 - 万 木 - 渔 人 - 柳 絮 - 垂 垂==垂 垂 四 幕 冻 云 顽	万 木 号 风 晚 更 寒	系 缆 渔 人 归 去 后	乱 飞 柳 絮 满 江 干
金 殿 - 芙 蓉 - 元 日 - 五 色 - 金 殿==金 殿 当 头 紫 阁 重	仙 人 掌 上 玉 芙 蓉	太 平 天 子 朝 元 日	五 色 云 车 驾 六 龙
水 流 - 菊 花 - 登 高 - 青 山 - 水 流==客 子 光 阴 似 水 流	西 风 吹 老 菊 花 秋	今 年 不 用 登 高 去	人 在 青 山 最 上 头
晚 岁 - 今 朝 - 长 老 - 林 下 - 晚 岁==中 军 晚 岁 甥 辞 去	左 相 今 朝 客 不 来	看 取 少 林 诚 长 老	死 生 林 下 伴 寒 斋
梢 头 - 阑 干 - 东 君 - 岁 寒 - 梢 头==为 觅 梢 头 一 点 酸	缥 枝 红 萼 谩 阑 干	东 君 已 误 当 时 约	犹 敛 幽 芳 待 岁 寒
风 日 - 高 歌 - 无 佗 - 密 密 - 风 日==云 敛 长 空 风 日 和	太 平 樵 牧 共 高 歌	衲 僧 饭 饱 无 佗 事	密 密 机 前 弄 玉 梭
青 山 - 茅 屋 - 扁 舟 - 把 钓 - 青 山==江 上 青 山 千 万 叠	水 边 茅 屋 两 三 间	朝 来 无 限 扁 舟 过	何 似 渠 侬 把 钓 竿
雨 霁 - 年 光 - 桃 李 - 多 情 - 雨 霁==雨 霁 风 和 日 渐 长	小 园 尊 酒 答 年 光	直 令 桃 李 能 言 语	何 似 多 情 睡 海 棠
石 门 - 凝 烟 - 庭 寒 - 树 老 - 石 门==石 门 有 雪 无 行 迹	松 壑 凝 烟 满 众 香	馀 食 施 庭 寒 鸟 下	破 衣 挂 树 老 僧 亡
浓 绿 - 江 风 - 水 面 - 画 屏 - 浓 绿==淡 处 还 浓 绿 处 青	江 风 吹 作 雨 毛 腥	起 从 水 面 萦 层 嶂	恍 似 帘 中 见 画 屏
积 翠 - 鸥 鹭 - 樊 川 - 烟 雨 - 南 山==寺 对 南 山 积 翠 浓	水 村 鸥 鹭 下 遥 空	层 楼 望 尽 樊 川 景	恨 不 凭 栏 烟 雨 中
交 情 - 雷 惊 - 非 吾 - 仔 细 - 交 情==道 义 交 情 不 用 盟	鸣 谦 肯 作 震 雷 惊	论 功 平 勃 非 吾 事	付 与 人 间 仔 细 评
雪 后 - 参 差 - 清 夜 - 倚 栏 - 雪 后==海 山 雪 后 海 天 宽	群 玉 参 差 万 里 寒	岩 谷 无 人 共 清 夜	倚 栏 独 向 月 中 看
酣 饮 - 倚 楼 - 一 点 - 海 门 - 酣 饮==与 君 未 别 且 酣 饮	别 后 令 人 空 倚 楼	一 点 风 帆 若 为 望	海 门 平 阔 鹭 涛 秋
寂 寞 - 落 日 - 五 更 - 人 语 - 茅 檐==茅 檐 寂 寞 住 人 稀	落 日 逢 迎 宿 酒 旗	梦 觉 五 更 山 月 上	溪 边 人 语 钓 船 移
铅 华 - 清 绝 - 和 羹 - 草 木 - 铅 华==费 尽 铅 华 总 失 真	色 香 清 绝 两 无 邻	待 渠 经 始 和 羹 了	乞 与 无 边 草 木 春
曙 色 - 初 霁 - 芳 树 - 春 风 - 曙 色==隔 市 炊 烟 曙 色 迟	小 城 初 霁 客 来 时	娇 莺 历 历 啼 芳 树	不 解 春 风 有 别 离
爽 气 - 百 里 - 冰 玉 - 难 攀 - 西 山==朝 来 爽 气 致 西 山	孰 愈 严 州 百 里 间	佣 贩 悬 知 尽 冰 玉	不 惟 二 士 眇 难 攀
延 年 - 蟾 宫 - 娥 蒙 - 桂 花 - 延 年==饮 冰 啮 雪 傅 延 年	要 比 蟾 宫 桂 子 妍	忽 遇 嫦 娥 蒙 一 盼	桂 花 未 敢 著 鞭 先
上 元 - 箫 鼓 - 高 门 - 金 盘 - 上 元==升 平 重 见 上 元 天	箫 鼓 声 中 璧 月 圆	惟 有 高 门 更 多 喜	金 盘 分 送 洗 儿 钱
水 云 - 柴 门 - 隐 居 - 岸 帻 - 水 云==城 郭 村 墟 共 水 云	槿 篱 竹 屋 映 柴 门	隐 居 亦 有 高 人 在	岸 帻 无 言 倚 钓 轩
衰 颜 - 三 年 - 长 短 - 得 一 - 衰 颜==老 我 衰 颜 百 念 煎	梅 山 少 我 十 三 年	人 生 不 问 寿 长 短	得 一 日 宽 皆 是 仙
上 林 - 夜 半 - 笙 箫 - 杨 梅 - 上 林==上 林 献 赋 恨 空 回	水 驿 冰 鲜 夜 半 催	枕 上 笙 箫 听 渐 近	杨 梅 卢 橘 过 江 来
纵 横 - 天 王 - 旂 直 - 凤 阙 - 纵 横==齐 鲁 纵 横 豺 虎 群	天 王 亲 拜 大 将 军	牙 旂 直 卷 狼 山 雪	金 印 还 瞻 凤 阙 云
云 蒸 - 玉 树 - 还 有 - 花 灯 - 瑶 林==瑶 林 春 意 似 云 蒸	娇 怯 难 支 玉 树 零	剩 绮 余 芬 还 有 韵	夜 阑 频 点 照 花 灯
垂 纶 - 溪 边 - 不 言 - 惊 鱼 - 垂 纶==每 嗟 船 子 惯 垂 纶	恒 泊 溪 边 荻 映 身	人 问 不 言 头 自 点	恐 惊 鱼 去 不 应 人
青 山 - 绝 顶 - 下 榻 - 折 券 - 青 山==欲 买 青 山 贷 寓 居	时 临 绝 顶 瞰 平 湖	已 容 下 榻 烦 重 问	肯 念 吾 贫 折 券 无
冷 淡 - 相 同 - 东 风 - 北 风 - 千 古==千 古 甘 心 冷 淡 中	却 于 春 事 不 相 同	东 风 只 解 吹 花 落	吹 得 花 开 是 北 风
杜 鹃 - 流 水 - 春 归 - 际 天 - 杜 鹃==一 夜 空 山 闻 杜 鹃	落 花 流 水 两 茫 然	凭 栏 不 觉 春 归 去	目 极 平 芜 绿 际 天
凉 风 - 万 里 - 关 塞 - 梦 魂 - 凉 风==凉 风 台 上 三 峰 月	不 夜 城 边 万 里 沙	离 别 莫 言 关 塞 远	梦 魂 长 在 子 真 家
润 下 - 撒 盐 - 为 霖 - 调 羹 - 润 下==润 下 因 何 自 上 来	空 中 真 有 撒 盐 才	庖 人 若 解 为 霖 味	清 水 调 羹 只 用 梅
公 卿 - 风 波 - 桥 下 - 湍 急 - 公 卿==隋 唐 而 下 贵 公 卿	近 世 风 波 走 利 名	借 问 天 津 桥 下 水	当 时 湍 急 作 何 声
丹 砂 - 寂 寞 - 当 车 - 春 归 - 丹 砂==重 萼 丹 砂 品 最 高	可 怜 寂 寞 弃 蓬 莴	会 当 车 载 金 钱 去	买 取 春 归 亦 足 豪
津 梁 - 君 郑 - 风 流 - 无 情 - 津 梁==残 客 津 梁 握 手 欷	多 君 郑 重 问 乌 衣	故 家 自 怨 风 流 歇	肯 骂 无 情 燕 子 飞
分 明 - 分 明 - 留 形 - 万 象 - 分 明==见 得 分 明 乃 谓 如	分 明 如 此 尚 为 疏	莫 於 见 处 留 形 迹	方 信 心 斋 万 象 虚
利 名 - 胸 中 - 憎 皆 - 灵 台 - 胸 中==利 名 都 不 到 胸 中	由 此 胸 中 气 自 冲	既 爱 且 憎 皆 是 病	灵 台 何 日 得 从 容
百 年 - 一 枝 - 无 人 - 杏 花 - 百 年==三 百 年 来 处 士 家	酒 旗 风 里 一 枝 斜	段 桥 荒 藓 无 人 问	颜 色 而 今 似 杏 花
来 追 - 按 剑 - 神 明 - 何 处 - 来 追==北 来 追 骑 满 江 滨	那 更 元 戎 按 剑 嗔	不 是 神 明 扶 正 直	淮 头 何 处 可 安 身
雪 声 - 飘 萧 - 有 意 - 飞 花 - 雪 声==雨 闹 雪 声 相 杂 下	飘 萧 密 势 洒 空 来	北 风 有 意 待 寒 腊	只 放 飞 花 一 半 开
腐 草 - 歌 钟 - 市 为 - 光 芒 - 虹 桥==七 里 虹 桥 腐 草 腥	歌 钟 词 赋 两 飘 零	不 随 天 市 为 消 长	文 字 光 芒 聚 德 星
秀 色 - 雨 浥 - 倒 影 - 烂 熳 - 秀 色==出 肋 梅 花 秀 色 新	不 堪 寒 雨 浥 清 尘	故 应 倒 影 澄 澜 碧	湿 玉 吹 香 烂 熳 春
梅 开 - 巡 檐 - 点 缀 - 佳 名 - 梅 开==南 州 要 是 梅 开 早	北 客 巡 檐 偏 眼 明	一 夜 飞 花 来 点 缀	新 亭 而 复 得 佳 名
花 繁 - 余 香 - 数 声 - 半 山 - 桑 条==桑 条 索 漠 栋 花 繁	风 敛 余 香 暗 度 垣	黄 鸟 数 声 残 午 梦	尚 疑 身 属 半 山 园
绿 华 - 梅 花 - 无 人 - 粉 面 - 绿 华==萼 绿 华 堂 艮 岳 东	梅 花 万 数 绕 离 宫	宣 和 旧 事 无 人 记	粉 面 含 凄 向 朔 风
缝 掖 - 生 涩 - 灯 前 - 江 神 - 缝 掖==缝 掖 无 由 挂 铁 衣	剑 花 生 涩 马 空 肥	灯 前 划 就 平 南 策	一 夜 江 神 涕 泣 归
银 河 - 月 华 - 金 莲 - 五 夜 - 银 河==天 碧 银 河 欲 下 来	月 华 如 水 浸 楼 台	谁 将 万 斛 金 莲 子	撤 向 星 都 五 夜 开
洛 阳 - 东 风 - 春 归 - 一 年 - 洛 阳==征 衣 消 尽 洛 阳 尘	泣 向 东 风 拭 泪 痕	不 及 青 春 归 有 信	一 年 一 别 乐 游 园
撷 青 - 白 头 - 束 帛 - 封 侯 - 撷 青==撷 青 日 日 饭 疲 牛	识 字 耕 夫 已 白 头	束 帛 不 来 山 鬼 笑	有 人 马 上 觅 封 侯
瑶 阶 - 南 山 - 为 深 - 道 人 - 瑶 阶==瑶 阶 金 殿 涌 青 莲	此 是 南 山 小 有 天	诗 客 若 为 深 避 酒	道 人 无 奈 不 参 禅
山 灵 - 栋 梁 - 龙 髯 - 游 人 - 山 灵==松 是 山 灵 一 手 栽	尧 天 长 就 栋 梁 材	龙 髯 怒 起 春 风 急	似 怪 游 人 喝 道 来
天 寒 - 泠 泠 - 一 枝 - 春 风 - 天 寒==日 暮 天 寒 小 驿 亭	竹 边 流 水 浅 泠 泠	一 枝 蚤 落 诗 人 手	无 恨 春 风 入 胆 瓶
方 丈 - 舞 琼 - 和 气 - 道 人 - 方 丈==老 病 维 摩 方 丈 开	天 风 破 冷 舞 琼 瑰	满 山 皓 色 作 和 气	知 是 道 人 冲 雪 来
不 同 - 春 风 - 寻 芳 - 解 作 - 不 同==花 叶 根 茎 迥 不 同	略 无 些 字 犯 春 风	羽 衣 纵 落 寻 芳 后	解 作 清 凉 烈 日 中
树 头 - 花 气 - 富 贵 - 通 明 - 树 头==银 烛 千 枝 插 树 头	烛 光 花 气 半 空 浮	人 间 富 贵 真 珠 室	天 上 通 明 白 玉 楼
流 霞 - 翠 袖 - 萧 然 - 客 思 - 流 霞==霓 裳 舞 罢 醉 流 霞	翠 袖 频 揎 眼 欲 花	丈 室 萧 然 那 用 此	春 深 料 得 客 思 家
千 载 - 霜 叶 - 坤 一 - 春 风 - 骚 人==千 载 骚 人 沉 骨 冷	冰 霜 叶 底 见 幽 香	乾 坤 一 种 忠 良 气	弹 压 春 风 众 草 芳
横 斜 - 高 低 - 僧 窗 - 置 在 - 花 木==花 木 横 斜 转 小 蹊	疏 帘 竹 屋 任 高 低	何 人 移 得 僧 窗 静	置 在 君 家 厅 事 西
六 月 - 第 一 - 看 云 - 萧 萧 - 六 月==去 年 六 月 焦 原 雨	入 得 东 州 第 一 朝	今 日 看 云 旧 时 节	又 来 农 畔 听 萧 萧
纷 纷 - 森 森 - 微 甘 - 崖 蜜 - 纷 纷==纷 纷 青 子 落 红 盐	正 味 森 森 苦 且 严	待 得 微 甘 回 齿 颊	已 输 崖 蜜 十 分 甜
尘 埃 - 老 柏 - 天 阶 - 住 庵 - 尘 埃==尘 埃 奔 走 尚 飘 蓬	想 听 庵 头 老 柏 风	会 向 天 阶 乞 衰 晚	住 庵 长 作 主 人 翁
青 女 - 东 君 - 冰 山 - 白 云 - 青 女==青 女 欺 花 战 未 分	花 神 直 诉 与 东 君	冰 山 回 首 知 何 许	依 旧 山 人 住 白 云
早 春 - 雪 消 - 得 意 - 东 风 - 早 春==早 春 风 力 已 轻 柔	瓦 雪 消 残 玉 半 沟	飞 蝶 鸣 鸠 俱 得 意	东 风 应 笑 我 闲 愁
秋 江 - 青 山 - 来 住 - 烦 君 - 不 许==秋 江 不 许 一 尘 染	只 有 青 山 倒 影 寒	我 欲 移 家 来 住 此	烦 君 先 为 斩 鱼 竿
水 轩 - 金 樽 - 侵 夜 - 闭 门 - 风 扫==先 倩 清 风 扫 水 轩	更 呼 凉 月 倒 金 樽	定 知 明 府 归 侵 夜	县 郭 留 灯 未 闭 门
山 林 - 雨 意 - 骥 足 - 有 刘 - 山 林==放 虎 山 林 计 已 非	蛟 龙 云 雨 意 犹 迟	士 元 骥 足 思 腾 踏	盍 有 刘 琮 不 告 时
西 风 - 黄 昏 - 功 名 - 自 忆 - 古 道==萧 萧 古 道 西 风 雨	惨 惨 黄 昏 匹 马 行	未 遇 功 名 莫 嗟 叹	逢 时 更 自 忆 平 生
碧 海 - 时 仙 - 乘 风 - 洞 天 - 碧 海==碧 海 何 年 已 变 田	空 传 双 舄 旧 时 仙	乘 风 欲 挹 浮 邱 袖	同 访 朱 明 别 洞 天
更 阑 - 金 钿 - 丝 眠 - 悲 笳 - 更 阑==更 阑 炙 烛 绣 檐 遮	卸 却 金 钿 与 翠 花	心 似 乱 丝 眠 不 得	江 楼 中 夜 咽 悲 笳
瘦 骨 - 驰 驱 - 松 楸 - 读 书 - 瘦 骨==瘦 骨 岩 岩 祸 患 馀	追 随 人 事 愈 驰 驱	何 时 酒 扫 松 楸 畔	小 盖 茅 庵 只 读 书
白 日 - 三 月 - 桃 花 - 踏 歌 - 白 日==白 日 相 思 可 奈 何	青 春 三 月 已 无 多	桃 花 风 急 鲤 鱼 老	独 上 台 城 听 踏 歌
佩 玉 - 幽 花 - 兄 弟 - 处 处 - 佩 玉==佩 玉 垂 绅 廊 庙 人	幽 花 小 草 岂 其 伦	须 知 四 海 皆 兄 弟	淡 泊 论 交 处 处 亲
寒 塘 - 蝴 蝶 - 无 穷 - 幽 人 - 寒 塘==影 落 寒 塘 月 照 时	梦 为 蝴 蝶 绕 高 枝	画 工 欲 画 无 穷 意	不 道 幽 人 圣 得 知
笔 下 - 墨 晕 - 纸 帐 - 梅 花 - 淇 澳==淇 澳 新 梢 笔 下 分	枕 屏 墨 晕 点 寒 云	诗 人 纸 帐 眠 清 夜	不 梦 梅 花 梦 此 君
重 阳 - 今 朝 - 黄 花 - 处 处 - 故 乡==去 岁 重 阳 尚 故 乡	今 朝 官 舍 又 重 阳	人 情 不 似 黄 花 好	处 处 相 逢 一 种 香
青 青 - 羊 肠 - 畦 岸 - 尘 甑 - 青 青==小 麦 青 青 大 麦 黄	护 田 沙 迳 绕 羊 肠	秧 畦 岸 岸 水 初 饱	尘 甑 家 家 饭 已 香
登 临 - 往 事 - 深 浅 - 崆 峒 - 登 临==登 临 犹 觉 酒 边 豪	往 事 新 愁 付 一 陶	深 浅 不 常 章 贡 水	崆 峒 只 似 旧 时 高
力 微 - 夜 深 - 花 梢 - 东 风 - 力 微==脸 晕 轻 红 酒 力 微	真 妃 半 醉 夜 深 时	杜 鹃 叫 落 花 梢 月	独 倚 东 风 睡 不 足
远 信 - 流 年 - 相 问 - 一 树 - 秦 无==家 隔 西 秦 无 远 信	身 随 东 洛 度 流 年	病 来 旅 馆 谁 相 问	牢 落 间 庭 一 树 蝉
春 风 - 夜 月 - 露 带 - 帘 幕 - 颠 狂==春 风 尽 日 恣 颠 狂	吹 散 游 云 夜 月 光	露 带 清 寒 入 花 骨	暗 寻 帘 幕 度 幽 香
带 难 - 彭 泽 - 高 情 - 名 园 - 为 米==为 米 徒 劳 束 带 难	当 时 彭 泽 便 休 官	高 情 曾 赋 归 来 句	尽 入 名 园 扁 署 看
得 意 - 忘 言 - 寒 尽 - 野 花 - 得 意==蚁 窠 得 意 从 渠 计	螳 翳 忘 言 息 我 机	寒 尽 山 庵 无 历 日	野 花 啼 鸟 又 春 归
吹 箫 - 幽 馆 - 龙 盘 - 宁 王 - 吹 箫==秦 女 吹 箫 蹑 彩 霞	孤 茔 幽 馆 掩 梨 花	龙 盘 金 写 崇 真 字	犹 是 宁 王 赐 嗣 华
三 年 - 一 日 - 南 北 - 归 去 - 三 年==三 年 耀 武 群 雄 服	一 日 回 銮 万 国 春	南 北 通 欢 永 无 事	谢 恩 归 去 老 陪 臣
万 里 - 街 鼓 - 梅 花 - 天 明 - 憔 悴==万 里 江 湖 憔 悴 身	冬 冬 街 鼓 不 饶 人	只 愁 一 夜 梅 花 老	看 到 天 明 付 与 春
秋 风 - 数 声 - 残 暑 - 华 池 - 秋 风==一 宿 秋 风 未 觉 凉	数 声 宫 漏 日 犹 长	林 泉 无 计 消 残 暑	虚 向 华 池 费 稻 粱
做 春 - 白 日 - 白 日 - 百 花 - 正 少==侬 做 春 花 正 少 年	郎 做 白 日 在 青 天	白 日 在 天 光 在 地	百 花 谁 不 愿 郎 怜
篱 边 - 猛 虎 - 北 斗 - 地 轴 - 篱 边==俊 鹞 不 打 篱 边 兔	猛 虎 终 不 食 伏 肉	毛 头 星 现 北 斗 前	把 断 天 关 并 地 轴
花 市 - 罗 绮 - 何 处 - 客 心 - 花 市==花 市 银 灯 夜 向 深	香 风 罗 绮 迥 沈 沈	不 知 何 处 笙 歌 起	传 得 新 愁 上 客 心
寺 朝 - 亭 晚 - 千 古 - 烟 微 - 朝 餐==十 三 楼 寺 朝 餐 饭	六 一 泉 亭 晚 举 觞	千 古 湖 山 难 模 处	淡 烟 微 雨 更 斜 阳
黯 黯 - 数 声 - 纱 窗 - 半 夜 - 黯 黯==黯 黯 严 城 罢 鼓 鼙	数 声 相 续 出 寒 栖	不 嫌 惊 破 纱 窗 梦	却 怕 为 妖 半 夜 啼
春 阴 - 疏 枝 - 闻 香 - 饶 舌 - 春 阴==春 阴 欲 雪 冻 云 乾	索 笑 疏 枝 共 一 寒	静 裹 闻 香 祗 自 觉	怕 人 饶 舌 似 丰 干
千 山 - 寂 寥 - 一 年 - 今 朝 - 玉 人==千 山 万 水 玉 人 遥	人 事 音 书 谩 寂 寥	惆 怅 一 年 春 又 去	更 无 消 息 到 今 朝
沧 洲 - 琅 函 - 鱼 龙 - 光 浮 - 叶 下==手 持 贝 叶 下 沧 洲	千 部 琅 函 是 度 舟	应 有 鱼 龙 护 方 广	锦 江 春 色 镜 光 浮
笔 力 - 正 始 - 池 塘 - 清 襟 - 笔 力==卢 溪 笔 力 透 天 心	杨 令 文 追 正 始 音	更 读 池 塘 惠 连 句	识 君 何 待 接 清 襟
旗 亭 - 梅 花 - 枝 头 - 春 风 - 沽 酒==旗 亭 沽 酒 少 裴 回	左 手 梅 花 右 手 杯	眼 见 枝 头 开 数 蕊	春 风 自 我 掌 中 来
一 曲 - 草 木 - 简 无 - 风 鸟 - 一 曲==一 曲 回 看 天 鉴 池	一 边 草 木 与 云 齐	金 龙 玉 简 无 寻 处	花 自 春 风 鸟 自 啼
峥 嵘 - 千 尺 - 柳 丝 - 多 情 - 万 木==森 森 万 木 势 峥 嵘	千 尺 孤 标 更 上 征	惟 有 柳 丝 低 拂 路	腰 支 憔 悴 为 多 情
招 提 - 西 风 - 烟 霞 - 百 年 - 招 提==相 从 偶 到 招 提 寺	独 对 西 风 忆 羽 人	澹 泊 烟 霞 深 处 卧	百 年 衣 钵 此 生 身
辞 家 - 山 间 - 桃 花 - 纷 纷 - 辞 家==年 少 辞 家 不 畏 劳	山 间 绿 树 戍 楼 高	桃 花 不 合 浑 如 泪	和 雨 纷 纷 上 客 袍
知 名 - 一 番 - 起 小 - 绿 阴 - 知 名==闲 花 浪 蕊 不 知 名	又 是 一 番 春 划 生	病 起 小 园 无 一 事	杖 藜 看 得 绿 阴 成
暗 香 - 林 间 - 寒 窗 - 锦 绣 - 暗 香==夜 起 荆 扉 趁 暗 香	林 间 梅 下 卜 斋 房	寒 窗 安 着 清 相 向	清 杀 东 坡 锦 绣 肠
江 湖 - 庐 山 - 门 前 - 相 思 - 浩 荡==春 风 浩 荡 江 湖 客	咫 尺 庐 山 风 雨 急	门 前 老 树 最 关 情	一 夜 相 思 头 尽 白
风 微 - 芰 荷 - 梧 桐 - 凤 凰 - 帘 幕==帘 幕 风 微 日 正 长	庭 前 一 片 芰 荷 香	人 传 郎 在 梧 桐 树	妾 愿 将 身 化 凤 凰
稚 子 - 重 阳 - 明 年 - 梦 中 - 稚 子==稚 子 山 妻 伴 老 翁	重 阳 寻 遍 菊 花 丛	明 年 把 酒 知 何 处	却 忆 高 亭 是 梦 中
水 云 - 风 味 - 一 枝 - 何 处 - 水 云==丛 林 荒 落 水 云 寒	风 味 辛 酸 话 转 难	隐 隐 一 枝 一 外 去	不 知 何 处 择 人 安
珠 箔 - 玉 钩 - 罗 绮 - 青 楼 - 青 楼==群 芳 珠 箔 映 青 楼	楼 上 珠 帘 卷 玉 钩	十 二 香 衢 遍 罗 绮	青 楼 和 月 为 君 愁
功 名 - 十 年 - 湖 上 - 尽 日 - 功 名==落 落 功 名 鬓 早 斑	蹉 跎 心 事 十 年 间	看 来 只 合 归 湖 上	渔 钓 丛 中 尽 日 闲
春 归 - 春 意 - 归 家 - 何 处 - 三 月==三 月 春 归 留 不 住	春 归 春 意 难 分 付	凡 言 归 者 必 归 家	为 问 春 家 在 何 处
延 宾 - 养 性 - 人 醉 - 素 壁 - 延 宾==白 酒 延 宾 出 自 如	收 书 养 性 务 三 余	山 人 醉 吐 惊 人 句	却 向 东 庵 素 壁 书
长 歌 - 塞 北 - 孤 城 - 天 外 - 横 吹==横 吹 长 歌 千 万 骑	将 军 塞 北 立 功 回	边 人 争 出 孤 城 望	渐 见 族 旗 天 外 来
陌 上 - 足 波 - 何 处 - 笙 歌 - 陌 上==洛 阳 陌 上 多 离 别	蓬 莱 山 下 足 波 潮	碧 海 桑 田 何 处 在	笙 歌 一 听 一 遥 遥
消 魂 - 残 秋 - 有 阿 - 冷 雨 - 消 魂==阻 风 无 酒 倍 消 魂	况 是 残 秋 岸 柳 髡	赖 有 阿 咸 情 话 好	一 帆 冷 雨 过 娄 门
涧 底 - 石 桥 - 何 暮 - 昨 夜 - 长 松==谷 口 长 松 涧 底 藤	石 桥 山 路 晚 登 登	囊 琴 斗 酒 来 何 暮	空 负 寒 斋 昨 夜 镫
津 头 - 烟 波 - 扁 舟 - 西 湖 - 津 头==偶 向 津 头 买 钓 蓑	怀 人 只 隔 一 烟 波	扁 舟 欲 渡 长 江 去	奈 此 西 湖 明 月 何
漫 漫 - 疏 棂 - 戍 鼓 - 明 月 - 漫 漫==乌 啼 霜 落 夜 漫 漫	风 入 疏 棂 客 枕 寒	戍 鼓 敲 残 鸡 乱 唱	半 轩 明 月 照 栏 干
刺 史 - 寂 寥 - 图 画 - 白 发 - 刺 史==可 笑 山 州 为 刺 史	寂 寥 都 不 似 川 城	若 无 书 籍 兼 图 画	便 不 教 人 白 发 生
萧 疏 - 雪 后 - 玉 楼 - 横 吹 - 青 灯==青 灯 影 里 萧 疏 树	雪 后 风 微 气 吐 氛	醉 倚 玉 楼 频 赏 望	横 吹 铁 笛 叫 寒 云
山 回 - 翠 微 - 春 满 - 夜 深 - 溪 山==溪 山 回 首 昔 人 非	剩 喜 文 峰 拥 翠 微	尊 俎 笑 谈 春 满 院	不 辞 和 月 夜 深 归
君 子 - 横 行 - 离 离 - 蝶 误 - 孤 标==长 爱 孤 标 似 君 子	不 禁 横 行 巧 挤 排	短 幅 离 离 乃 遗 像	至 今 寒 蝶 误 飞 来
萍 蓬 - 飘 飘 - 满 县 - 春 风 - 萍 蓬==林 生 牢 落 叹 萍 蓬	词 采 飘 飘 甑 屡 空	闻 道 河 阳 花 满 县	欲 从 大 手 借 春 风
春 风 - 湘 江 - 梦 中 - 千 里 - 洞 房==洞 房 昨 夜 春 风 起	故 人 尚 隔 湘 江 水	枕 上 片 时 春 梦 中	行 尽 江 南 数 千 里
六 出 - 清 湍 - 无 人 - 隔 岸 - 六 出==六 出 英 英 九 夏 寒	短 丛 香 玉 映 清 湍	主 人 自 出 无 人 管	输 与 泠 然 隔 岸 看
多 岐 - 尚 虑 - 知 人 - 知 人 - 多 岐==冲 冲 行 路 自 多 岐	已 踏 归 途 尚 虑 非	迄 犬 只 知 人 是 盗	不 知 人 亦 夜 来 归
金 鸭 - 越 罗 - 芳 容 - 风 落 - 午 夜==金 鸭 烧 残 午 夜 香	内 家 初 试 越 罗 裳	芳 容 不 肯 留 春 驻	几 阵 东 风 落 海 棠
流 水 - 云 鬓 - 把 姑 - 倾 城 - 流 水==台 前 流 水 眼 波 明	台 上 闲 云 鬓 叶 轻	莫 把 姑 苏 远 相 比	不 曾 亡 国 祇 倾 城
到 处 - 残 枝 - 山 僧 - 春 来 - 到 处==到 处 已 无 花 可 吹	东 风 犹 自 舞 残 枝	山 僧 只 解 关 门 睡	春 去 春 来 总 不 知
春 光 - 花 残 - 风 枝 - 雕 梁 - 春 光==一 巢 功 绩 破 春 光	絮 落 花 残 两 翅 狂	月 树 风 枝 不 栖 去	强 来 言 语 泥 雕 梁
金 羁 - 春 风 - 落 月 - 飞 花 - 辽 海==白 马 金 羁 辽 海 东	罗 帷 绣 被 卧 春 风	落 月 低 轩 窥 烛 尽	飞 花 入 户 笑 床 空
好 花 - 青 帝 - 游 人 - 绿 阴 - 好 花==十 日 好 花 都 去 尽	可 怜 青 帝 用 功 深	游 人 莫 便 无 凭 据	未 必 红 芳 胜 绿 阴
横 空 - 肌 骨 - 忍 冻 - 胸 次 - 横 空==霜 气 横 空 月 色 明	寒 侵 肌 骨 不 胜 清	支 筇 忍 冻 游 山 径	胸 次 都 无 世 俗 情
金 灯 - 春 阴 - 离 思 - 美 人 - 金 灯==金 灯 飒 飒 夜 潮 寒	楼 观 春 阴 海 气 残	莫 露 乡 心 与 离 思	美 人 容 易 曲 中 弹
如 来 - 森 罗 - 法 眼 - 是 吾 - 妙 体==如 来 妙 体 遍 河 沙	万 象 森 罗 无 障 遮	会 得 圆 通 真 法 眼	始 知 三 界 是 吾 家
来 风 - 青 青 - 南 浦 - 前 村 - 黄 昏==春 来 风 雨 耿 黄 昏	初 见 青 青 月 一 痕	忆 自 消 魂 南 浦 后	不 禁 描 出 向 前 村
团 扇 - 红 泪 - 无 主 - 画 梁 - 团 扇==不 见 当 年 团 扇 郎	双 垂 红 泪 湿 流 黄	楼 空 燕 子 怜 无 主	剩 有 歌 尘 在 画 梁
疏 帘 - 月 满 - 一 杯 - 山 色 - 荷 香==疏 帘 不 下 纵 荷 香	梦 破 纱 厨 月 满 廊	笑 尽 一 杯 鞭 马 走	恍 疑 山 色 是 家 乡
拂 云 - 万 里 - 扁 舟 - 江 上 - 拂 云==拂 云 高 雁 倚 风 抟	下 视 平 湖 万 里 宽	搔 首 扁 舟 又 东 去	钱 塘 江 上 看 波 澜
灯 火 - 书 窗 - 深 方 - 功 名 - 灯 火==槐 黄 灯 火 困 豪 英	此 去 书 窗 得 此 生	学 力 根 深 方 蒂 固	功 名 水 到 自 渠 成
零 落 - 折 枝 - 风 味 - 三 年 - 零 落==残 梅 零 落 不 禁 吹	真 是 无 花 空 折 枝	堪 笑 老 人 风 味 减	三 年 不 作 送 梅 诗
香 销 - 残 灯 - 漠 漠 - 风 吹 - 香 销==香 销 云 凝 旧 僧 家	僧 刹 残 灯 壁 半 斜	日 暮 松 烟 空 漠 漠	秋 风 吹 破 妙 莲 华
花 残 - 客 愁 - 夜 半 - 白 头 - 花 残==先 自 花 残 故 相 恼	况 值 雨 声 催 客 愁	狂 吟 夜 半 睡 不 得	起 待 清 晨 梳 白 头
看 山 - 兰 亭 - 风 流 - 茂 林 - 看 山==便 著 工 夫 去 看 山	兰 亭 未 遇 莫 空 还	向 来 一 段 风 流 事	只 在 茂 林 修 竹 间
东 君 - 春 风 - 芳 心 - 盈 盈 - 东 君==东 君 何 事 妒 花 妍	不 遣 春 风 一 笑 嫣	邀 动 芳 心 愁 万 缕	盈 盈 含 恨 雨 中 天
郁 蒸 - 身 轻 - 催 归 - 城 头 - 郁 蒸==晚 上 危 亭 避 郁 蒸	风 生 两 腋 觉 身 轻	更 筹 只 是 催 归 去	不 到 城 头 月 未 生
绿 云 - 离 离 - 昼 长 - 一 帘 - 苔 花==苔 花 满 径 绿 云 凉	嫩 竹 离 离 覆 短 墙	院 静 昼 长 人 不 到	一 帘 风 袅 一 炉 香
白 鹤 - 渔 矶 - 青 山 - 君 王 - 白 鹤==白 鹤 飞 来 牵 我 衣	东 风 吹 我 下 渔 矶	当 年 只 为 青 山 误	直 草 君 王 一 诏 归
招 提 - 酒 旆 - 云 林 - 山 灵 - 招 提==招 提 依 约 在 烟 萝	酒 旆 风 微 拂 钓 蓑	欲 税 云 林 归 卜 隐	山 灵 应 笔 赚 人 多
物 华 - 花 梢 - 红 蕊 - 枝 上 - 物 华==物 华 俱 人 发 生 辰	喜 见 花 梢 刺 眼 新	便 好 衔 杯 嚼 红 蕊	不 须 枝 上 火 烧 春
缭 绕 - 纵 横 - 迷 路 - 烟 霞 - 黄 花==东 溪 缭 绕 黄 花 国	西 崦 纵 横 白 酒 家	谁 道 桃 源 解 迷 路	与 君 平 步 到 烟 霞
露 冷 - 小 径 - 神 仙 - 猿 啼 - 无 人==云 深 露 冷 无 人 到	小 径 阴 云 翠 欲 迷	吊 罢 神 仙 古 时 迹	乱 峰 影 裹 听 猿 啼
道 院 - 不 生 - 落 花 - 断 送 - 道 院==道 院 僧 居 相 与 邻	绿 阴 门 巷 不 生 尘	落 花 飞 絮 无 情 绪	只 解 年 年 断 送 春
暗 花 - 药 炉 - 畦 麦 - 瓶 焦 - 雨 暗==一 帘 霏 雨 暗 花 朝	焙 药 炉 边 拥 破 貂	深 坐 不 知 畦 麦 信	喜 看 黄 液 上 瓶 焦
风 帆 - 安 流 - 徐 送 - 封 侯 - 风 帆==彭 蠡 风 帆 一 箭 收	九 江 安 庆 是 安 流	说 与 藩 王 徐 送 款	亲 臣 无 数 要 封 侯
波 心 - 鱼 龙 - 休 惆 - 中 流 - 突 兀==突 兀 波 心 倚 翠 空	他 年 金 碧 照 鱼 龙	火 烧 水 转 休 惆 怅	且 看 中 流 树 荫 浓
山 河 - 驻 马 - 胸 中 - 江 天 - 山 河==一 登 伟 观 眇 山 河	下 有 将 军 驻 马 坡	不 是 胸 中 兵 十 万	长 江 天 险 误 人 多
风 云 - 题 桥 - 得 意 - 贤 哲 - 风 云==汉 朝 卿 相 尽 风 云	司 马 题 桥 众 又 闻	何 事 不 如 杨 得 意	解 搜 贤 哲 荐 明 君
潇 湘 - 风 叶 - 何 处 - 成 行 - 潇 湘==拍 天 烟 水 接 潇 湘	芦 苇 秋 风 叶 叶 凉	何 处 渔 郎 夜 吹 笛	雁 群 惊 起 不 成 行
清 风 - 南 柯 - 归 去 - 溪 山 - 清 风==一 枕 清 风 梦 绿 萝	人 间 随 处 是 南 柯	也 知 睡 足 当 归 去	不 奈 溪 山 留 客 何
云 深 - 松 门 - 故 人 - 鸟 语 - 云 深==碧 云 深 处 望 湖 山	时 步 松 门 独 往 还	眼 底 故 人 都 不 见	但 闻 幽 鸟 语 关 关
生 涯 - 不 苦 - 前 朝 - 住 几 - 山 中==山 中 多 有 好 生 涯	涧 户 云 关 不 苦 赊	试 觅 前 朝 避 兵 处	至 今 犹 住 几 人 家
分 明 - 丹 青 - 烟 雨 - 丹 青 - 平 野==天 嫌 平 野 树 分 明	便 恐 丹 青 画 得 成	收 入 晚 风 烟 雨 里	自 将 水 墨 替 丹 青
江 南 - 西 湖 - 烟 雨 - 宫 殿 - 江 南==江 南 四 百 八 十 寺	未 抵 西 湖 胜 处 多	不 用 楼 台 带 烟 雨	只 看 宫 殿 压 晴 波
云 浮 - 欢 见 - 三 冬 - 人 愁 - 云 浮==胡 尘 未 动 朔 云 浮	行 在 多 欢 见 小 侯	愿 保 三 冬 资 我 乐	更 无 一 事 使 人 愁
淑 景 - 鸭 头 - 花 深 - 春 风 - 景 长==鱼 藻 宫 中 淑 景 长	鸭 头 新 水 御 池 塘	奇 花 深 院 门 门 闭	总 被 春 风 漏 泄 香
野 鸟 - 及 时 - 有 意 - 穿 林 - 野 鸟==野 鸟 关 关 督 驾 犁	及 时 新 雨 土 膏 肥	知 君 有 意 农 夫 劝	故 故 穿 林 傍 马 飞
上 苑 - 金 殿 - 由 出 - 宫 莺 - 长 乐==长 乐 宫 连 上 苑 春	玉 楼 金 殿 艳 歌 新	君 门 一 入 无 由 出	唯 有 宫 莺 得 见 人
未 消 - 一 生 - 千 尺 - 歌 风 - 未 消==失 计 鸿 门 根 未 消	一 生 霸 业 亦 徒 劳	当 时 漫 筑 台 千 尺	争 似 歌 风 地 步 高
三 日 - 飘 零 - 惟 有 - 绿 丛 - 三 日==东 园 三 日 两 兼 风	桃 李 飘 零 扫 地 空	惟 有 山 茶 偏 耐 久	绿 丛 又 放 数 枝 红
秋 风 - 五 夜 - 记 南 - 道 骨 - 秋 风==秋 风 著 意 菊 丛 黄	不 怕 东 篱 五 夜 霜	曾 记 南 阳 饮 潭 水	要 令 道 骨 合 仙 方
云 烟 - 积 翠 - 海 市 - 明 灭 - 云 烟==云 烟 缥 缈 郁 孤 台	积 翠 浮 空 雨 半 开	想 见 之 罘 观 海 市	绛 宫 明 灭 是 蓬 莱
杖 藜 - 青 钱 - 儿 童 - 一 年 - 杖 藜==杖 藜 里 饭 去 匆 匆	过 眼 青 钱 转 手 空	赢 得 儿 童 语 音 好	一 年 强 半 在 城 中
月 明 - 执 手 - 云 山 - 烟 波 - 月 明==月 明 愁 向 此 宵 多	执 手 河 梁 意 若 何	千 里 云 山 青 不 断	片 帆 何 处 宿 烟 波
烟 波 - 耿 耿 - 光 明 - 逐 浪 - 万 里==万 里 烟 波 接 素 秋	银 缸 耿 耿 泛 中 流	自 从 一 点 光 明 后	逐 浪 随 波 未 肯 休
荒 山 - 夕 照 - 头 雪 - 经 卷 - 荒 山==一 间 瓦 屋 荒 山 里	山 路 萦 回 夕 照 明	只 有 比 丘 头 雪 白	旋 收 经 卷 入 相 迎
东 风 - 陪 岁 - 太 平 - 离 宫 - 东 风==绮 窗 绣 户 又 东 风	丹 掖 游 陪 岁 岁 同	但 愿 太 平 无 限 乐	何 须 三 十 六 离 宫
铃 声 - 轮 囷 - 万 里 - 夜 宿 - 铃 声==栈 云 零 乱 驮 铃 声	驿 树 轮 囷 桦 烛 明	清 梦 不 知 身 万 里	只 言 今 夜 宿 葭 萌
乘 兴 - 秋 香 - 婆 娑 - 百 回 - 乘 兴==偶 来 乘 兴 不 须 疑	一 顷 秋 香 欲 发 时	老 子 婆 娑 真 为 尔	百 回 相 见 愧 鸬 鹚
柳 绿 - 春 风 - 杨 花 - 春 归 - 依 依==满 城 杨 柳 绿 依 依	背 著 春 风 自 在 飞	却 是 杨 花 有 才 思	一 时 收 拾 伴 春 归
玉 山 - 城 郭 - 满 庭 - 高 节 - 玉 山==玉 山 冰 水 是 吾 家	城 郭 屡 过 三 姓 茶	满 庭 修 绿 谁 人 种	高 节 岁 寒 仍 有 加
悲 风 - 宿 草 - 骑 马 - 洛 阳 - 悲 风==依 仁 台 废 悲 风 晚	履 信 池 荒 宿 草 春	自 问 老 身 骑 马 出	洛 阳 城 里 觅 何 人
画 角 - 凭 飞 - 满 地 - 幽 人 - 画 角==画 角 三 终 夜 未 阑	醉 凭 飞 阁 喜 天 宽	月 明 满 地 江 风 急	吹 落 幽 人 紫 绮 冠
五 色 - 病 眸 - 诗 人 - 兰 舟 - 五 色==日 开 五 色 暖 征 裘	雪 满 群 山 爽 病 眸	道 是 诗 人 穷 到 骨	暖 边 爽 里 放 兰 舟
灵 境 - 江 山 - 风 光 - 龟 城 - 灵 境==周 游 灵 境 散 幽 情	千 里 江 山 暂 得 行	所 恨 风 光 看 未 足	却 驱 金 翠 入 龟 城
衲 衣 - 经 年 - 云 雨 - 归 期 - 衲 衣==蔬 饭 藜 床 破 衲 衣	经 年 兀 兀 槿 花 篱	与 君 聚 散 若 云 雨	君 问 归 期 未 有 期
明 珠 - 堪 猜 - 年 事 - 江 头 - 明 珠==底 事 明 珠 解 去 来	当 时 合 蒲 已 堪 猜	贾 胡 不 省 何 年 事	老 石 江 头 空 绿 苔
淡 淡 - 驿 使 - 憔 悴 - 嫁 易 - 淡 淡==娥 眉 淡 淡 自 成 妆	驿 使 还 家 空 断 肠	脂 粉 不 施 憔 悴 尽	失 身 未 嫁 易 元 光
风 来 - 市 廛 - 孤 高 - 避 世 - 玉 佩==树 杪 风 来 玉 佩 惊	仙 香 远 胜 市 廛 清	细 看 一 段 孤 高 趣	恰 似 幽 人 避 世 情
纤 腰 - 风 愁 - 黄 金 - 东 风 - 纤 腰==条 妒 纤 腰 叶 妒 眉	怕 风 愁 雨 尽 低 垂	黄 金 穗 短 人 争 挽	更 被 东 风 折 一 枝
云 端 - 泓 一 - 静 听 - 阑 干 - 云 端==天 然 奇 石 耸 云 端	下 浸 龙 泓 一 掬 寒	静 听 潺 湲 眠 未 得	不 妨 乘 月 依 阑 干
一 朵 - 翠 云 - 清 浅 - 游 人 - 一 朵==一 朵 蓬 莱 在 世 间	梵 王 宫 阙 翠 云 间	近 南 溪 水 更 清 浅	闻 道 游 人 未 忍 还
色 鲜 - 堪 怜 - 风 流 - 禅 心 - 色 鲜==满 库 琼 芳 斗 色 鲜	就 中 一 朵 最 堪 怜	恁 伊 万 种 风 流 态	惟 有 禅 心 似 铁 坚
春 光 - 归 来 - 似 雪 - 杨 柳 - 春 光==春 光 若 海 渺 无 边	日 暮 归 来 泛 玉 船	红 酽 海 棠 红 似 雪	翠 娇 杨 柳 暗 如 烟
一 棹 - 十 岁 - 禅 榻 - 落 花 - 一 棹==觥 船 一 棹 百 分 空	十 岁 青 春 不 负 公	今 日 鬓 丝 禅 榻 畔	茶 烟 轻 飏 落 花 风
晚 风 - 心 胸 - 须 臾 - 天 边 - 飘 飘==云 气 飘 飘 御 晚 风	笑 谈 嘘 吸 满 心 胸	须 臾 敛 尽 还 空 碧	露 出 天 边 无 数 峰
今 夜 - 火 树 - 星 河 - 丹 凤 - 今 夜==今 夜 金 吾 不 禁 街	灯 山 火 树 准 宣 牌	长 安 一 片 星 河 里	丹 凤 楼 高 众 乐 谐
过 月 - 桂 花 - 素 娥 - 凤 凰 - 凌 风==半 醉 凌 风 过 月 旁	水 精 宫 殿 桂 花 香	素 娥 定 赴 瑶 池 宴	侍 女 皆 骑 白 凤 凰
远 山 - 衣 单 - 桃 花 - 桃 花 - 远 山==晓 翠 妨 人 看 远 山	小 风 偏 入 客 衣 单	桃 花 爱 做 春 寒 信	只 恐 桃 花 也 自 寒
秋 天 - 看 天 - 似 鹤 - 一 身 - 秋 天==秋 天 尤 觉 晓 天 清	仰 首 看 天 俯 首 行	不 但 长 歌 声 似 鹤	一 身 浑 似 鹤 般 轻
故 人 - 古 殿 - 槁 叶 - 孤 灯 - 故 人==故 人 陈 迹 生 蛛 网	古 殿 苔 深 叠 绿 缯	檐 雨 晚 秋 鸣 槁 叶	窗 风 深 夜 触 孤 灯
百 花 - 谁 可 - 追 谷 - 蜂 蝶 - 百 花==春 风 待 看 百 花 奔	旧 事 知 谁 可 共 论	颜 色 不 曾 追 谷 好	从 他 蜂 蝶 自 劳 魂
桃 叶 - 东 风 - 南 北 - 肯 过 - 扬 州==扬 州 桃 叶 能 留 客	任 是 东 风 江 上 狂	南 北 人 情 亦 相 似	六 军 不 肯 过 咸 阳
蔷 薇 - 雨 余 - 秋 风 - 入 诗 - 蔷 薇==出 架 蔷 薇 秀 晚 枝	雨 余 屋 角 理 蛛 丝	可 怜 一 曲 秋 风 地	万 思 千 情 斗 入 诗
雨 暗 - 鼍 浪 - 功 名 - 听 雨 - 雨 暗==我 生 急 雨 暗 淮 天	出 没 蛟 鼍 浪 入 船	白 首 功 名 无 尺 寸	茅 檐 还 听 雨 声 眠
观 月 - 石 桥 - 与 今 - 清 光 - 东 海==常 观 月 从 东 海 出	想 照 石 桥 旁 畔 人	试 问 当 年 与 今 日	清 光 不 改 只 如 新
寒 色 - 一 径 - 鸠 藏 - 横 飞 - 风 寒==无 风 寒 色 自 凄 迷	晚 日 低 笼 一 径 微	竹 里 鸠 藏 初 未 觉	小 车 行 过 忽 横 飞
屈 曲 - 淡 烟 - 诗 人 - 三 弄 - 屈 曲==屈 曲 溪 桥 路 两 丫	淡 烟 如 隔 小 棂 纱	南 枝 已 入 诗 人 手	三 弄 从 教 咽 暮 笳
凛 凛 - 龙 蛇 - 中 天 - 爪 牙 - 凛 凛==凛 凛 孤 风 不 自 夸	端 居 寰 海 定 龙 蛇	大 中 天 子 曾 轻 触	三 度 亲 遭 弄 爪 牙
青 草 - 秋 声 - 窥 伺 - 西 风 - 青 草==青 草 黄 泥 孰 与 争	吆 吆 偏 喜 弄 秋 声	人 家 儿 女 能 窥 伺	莫 向 西 风 特 地 鸣
伴 月 - 芦 花 - 薜 荔 - 林 泉 - 娟 娟==一 纶 长 伴 月 娟 娟	满 岸 芦 花 入 短 舷	薜 荔 未 堪 华 衮 用	此 身 甘 作 老 林 泉
何 处 - 风 急 - 有 群 - 环 佩 - 何 处==何 处 飞 来 一 段 云	太 湖 风 急 到 江 城	云 中 疑 有 群 仙 过	时 听 丁 东 环 佩 声
木 落 - 萧 然 - 道 人 - 何 处 - 木 落==木 落 同 高 八 月 天	山 荒 屋 老 意 萧 然	道 人 香 火 但 灰 冷	何 处 如 今 更 有 仙
传 宣 - 挥 毫 - 研 雪 - 独 酌 - 传 宣==沈 香 亭 上 示 传 宣	斗 酒 挥 毫 自 百 篇	研 雪 新 蒲 瓯 弄 碧	遥 知 独 酌 意 悠 然
环 宫 - 天 边 - 金 粟 - 如 乞 - 环 宫==性 根 本 自 白 环 宫	分 得 天 边 一 种 红	比 似 将 花 供 金 粟	何 如 乞 米 送 卢 仝
三 月 - 帘 幕 - 秉 烛 - 杨 柳 - 江 南==三 月 江 南 花 满 枝	风 轻 帘 幕 燕 争 飞	游 人 休 惜 夜 秉 烛	杨 柳 阴 浓 春 欲 归
楼 阁 - 泽 国 - 云 气 - 天 工 - 化 城==化 城 楼 阁 壮 人 寰	泽 国 封 疆 镇 两 关	云 气 开 成 银 色 界	天 工 斫 出 点 苍 山
风 吹 - 清 波 - 莲 叶 - 笑 语 - 湖 上==湖 上 西 风 吹 绮 罗	靓 妆 越 女 照 清 波	折 将 莲 叶 佯 遮 面	棹 过 前 滩 笑 语 多
梅 花 - 春 回 - 儿 童 - 归 去 - 梅 花==门 外 梅 花 扰 复 栽	回 时 春 去 去 春 回	儿 童 拍 手 应 相 笑	归 去 贾 生 今 又 来
燕 寂 - 熟 花 - 卷 帘 - 竹 篱 - 燕 寂==鸣 鸠 乳 燕 寂 无 声	蜜 熟 花 蜂 亦 懒 营	睡 起 卷 帘 春 已 晚	竹 篱 穿 笋 两 三 茎
夜 泊 - 潮 来 - 江 花 - 山 青 - 夜 泊==归 舟 夜 泊 西 兴 渡	坐 看 潮 来 又 潮 去	江 草 江 花 春 复 春	山 青 水 绿 原 如 故
一 日 - 活 计 - 归 来 - 南 山 - 一 日==又 是 间 中 一 日 过	明 朝 活 计 看 如 何	拾 薪 童 子 归 来 晚	报 说 南 山 野 菜 多
春 蔬 - 青 嫩 - 溪 头 - 沽 酒 - 满 畦==桑 下 春 蔬 绿 满 畦	菘 心 青 嫩 芥 苔 肥	溪 头 洗 择 店 头 卖	日 暮 裹 盐 沽 酒 归
六 龙 - 雪 下 - 银 色 - 琼 瑶 - 六 龙==雷 动 天 旋 从 六 龙	更 催 时 雪 下 云 空	师 行 银 色 光 中 地	鸟 过 琼 瑶 草 木 中
无 言 - 飘 零 - 只 在 - 莫 误 - 有 声==秋 本 无 言 那 有 声	不 然 风 过 物 飘 零	此 心 只 在 人 心 做	说 与 行 人 莫 误 听
啼 鹃 - 南 人 - 衣 冠 - 玉 堂 - 啼 鹃==天 津 桥 上 听 啼 鹃	从 此 南 人 弄 相 权	多 少 衣 冠 落 沙 漠	朱 崖 宜 著 玉 堂 仙
香 色 - 幽 人 - 有 意 - 千 花 - 香 色==冻 蕊 凝 香 色 艳 新	小 山 深 坞 伴 幽 人	知 君 有 意 凌 寒 色	羞 共 千 花 一 样 春
全 身 - 万 象 - 独 步 - 惊 人 - 腾 腾==腾 腾 师 子 露 全 身	吞 却 森 罗 万 象 形	头 尾 也 无 常 独 步	眼 光 不 眨 大 惊 人
汀 洲 - 西 风 - 陂 塘 - 蓼 花 - 红 穗==浅 深 红 穗 绕 汀 洲	笑 舞 西 风 体 力 柔	雅 意 陂 塘 非 玩 物	令 人 却 忆 蓼 花 游
骊 珠 - 阑 干 - 好 景 - 征 鞍 - 骊 珠==着 壁 骊 珠 五 月 寒	行 人 到 此 泣 阑 干	亭 前 好 景 慵 回 首	恐 跨 征 鞍 不 得 看
扁 鹊 - 饮 上 - 湖 内 - 一 滴 - 扁 鹊==缘 何 扁 鹊 号 良 医	传 法 元 来 饮 上 池	化 作 月 湖 湖 内 水	愿 捐 一 滴 救 疮 痍
银 床 - 汲 水 - 馆 静 - 栋 梁 - 银 床==银 床 露 湿 井 华 寒	自 挈 铜 瓶 汲 水 还	宿 雨 未 乾 池 馆 静	凉 蝉 犹 在 栋 梁 间
上 元 - 销 魂 - 如 沸 - 倚 门 - 俳 优==花 鼓 俳 优 闹 上 元	管 弦 嘈 杂 并 销 魂	灯 如 飞 盖 歌 如 沸	半 面 佳 人 恰 倚 门
纸 帐 - 晓 日 - 好 梦 - 窗 外 - 纸 帐==布 衾 纸 帐 饯 残 冬	老 眼 俄 惊 晓 日 红	好 梦 追 寻 忘 首 尾	但 闻 窗 外 竹 摇 风
月 桂 - 沾 衣 - 西 山 - 断 云 - 月 桂==月 桂 峰 前 快 雨 飞	林 间 避 雨 亦 沾 衣	才 晴 便 出 西 山 路	却 共 断 云 相 趁 归
飞 鸿 - 同 云 - 瑶 林 - 儿 童 - 飞 鸿==冥 冥 何 处 认 飞 鸿	天 地 同 云 冷 不 风	玉 蕊 瑶 林 应 在 望	儿 童 喜 入 笑 声 中
白 虎 - 帝 乡 - 太 乙 - 白 苹 - 白 虎==白 虎 明 光 奏 五 侯	帝 乡 寥 隔 在 温 柔	甘 泉 太 乙 重 招 起	聊 答 青 藜 照 白 苹
枕 上 - 人 事 - 开 门 - 片 云 - 枕 上==隔 水 钟 声 枕 上 闻	城 中 人 事 已 纷 纷	开 门 放 鹤 溪 边 去	冲 破 闲 阶 一 片 云
酒 醒 - 寒 泉 - 秋 色 - 一 片 - 酒 醒==酒 醒 窗 明 月 半 川	怯 将 病 齿 漱 寒 泉	楼 西 别 有 清 秋 色	一 片 淮 山 在 晓 烟
人 愁 - 水 流 - 元 刘 - 陶 谢 - 人 愁==君 诗 何 以 解 人 愁	初 日 红 蕖 碧 水 流	未 怕 元 刘 妨 独 步	每 思 陶 谢 与 同 游
山 出 - 涧 玉 - 轳 引 - 赤 脚 - 山 出==山 出 涓 寒 一 道 泉	暗 声 落 涧 玉 铮 然	辘 轳 引 上 泥 丸 顶	便 是 人 间 赤 脚 仙
万 丈 - 霜 天 - 金 麟 - 月 明 - 万 丈==万 丈 寒 潭 彻 底 清	霜 天 午 夜 欲 生 冰	钓 鱼 要 掷 金 麟 饵	拨 转 芦 蓬 向 月 明
燕 台 - 新 声 - 夜 半 - 鹦 鹉 - 赋 就==燕 台 赋 就 尚 缄 囊	已 作 新 声 绕 杏 梁	见 说 负 山 常 夜 半	能 言 鹦 鹉 枉 关 防
天 迥 - 残 照 - 寒 鸦 - 一 树 - 天 迥==天 迥 孤 帆 隐 约 归	茫 茫 残 照 欲 沉 西	寒 鸦 散 乱 知 多 少	飞 向 江 头 一 树 栖
握 手 - 追 随 - 江 湖 - 无 言 - 握 手==都 城 握 手 意 弥 温	少 小 追 随 莫 更 论	一 别 江 湖 重 十 载	偶 然 相 见 欲 无 言
老 火 - 提 携 - 千 头 - 三 藏 - 老 火==老 火 丹 田 热 欲 吹	不 妨 水 雪 重 提 携	金 多 不 用 千 头 橘	刀 害 无 嫌 三 藏 梨
日 淡 - 看 花 - 竹 边 - 走 马 - 日 淡==烟 浓 日 淡 不 多 寒	担 上 看 花 雪 作 团	想 得 竹 边 春 已 暗	明 朝 走 马 过 溪 看
几 家 - 泥 沙 - 风 送 - 得 一 - 榔 遍==烟 草 槟 榔 遍 几 家	金 钱 不 惜 掷 泥 沙	夕 阳 门 巷 香 风 送	拣 得 一 篮 鹰 爪 花
珠 颗 - 结 成 - 和 气 - 寒 温 - 珠 颗==圆 小 香 黄 珠 颗 垂	结 成 洛 邑 重 霜 时	相 公 和 气 陶 群 物	不 是 寒 温 变 土 宜
北 风 - 城 头 - 雪 融 - 雪 融 - 北 风==南 风 融 雪 北 风 凝	晚 日 城 头 已 可 登	莫 道 雪 融 便 无 迹	雪 融 成 水 水 成 冰
溪 头 - 蜂 腰 - 半 篙 - 黄 昏 - 燕 尾==燕 尾 溪 头 晚 色 分	蜂 腰 山 断 日 斜 曛	半 篙 碧 静 秋 垂 钓	一 棹 黄 昏 冷 载 云
玉 色 - 碧 油 - 春 睡 - 佳 人 - 玉 色==织 手 搓 来 玉 色 匀	碧 油 煎 出 嫩 黄 深	夜 来 春 睡 知 轻 重	压 匾 佳 人 缠 臂 金
千 山 - 思 乡 - 独 留 - 桃 李 - 千 山==南 北 千 山 与 万 山	轩 车 谁 不 思 乡 关	独 留 芳 翰 悲 前 迹	陌 上 恐 伤 桃 李 颜
此 时 - 文 章 - 读 书 - 瓣 香 - 此 时==此 时 不 忍 抱 遗 材	欲 把 文 章 扇 冷 灰	见 说 读 书 堂 尚 在	瓣 香 寄 与 谒 东 莱
高 眠 - 足 最 - 穷 通 - 马 上 - 欹 枕==欹 枕 高 眠 日 午 春	酒 酣 睡 足 最 闲 身	明 朝 会 得 穷 通 理	未 必 输 他 马 上 人
柳 絮 - 香 醪 - 万 点 - 千 钟 - 惊 飞==春 事 已 惊 飞 柳 絮	香 醪 何 日 酿 松 脂	要 平 万 点 风 前 恨	莫 遣 千 钟 醒 后 知
横 陈 - 玄 都 - 扑 面 - 苦 吟 - 武 陵==武 陵 人 去 水 横 陈	独 向 玄 都 管 领 春	日 暖 风 轻 尘 扑 面	刘 郎 空 老 苦 吟 身
百 战 - 数 重 - 呼 延 - 骑 归 - 沙 场==百 战 沙 场 碎 铁 衣	城 南 已 合 数 重 围	突 营 射 杀 呼 延 将	独 领 残 兵 千 骑 归
落 叶 - 连 天 - 旧 游 - 北 斗 - 落 叶==今 日 相 逢 落 叶 前	洞 庭 秋 水 远 连 天	共 说 金 华 旧 游 处	回 看 北 斗 欲 潸 然
三 日 - 一 雨 - 阴 阳 - 且 喜 - 先 春==先 春 三 日 已 闻 雷	驱 得 长 空 一 雨 来	莫 问 阴 阳 今 失 序	硗 园 且 喜 趁 犁 开
寒 梅 - 芳 菲 - 寂 寞 - 解 围 - 寒 梅==溪 上 寒 梅 初 满 枝	夜 来 霜 月 透 芳 菲	清 光 寂 寞 思 无 尽	应 待 琴 尊 与 解 围
池 边 - 消 魂 - 寻 香 - 金 钩 - 锦 鳞==尽 日 池 边 钓 锦 鳞	芰 荷 香 里 暗 消 魂	依 稀 纵 有 寻 香 饵	知 是 金 钩 不 肯 吞
滔 滔 - 有 酒 - 长 江 - 草 木 - 滔 滔==是 滔 滔 者 竟 谁 归	有 酒 盈 卮 不 暇 挥	待 挽 长 江 洗 兵 马	尽 还 草 木 旧 晶 晖
万 瓦 - 别 山 - 阁 下 - 一 日 - 万 瓦==万 瓦 如 鳞 绣 作 堆	别 山 重 见 秃 翁 来	晴 川 阁 下 南 条 水	一 日 同 君 荡 几 回
茅 檐 - 一 粒 - 萧 条 - 芭 蕉 - 千 金==茅 檐 月 有 千 金 税	稻 饭 年 无 一 粒 租	生 事 萧 条 人 问 我	水 芭 蕉 与 石 菖 蒲
鼓 吹 - 醮 坛 - 元 老 - 钧 天 - 吹 笙==考 鼓 吹 笙 送 上 清	醮 坛 将 罢 日 初 生	太 平 元 老 偏 承 宠	召 听 钧 天 广 乐 声
新 诗 - 花 开 - 此 时 - 一 杯 - 新 诗==潘 令 新 诗 忽 寄 来	分 明 绣 段 对 花 开	此 时 欲 醉 红 楼 里	正 被 歌 人 劝 一 杯
道 旁 - 悠 悠 - 晓 色 - 楼 阁 - 道 旁==道 旁 竹 树 露 如 倾	带 睡 悠 悠 十 里 行	晓 色 未 分 烟 尚 重	压 城 楼 阁 已 峥 嵘
濯 缨 - 今 朝 - 洪 想 - 一 雨 - 濯 缨==昨 日 江 清 可 濯 缨	今 朝 潢 潦 忽 能 盈	发 洪 想 有 山 崩 处	一 雨 安 能 作 许 生
踏 遍 - 多 风 - 酡 颜 - 风 马 - 红 尘==踏 遍 红 尘 四 百 州	几 多 风 月 是 良 俦	朝 来 应 笑 酡 颜 叟	道 不 相 侔 风 马 牛
春 水 - 野 人 - 前 村 - 烟 树 - 春 水==春 水 初 收 露 浅 沙	野 人 相 见 问 年 华	芒 鞋 竹 杖 前 村 路	烟 树 深 深 叫 乳 鸦
沧 浪 - 幽 人 - 来 住 - 买 断 - 沧 浪==十 里 沧 浪 绝 岸 遥	幽 人 行 处 有 谁 招	幸 无 车 马 妨 来 住	买 断 寒 蔬 取 意 挑
山 阴 - 衔 杯 - 清 绝 - 瑶 琴 - 山 阴==欲 作 山 阴 兴 尽 回	良 思 与 子 共 衔 杯	要 须 人 境 俱 清 绝	好 抱 瑶 琴 踏 雪 来
茫 茫 - 荷 花 - 远 寺 - 待 月 - 茫 茫==菰 蒲 无 边 水 茫 茫	荷 花 夜 开 风 露 香	渐 见 灯 明 出 远 寺	更 待 月 黑 看 湖 光
参 差 - 第 游 - 白 日 - 青 山 - 雁 塔==慈 恩 雁 塔 参 差 榜	杏 苑 莺 花 次 第 游	白 日 有 愁 犹 可 散	青 山 高 卧 况 无 愁
红 稀 - 春 回 - 无 人 - 枝 头 - 红 稀==芳 歇 红 稀 蝶 懒 来	潇 潇 风 雷 送 春 回	绿 阴 如 许 无 人 看	软 玉 枝 头 已 有 梅
真 人 - 云 飞 - 松 杉 - 千 年 - 人 上==梁 代 真 人 上 紫 微	水 盘 山 脚 五 云 飞	松 杉 老 尽 无 消 息	犹 得 千 年 一 度 归
怒 势 - 见 骨 - 风 波 - 晴 窗 - 怒 势==怒 势 自 惊 殊 莫 拟	静 心 人 见 骨 毛 寒	平 生 一 对 风 波 眼	今 日 晴 窗 不 忍 看
西 湖 - 沙 禽 - 茅 屋 - 梅 花 - 西 湖==东 风 吹 客 到 西 湖	汀 草 沙 禽 半 识 吾	惟 欠 数 间 茅 屋 在	种 梅 花 处 伴 林 逋
江 城 - 喧 喧 - 酌 酒 - 百 年 - 五 更==五 更 人 语 起 江 城	歌 笑 喧 喧 天 欲 明	酌 酒 寿 君 但 一 醉	百 年 珍 重 是 人 情
生 物 - 和 气 - 开 花 - 吹 嘘 - 生 物==寒 谷 春 生 物 物 均	薰 然 和 气 特 相 亲	十 年 屡 作 开 花 赏	重 费 吹 嘘 是 此 人
故 乡 - 新 岁 - 烹 茶 - 沽 酒 - 故 乡==他 乡 故 乡 老 若 此	新 岁 旧 岁 穷 依 然	烹 茶 但 有 二 升 水	沽 酒 初 无 三 百 钱
东 风 - 春 容 - 万 缕 - 茸 裘 - 东 风==东 风 吹 恨 入 青 楼	满 目 春 容 总 是 愁	杨 柳 织 成 丝 万 缕	凭 谁 裁 作 翠 茸 裘
芒 鞋 - 津 梁 - 六 月 - 一 身 - 芒 鞋==菜 根 惯 咬 著 芒 鞋	便 是 津 梁 一 世 材	六 月 雨 行 缘 底 事	一 身 不 惜 惜 人 才
大 厦 - 数 椽 - 挥 毫 - 江 干 - 大 厦==贬 值 大 厦 室 庐 窘	之 子 数 椽 天 地 宽	醉 里 挥 毫 诗 胆 大	不 悬 金 印 老 江 干
香 飘 - 山 光 - 止 又 - 垂 虹 - 香 飘==香 飘 菡 萏 短 篷 中	水 色 山 光 一 样 同	行 止 又 非 人 所 料	今 年 两 度 上 垂 虹
虚 檐 - 风 帘 - 绿 阴 - 梅 黄 - 虚 檐==燕 入 虚 檐 教 子 飞	风 帘 不 卷 和 新 诗	绿 阴 满 迳 晴 蜓 小	正 是 梅 黄 欲 雨 时
萧 萧 - 岁 时 - 西 湖 - 寒 盟 - 萧 萧==短 发 萧 萧 满 镜 秋	家 居 但 觉 岁 时 流	两 年 不 见 西 湖 面	笑 我 寒 盟 是 白 鸥
点 点 - 晴 日 - 水 边 - 行 吟 - 点 点==点 点 青 萍 秋 后 衰	溶 溶 晴 日 见 鱼 儿	水 边 窥 影 何 方 客	自 照 行 吟 憔 悴 姿
奕 叶 - 花 间 - 神 仙 - 日 韩 - 奕 叶==顷 刻 花 开 奕 叶 光	花 间 奇 字 兆 灾 祥	神 仙 幻 术 从 来 有	昔 日 韩 湘 今 仲 湘
山 中 - 海 上 - 知 人 - 话 旧 - 山 中==山 中 亦 有 薇 堪 采	海 上 那 无 节 可 持	野 老 不 知 人 事 改	相 逢 犹 话 旧 年 时
萧 萧 - 平 沙 - 湘 江 - 山 月 - 萧 萧==落 木 萧 萧 风 怒 号	平 沙 漠 漠 雁 腥 臊	湘 江 秋 水 澄 如 练	山 鬼 嚣 时 山 月 高
商 山 - 四 皓 - 日 可 - 一 樽 - 商 山==锦 园 不 减 商 山 乐	四 皓 中 间 著 此 翁	今 日 可 无 千 字 作	何 人 似 此 一 樽 同
后 土 - 琼 花 - 归 去 - 诗 人 - 后 土==后 土 祠 中 二 月 暮	琼 花 放 后 有 蜂 来	东 君 不 怕 春 归 去	留 待 诗 人 一 夜 开
春 来 - 飞 锡 - 莲 池 - 狂 风 - 春 来==春 来 日 日 到 西 林	飞 锡 经 行 不 可 寻	莲 池 旧 是 无 波 水	莫 逐 狂 风 起 浪 心
不 言 - 偶 同 - 秋 来 - 鼓 铸 - 不 言==夷 甫 不 言 非 尔 类	鲁 褒 为 论 偶 同 名	秋 来 自 满 虚 闲 地	不 用 良 工 鼓 铸 成
天 工 - 有 香 - 埋 玉 - 折 枝 - 百 花==天 工 戏 剪 百 花 房	夺 尽 人 工 更 有 香	埋 玉 地 中 成 故 物	折 枝 镜 里 忆 新 妆
马 蹄 - 归 来 - 青 楼 - 新 曲 - 马 蹄==春 城 踏 踏 马 蹄 轻	醉 里 归 来 鼓 二 更	月 满 青 楼 人 不 寐	政 将 新 曲 按 银 筝
天 涯 - 处 处 - 手 冬 - 疆 界 - 天 涯==朔 风 吹 玉 满 天 涯	旷 望 平 林 处 处 花	袖 手 冬 窝 无 事 客	不 分 疆 界 是 谁 家
三 更 - 殊 方 - 息 否 - 荆 渚 - 三 更==芭 蕉 急 雨 三 更 闹	客 子 殊 方 五 月 寒	近 得 会 稽 消 息 否	稍 传 荆 渚 路 歧 宽
松 烟 - 起 尘 - 霜 露 - 去 寻 - 松 烟==新 松 烟 翠 入 衣 巾	雨 後 冈 原 不 起 尘	霜 露 悲 怀 今 正 切	曾 非 结 客 去 寻 春
长 歌 - 倚 阑 - 楚 水 - 鸟 外 - 长 歌==一 曲 长 歌 行 路 难	昏 鸦 归 尽 倚 阑 干	不 知 楚 水 巴 山 地	更 有 高 楼 鸟 外 看
南 楼 - 晓 鸡 - 凄 凉 - 灯 前 - 南 楼==愁 听 南 楼 角 又 吹	晓 鸡 啼 后 更 分 离	如 何 销 得 凄 凉 思	更 劝 灯 前 酒 一 卮
韫 椟 - 日 新 - 垂 柳 - 被 发 - 韫 椟==洛 京 韫 椟 起 儒 珍	地 讲 忠 规 德 日 新	禁 苑 金 丝 舞 垂 柳	万 方 已 被 发 生 仁
祥 烟 - 樱 桃 - 年 年 - 花 落 - 丽 日==丽 日 祥 烟 锁 禁 林	樱 桃 初 熟 可 成 阴	年 年 翠 辇 来 游 幸	花 落 春 宫 一 寸 深
参 差 - 飚 轮 - 玄 冥 - 得 新 - 参 差==月 照 参 差 海 上 峰	飚 轮 度 处 灭 行 踪	玄 冥 宫 里 留 宵 宴	传 得 新 方 解 扰 龙
伤 心 - 归 来 - 玉 箫 - 红 颜 - 伤 心==人 自 伤 心 春 自 回	倚 阑 愁 睹 燕 归 来	玉 箫 吹 断 秦 楼 曲	嬴 得 红 颜 镜 里 灰
别 情 - 落 月 - 今 夜 - 第 一 - 别 情==何 处 邀 君 话 别 情	寒 山 木 落 月 华 清	莫 愁 今 夜 无 诗 思	已 听 秋 猿 第 一 声
高 举 - 松 下 - 千 帙 - 呼 儿 - 竹 边==竹 边 闻 鹤 思 高 举	松 下 观 禽 觉 倦 飞	幸 有 故 书 千 帙 在	呼 儿 共 读 嗣 前 徽
蜀 锦 - 千 官 - 朱 门 - 水 寒 - 蜀 锦==蜀 锦 机 中 瑞 鹘 盘	宫 袍 岁 岁 给 千 官	朱 门 次 第 皆 轻 暖	御 所 空 悲 易 水 寒
人 烟 - 草 木 - 一 幅 - 出 山 - 逢 仙==人 烟 断 处 逢 仙 迹	草 木 深 时 听 鸟 悲	记 取 画 工 描 一 幅	出 山 长 若 在 山 时
黄 金 - 变 态 - 风 流 - 腊 后 - 白 璧==白 璧 黄 金 取 意 裁	极 知 变 态 自 江 梅	风 流 一 样 香 仍 好	共 趁 春 前 腊 后 开
夜 夜 - 出 户 - 吹 笳 - 声 满 - 夜 夜==夜 夜 乌 来 啼 未 央	明 月 出 户 空 飞 霜	吹 笳 征 夫 不 就 寝	宫 筵 列 烛 声 满 堂
千 年 - 深 藏 - 全 身 - 生 幽 - 千 年==千 年 鼠 化 白 蝙 蝠	黑 洞 深 藏 避 网 罗	远 害 全 身 诚 得 计	一 生 幽 暗 又 如 何
独 立 - 湘 江 - 妃 子 - 胸 中 - 独 立==迟 回 独 立 湘 江 头	湘 江 无 情 空 自 流	拟 呼 妃 子 弄 云 瑟	一 泻 胸 中 千 斛 愁
屏 风 - 合 欢 - 青 青 - 看 来 - 屏 风==生 色 屏 风 一 面 开	轻 罗 团 扇 合 欢 裁	深 深 院 落 青 青 柳	纵 是 无 花 也 看 来
鸟 啼 - 炊 烟 - 旧 有 - 曲 肱 - 鸟 啼==华 蹊 归 来 鸟 啼 幕	庖 舍 炊 烟 卧 风 缕	西 窗 旧 有 竹 肋 床	伸 足 曲 肱 成 栩 栩
泉 声 - 携 琴 - 只 系 - 落 叶 - 泉 声==故 里 泉 声 不 可 闻	携 琴 相 约 鲍 参 军	山 瓢 只 系 经 行 处	落 叶 这 山 好 觅 君
翔 风 - 祥 刑 - 一 夕 - 现 夺 - 翔 风==仁 侠 翔 风 勇 驾 臼	皇 华 使 者 出 祥 刑	福 星 一 夕 迁 吴 分	欲 向 陇 山 现 夺 星
风 流 - 山 川 - 青 史 - 知 人 - 风 流==诸 葛 风 流 尚 未 休	山 川 为 斩 邓 锺 头	至 今 青 史 忧 吴 蜀	莫 把 知 人 责 夏 侯
山 寒 - 一 群 - 顿 曾 - 李 将 - 山 寒==白 登 山 寒 低 朔 云	野 马 黄 羊 各 一 群	冒 顿 曾 围 汉 天 子	胡 儿 惟 说 李 将 军
露 蕊 - 玉 人 - 妆 面 - 风 光 - 晓 色==晓 色 宜 直 露 蕊 鲜	玉 人 斜 插 斗 清 妍	新 花 更 映 新 妆 面	无 限 风 光 在 鬓 边
长 明 - 千 里 - 神 光 - 妨 金 - 长 明==灯 长 三 世 火 长 明	千 里 遗 踪 子 细 寻	自 是 神 光 能 永 夜	不 妨 金 偈 更 降 心
夜 雨 - 对 床 - 论 文 - 尘 埃 - 夜 雨==独 宿 空 斋 夜 雨 流	对 床 无 味 不 如 休	论 文 似 汝 相 逢 少	又 被 尘 埃 铺 席 囚
暮 烟 - 一 笛 - 山 青 - 分 明 - 暮 烟==鸟 飞 欲 尽 暮 烟 横	一 笛 西 风 万 里 晴	山 外 有 山 青 不 见	微 云 映 出 却 分 明
山 村 - 倚 门 - 赛 田 - 石 田 - 山 村==今 年 小 稔 遍 山 村	白 叟 黄 童 笑 倚 门	老 瓦 为 樽 赛 田 祖	石 田 多 稼 庆 曾 孙
山 林 - 夕 阳 - 芒 鞋 - 篮 舆 - 山 林==老 眼 山 林 自 是 宜	卧 龙 春 晚 夕 阳 迟	芒 鞋 竹 杖 经 行 遍	绝 胜 篮 舆 喝 道 时
静 坐 - 盘 恒 - 马 上 - 云 烟 - 水 边==水 边 静 坐 天 将 暮	犹 自 盘 恒 未 成 去	马 上 回 头 更 一 观	云 烟 已 隔 无 重 数
灯 烛 - 移 花 - 冰 盘 - 月 凉 - 灯 烛==竹 里 高 亭 灯 烛 光	月 移 花 影 上 西 厢	蔗 浆 金 碗 冰 盘 冻	始 信 人 间 五 月 凉
五 陵 - 山 中 - 夜 长 - 驻 马 - 五 陵==远 自 五 陵 独 窜 身	筑 阳 山 中 归 路 新	横 流 夜 长 不 得 渡	驻 马 荒 亭 逢 故 人
出 大 - 苍 梧 - 终 日 - 鹧 鸪 - 大 槐==真 人 梦 出 大 槐 宫	万 里 苍 梧 一 洗 空	终 日 忧 兄 行 不 得	鹧 鸪 应 是 鼻 亭 公
西 风 - 霜 林 - 无 人 - 紫 泥 - 万 木==纷 纷 万 木 尽 西 风	独 立 霜 林 我 御 冬	滓 畔 无 人 谁 着 语	止 斋 但 护 紫 泥 封
帘 疏 - 怅 望 - 知 几 - 两 见 - 爽 月==风 帘 疏 爽 月 徘 徊	怅 望 家 人 把 酒 杯	病 著 幽 窗 知 几 日	瓶 花 两 见 木 犀 开
红 尘 - 白 首 - 君 子 - 嵌 岩 - 红 尘==红 尘 半 世 仅 绯 衫	白 首 官 曹 两 换 衔	羞 见 淮 乡 隐 君 子	紫 芝 黄 独 老 嵌 岩
百 尺 - 扁 舟 - 西 山 - 云 生 - 百 尺==且 卧 元 龙 百 尺 楼	难 忘 江 海 一 扁 舟	西 山 爽 气 助 诗 兴	忽 有 碧 云 生 暮 愁
欲 去 - 雪 下 - 千 里 - 琼 枝 - 去 难==淮 上 惊 波 欲 去 难	更 逢 春 雪 下 云 端	思 君 一 夜 如 千 里	手 把 琼 枝 不 奈 寒
分 明 - 朝 檐 - 朱 门 - 秋 风 - 灯 花==灯 花 昨 夜 已 分 明	更 听 朝 檐 喜 鹊 声	明 日 朱 门 闭 空 馆	秋 风 骏 马 大 梁 城
飞 花 - 佛 灯 - 维 摩 - 醍 醐 - 飞 花==山 雨 飞 花 访 谢 连	新 诗 细 草 佛 灯 前	前 身 记 是 维 摩 诘	手 把 醍 醐 坐 白 莲
百 年 - 万 里 - 黄 金 - 元 勋 - 百 年==三 百 年 余 历 数 更	东 南 万 里 看 升 平	黄 金 台 上 麒 麟 阁	混 一 元 勋 是 贾 生
红 叶 - 凉 风 - 吟 秋 - 比 君 - 红 叶==不 堪 红 叶 青 苔 地	又 是 凉 风 暮 雨 天	莫 怪 独 吟 秋 思 苦	比 君 校 近 二 毛 年
鸾 旗 - 著 汉 - 山 花 - 鹧 鸪 - 从 鸾==夜 过 江 左 从 鸾 旗	从 此 灵 君 著 汉 衣	春 到 阴 山 花 似 雪	望 乡 台 上 鹧 鸪 飞
沉 迷 - 凭 阑 - 春 意 - 黄 鹂 - 沉 迷==日 于 诗 雅 转 沉 迷	尤 爱 凭 阑 此 构 题	飘 荡 杨 花 春 意 晚	黄 鹂 飞 过 水 东 西
萧 萧 - 神 仙 - 北 海 - 种 瓜 - 四 壁==萧 萧 四 壁 住 残 生	不 学 神 仙 不 学 僧	有 酒 未 能 忘 北 海	种 瓜 且 自 学 东 陵
烂 熟 - 志 真 - 健 儿 - 青 灯 - 烂 熟==九 边 烂 熟 等 雕 虫	远 志 真 看 小 草 同	枉 说 健 儿 身 手 在	青 灯 夜 雪 阻 山 东
眼 昏 - 似 雪 - 叶 落 - 马 蹄 - 眼 昏==病 眼 昏 昏 四 顾 迷	独 行 浑 似 雪 中 鸡	花 开 叶 落 真 成 梦	愁 听 门 前 过 马 蹄
春 盘 - 把 酒 - 夜 雨 - 便 作 - 春 盘==厨 供 樱 笋 上 春 盘	把 酒 留 春 少 住 难	只 是 檐 花 前 夜 雨	明 朝 便 作 酿 梅 看
红 云 - 晴 日 - 玉 阙 - 霞 巾 - 红 云==海 棠 亭 上 号 红 云	晴 日 青 天 绛 彩 新	疑 是 群 仙 朝 玉 阙	一 时 都 戴 紫 霞 巾
楼 阁 - 绝 顶 - 白 云 - 七 星 - 楼 阁==称 安 楼 阁 贯 空 嵌	绝 顶 磨 霄 凝 翠 岚	若 到 白 云 犹 未 半	凭 君 更 上 七 星 岩
堪 怜 - 寒 食 - 仙 掌 - 屯 田 - 江 乡==江 乡 春 事 最 堪 怜	寒 食 清 明 欲 禁 烟	残 月 晓 风 仙 掌 路	何 人 为 吊 柳 屯 田
长 门 - 萧 萧 - 松 柏 - 伤 心 - 长 门==定 知 生 不 出 长 门	禾 黍 萧 萧 寺 后 村	松 柏 城 南 万 丘 冢	伤 心 最 说 内 人 园
一 叶 - 早 秋 - 江 南 - 紫 云 - 烟 中==烟 中 一 叶 采 莲 舟	两 岸 香 风 正 早 秋	瞥 见 江 南 明 月 上	玉 箫 吹 断 紫 云 愁
云 衢 - 竹 深 - 儿 童 - 溪 风 - 风 吹==西 风 吹 步 上 云 衢	万 竹 深 围 一 草 庐	分 付 儿 童 勿 轻 剪	蜀 溪 风 月 正 关 渠
如 云 - 茜 裙 - 君 子 - 修 竹 - 如 云==甘 蕉 舒 绿 蔼 如 云	花 放 惟 应 配 茜 裙	何 事 偏 蒙 君 子 号	固 宜 修 竹 出 弹 文
纷 纷 - 云 深 - 便 好 - 霁 月 - 纷 纷==世 事 纷 纷 起 笑 端	五 云 深 处 最 高 寒	与 君 便 好 寻 前 约	霁 月 难 同 俗 眼 看
春 光 - 黄 鹂 - 夭 桃 - 牡 丹 - 年 年==年 年 宫 柳 好 春 光	百 啭 黄 鹂 绕 建 章	冶 杏 夭 桃 红 胜 锦	牡 丹 屏 里 燕 诸 王
露 下 - 空 山 - 黄 花 - 烟 雨 - 露 下==老 子 垂 垂 秋 露 下	九 月 空 山 天 气 寒	黄 花 剩 开 且 勿 剪	留 得 一 秋 烟 雨 看
深 夜 - 衾 寒 - 自 起 - 梅 花 - 深 夜==破 屋 难 禁 深 夜 雨	布 衾 寒 湿 半 床 云	愁 来 自 起 推 窗 看	人 比 梅 花 瘦 几 分
看 山 - 山 间 - 无 穷 - 半 山 - 凭 栏==莫 为 看 山 只 凭 栏	远 怀 犹 恨 两 山 间	坐 深 却 得 无 穷 趣	只 看 平 川 一 半 山
莺 声 - 窗 棂 - 浓 如 - 解 醒 - 莺 声==晓 枕 莺 声 带 梦 听	忽 看 淡 日 满 窗 棂	闲 愁 谁 遣 浓 如 酒	醉 过 残 春 不 解 醒
悲 秋 - 依 云 - 玉 漏 - 小 窗 - 断 肠==悲 秋 不 是 断 肠 初	风 景 依 依 云 影 疏	玉 漏 自 残 灯 自 落	小 窗 斜 月 半 庭 虚
截 断 - 冠 岭 - 春 色 - 桃 花 - 清 风==清 风 截 断 排 檐 雨	返 景 烧 成 冠 岭 霞	定 是 来 朝 好 春 色	海 棠 须 作 小 桃 花
豆 蔻 - 千 里 - 寻 芳 - 香 罗 - 豆 蔻==豆 蔻 花 封 小 字 缄	寄 声 千 里 落 云 帆	一 春 从 不 寻 芳 去	高 叠 香 罗 旧 赐 衫
东 风 - 余 寒 - 满 地 - 分 明 - 东 风==东 风 吹 雨 作 丝 轻	驾 勒 余 寒 放 晚 晴	满 地 湿 云 收 未 尽	一 帘 花 影 不 分 明
两 头 - 初 来 - 公 子 - 买 花 - 两 头==赣 州 船 子 两 头 尖	茉 莉 初 来 价 便 添	公 子 豪 华 钱 不 惜	买 花 只 拣 树 齐 檐
松 风 - 铜 瓶 - 声 闻 - 春 雪 - 松 风==松 风 桧 雨 到 来 初	急 引 铜 瓶 离 竹 炉	待 得 声 闻 俱 寂 后	一 瓯 春 雪 胜 醍 醐
日 佩 - 白 头 - 追 随 - 有 风 - 囊 侍==日 佩 诗 囊 侍 贵 臣	向 人 肯 作 白 头 新	自 今 歌 酒 追 随 去	犹 有 风 烟 一 半 春
清 明 - 月 朗 - 仙 仗 - 分 明 - 清 明==秋 来 夜 气 更 清 明	月 朗 窗 虚 梦 不 成	似 报 云 间 仙 仗 过	分 明 听 得 步 虚 声
到 处 - 不 归 - 归 去 - 赋 诗 - 到 处==到 处 江 山 非 不 佳	不 归 佛 屋 即 仙 家	南 山 自 好 不 归 去	落 魄 赋 诗 天 一 涯
冬 风 - 春 至 - 千 里 - 漫 漫 - 冬 风==一 冬 风 雪 苦 多 寒	春 至 冰 霜 更 积 攒	咫 尺 端 如 隔 千 里	况 于 楚 粤 路 漫 漫
残 日 - 柳 条 - 何 处 - 肠 断 - 残 日==残 日 西 楼 映 粉 红	画 眉 吹 蹙 柳 条 风	重 来 攀 折 人 何 处	肠 断 千 丝 一 笛 中
村 落 - 无 言 - 憔 悴 - 蜂 蝶 - 村 落==村 落 人 家 桃 李 枝	无 言 气 味 亦 依 依	可 怜 憔 悴 蓬 蒿 底	蜂 蝶 不 知 春 又 归
柳 色 - 一 枝 - 殷 勤 - 春 风 - 柳 色==遮 莫 江 头 柳 色 遮	日 浓 莺 睡 一 枝 斜	女 郎 折 得 殷 勤 看	道 是 春 风 及 第 花
抽 芽 - 清 明 - 五 日 - 桃 花 - 抽 芽==蕨 拳 欲 动 茗 抽 芽	节 近 清 明 路 近 家	五 日 缓 行 三 百 里	夹 溪 随 处 有 桃 花
月 明 - 清 声 - 中 庭 - 回 风 - 月 明==月 明 如 镜 酒 如 空	响 谷 清 声 出 汉 宫	怪 得 中 庭 红 叶 堕	琉 璃 帐 底 唱 回 风
触 石 - 万 壑 - 一 帆 - 画 船 - 触 石==拍 天 触 石 怒 涛 鸣	悬 瀑 奔 流 万 壑 声	好 借 一 帆 风 信 急	画 船 飞 过 富 阳 城
翠 丝 - 小 萼 - 鸳 鸯 - 分 明 - 翠 丝==翠 丝 盘 叶 碧 玲 珑	小 萼 花 铺 茜 缕 红	梦 里 鸳 鸯 留 不 得	分 明 却 在 绣 床 中
雨 濯 - 阑 干 - 楼 上 - 作 诗 - 吹 雨==江 风 吹 雨 濯 征 尘	百 尺 阑 干 爽 气 新	不 向 岳 阳 楼 上 醉	定 知 未 可 作 诗 人
载 酒 - 憔 悴 - 青 楼 - 锦 城 - 载 酒==落 拓 平 生 载 酒 行	如 今 憔 悴 鬓 丝 生	无 金 得 买 青 楼 笑	空 负 闲 愁 出 锦 城
清 秋 - 微 雨 - 离 恨 - 悠 悠 - 清 秋==琥 车 芝 驾 俨 清 秋	微 雨 侵 宵 助 涕 流	人 世 莫 嗟 离 恨 苦	却 应 天 上 更 悠 悠
江 天 - 亦 当 - 珍 重 - 生 春 - 江 天==江 天 买 得 总 输 君	我 亦 当 年 作 记 人	珍 重 平 生 一 杯 酒	又 孤 洲 渚 绿 生 春
赐 银 - 升 平 - 花 底 - 紫 泥 - 青 旗==青 旗 簇 仗 赐 银 幡	共 以 升 平 奉 至 尊	阊 阖 千 官 花 底 散	紫 泥 香 熟 诏 书 温
水 犹 - 泪 痕 - 心 随 - 橹 声 - 山 犹==山 犹 故 险 水 犹 奔	无 复 前 年 溅 泪 痕	自 是 人 心 随 境 别	橹 声 帆 色 尽 君 恩
断 桥 - 轻 舟 - 可 人 - 酒 家 - 断 桥==龙 舟 晓 发 断 桥 西	别 有 轻 舟 两 两 随	春 色 可 人 晴 较 稳	酒 家 争 出 柳 梢 旗
茫 茫 - 重 叠 - 春 寒 - 诗 人 - 影 微==笠 泽 茫 茫 雁 影 微	玉 峰 重 叠 护 云 衣	长 桥 寂 寞 春 寒 放	只 有 诗 人 一 舸 归
埋 玉 - 冠 谋 - 新 诗 - 可 徒 - 埋 玉==埋 玉 腰 间 觅 性 宗	儒 冠 谋 道 有 谁 同	笔 尖 冻 折 新 诗 就	但 可 徒 收 翰 墨 功
野 人 - 兴 不 - 归 来 - 西 山 - 野 人==懒 性 如 今 成 野 人	行 藏 由 兴 不 由 身	莫 惊 此 度 归 来 晚	买 得 西 山 正 值 春
白 玉 - 黄 金 - 中 到 - 云 深 - 凤 舞==白 玉 阶 前 金 凤 舞	黄 金 殿 上 玉 鸡 鸣	正 中 来 与 兼 中 到	昨 夜 云 深 月 正 明
一 曲 - 千 枝 - 知 处 - 酒 家 - 一 曲==一 曲 两 曲 涧 边 草	千 枝 万 枝 村 落 花	携 筇 深 去 不 知 处	几 叹 山 阿 隔 酒 家
马 蹄 - 日 长 - 篱 落 - 长 歌 - 马 蹄==留 得 春 风 趁 马 蹄	日 长 无 事 绿 杨 堤	菜 花 篱 落 谁 家 酒	缓 辔 长 歌 过 小 溪
霜 露 - 九 日 - 重 九 - 风 高 - 龙 山==九 日 龙 山 霜 露 凝	龙 川 九 日 气 如 烝	偶 逢 闰 月 还 重 九	酒 熟 风 高 喜 不 胜
人 语 - 一 茎 - 此 时 - 入 画 - 人 语==跨 水 行 人 语 不 符	绝 江 足 踏 一 茎 芦	此 时 独 自 栖 栖 去	今 日 人 将 入 画 图
沦 落 - 得 一 - 岭 头 - 他 谁 - 沦 落==江 西 诗 社 久 沦 落	晚 得 一 人 刘 改 之	不 向 岭 头 拈 取 去	此 衣 此 钵 付 他 谁
兰 若 - 风 清 - 万 象 - 低 头 - 兰 若==山 遥 海 阔 古 兰 若	月 白 风 清 老 比 丘	万 象 森 罗 总 宾 客	相 逢 莫 不 小 低 头
纤 尘 - 云 山 - 一 径 - 竹 床 - 冷 淡==湖 波 冷 淡 绝 纤 尘	满 目 云 山 是 四 邻	一 径 草 深 人 不 到	竹 床 蒲 扇 养 天 真
白 水 - 春 晴 - 飞 去 - 忘 机 - 白 水==白 水 满 塘 蒲 荇 青	野 凫 相 对 浴 春 晴	背 人 飞 去 犹 回 顾	我 已 忘 机 莫 浪 惊
文 章 - 者 莫 - 无 生 - 是 阿 - 文 章==辞 赋 文 章 能 者 稀	难 中 难 者 莫 过 诗	直 应 吟 骨 无 生 死	只 我 前 身 是 阿 谁
雨 露 - 溪 山 - 东 风 - 门 前 - 雨 露==百 里 桑 麻 雨 露 同	溪 山 无 地 不 春 风	东 风 若 问 春 来 处	尽 在 门 前 桃 李 中
无 人 - 压 枝 - 妙 手 - 犹 在 - 无 人==独 来 野 寺 无 人 识	故 作 寒 崖 雪 压 枝	相 得 平 生 藏 妙 手	只 今 犹 在 鬓 如 丝
深 山 - 马 上 - 玉 鞭 - 天 涯 - 深 山==深 山 曲 路 见 桃 花	马 上 匆 匆 日 欲 斜	可 奈 玉 鞭 留 不 住	又 衔 春 恨 到 天 涯
箕 山 - 无 人 - 岩 畔 - 千 古 - 寂 寂==寂 寂 箕 山 春 复 秋	更 无 人 到 此 溪 头	弃 瓢 岩 畔 中 宵 月	千 古 空 闻 属 许 由
画 船 - 红 红 - 长 水 - 月 上 - 画 船==一 出 宫 门 上 画 船	红 红 白 白 艳 神 仙	山 长 水 远 愁 无 那	又 见 江 南 月 上 弦
根 株 - 红 红 - 霜 风 - 百 丈 - 根 株==泰 华 根 株 本 一 同	何 分 白 白 与 红 红	半 池 只 怕 霜 风 倒	输 与 苍 颜 百 丈 松
三 台 - 惊 忙 - 草 木 - 亲 见 - 三 台==悬 崖 捉 拍 舞 三 台	死 虎 惊 忙 眼 豁 开	圣 地 不 生 凡 草 木	果 然 亲 见 瞎 堂 来
山 间 - 栖 烟 - 道 人 - 松 风 - 山 间==尝 爱 山 间 老 乔 松	栖 烟 宿 雨 盘 虬 龙	道 人 所 爱 偶 相 似	许 我 来 此 听 松 风
思 归 - 万 里 - 林 下 - 夜 深 - 客 思==紫 骝 回 首 客 思 归	万 里 家 山 蝶 梦 迷	问 宿 莫 来 林 下 邸	夜 深 生 怕 杜 鹃 啼
顶 偏 - 灵 苗 - 翠 叶 - 春 光 - 顶 偏==妙 峰 孤 顶 偏 肥 腻	天 产 灵 苗 不 触 地	翠 叶 无 风 常 自 摇	清 香 那 逐 春 光 媚
成 林 - 富 贵 - 一 灯 - 夜 堂 - 成 林==海 棠 初 绽 锦 成 林	多 少 人 间 富 贵 心	隽 永 一 灯 论 语 课	萧 萧 风 雨 夜 堂 深
十 年 - 桃 红 - 无 人 - 荔 枝 - 十 年==活 八 十 年 头 雪 白	啖 三 百 颗 面 桃 红	村 南 村 北 无 人 识	向 荔 枝 边 觅 此 翁
水 云 - 欲 语 - 冷 面 - 最 相 - 水 云==形 容 肮 脏 水 云 宜	心 意 阑 残 欲 语 谁	不 作 贵 人 炎 冷 面	北 山 逋 客 最 相 知
含 情 - 风 流 - 霓 旌 - 清 词 - 含 情==含 情 遥 夜 几 人 知	闲 咏 风 流 小 谢 诗	还 似 霓 旌 下 烟 露	月 边 吹 落 上 清 词
极 目 - 草 树 - 望 中 - 小 船 - 极 目==极 目 云 天 意 已 舒	迎 人 草 树 绿 扶 疏	望 中 孤 塔 松 江 近	便 有 小 船 来 卖 鱼
百 雉 - 衣 冠 - 荆 山 - 朝 宗 - 百 雉==楼 高 百 雉 楚 城 东	吴 蜀 衣 冠 邂 逅 逢	自 是 荆 山 为 屏 翰	更 看 江 汉 日 朝 宗
收 藏 - 珍 重 - 良 夜 - 林 花 - 收 藏==收 藏 春 色 驻 年 华	珍 重 王 孙 好 事 家	肯 挽 归 骖 共 良 夜	一 天 风 露 一 林 花
塞 北 - 落 怨 - 千 日 - 庭 前 - 江 南==塞 北 江 南 共 一 家	何 须 泪 落 怨 黄 沙	春 酒 半 酣 千 日 醉	庭 前 还 有 落 梅 花
东 风 - 柔 条 - 三 月 - 青 青 - 杨 柳==杨 柳 东 风 尽 日 吹	柔 条 应 自 不 禁 持	都 门 三 月 伤 心 地	强 半 青 青 赠 别 离
草 茸 - 清 和 - 霏 微 - 树 阴 - 草 茸==芳 草 茸 茸 没 屦 深	清 和 天 气 润 园 林	霏 微 小 雨 初 晴 处	暗 数 青 梅 立 树 阴
春 减 - 阳 微 - 层 楼 - 潮 不 - 春 减==花 飞 春 减 燕 雏 飞	西 兴 渡 口 夕 阳 微	等 闲 更 上 层 楼 望	贪 看 江 潮 不 肯 归
片 片 - 插 柳 - 晴 沙 - 春 去 - 片 片==片 片 飞 化 更 异 乡	人 家 插 柳 抵 愁 长	晴 沙 烟 草 几 今 古	春 去 春 来 燕 子 忙
莲 社 - 青 山 - 红 紫 - 云 绕 - 疏 钟==莲 社 疏 钟 报 晓 晴	青 山 落 日 映 江 明	一 番 红 紫 春 归 后	新 绿 如 云 绕 径 生
洛 滨 - 悠 悠 - 物 外 - 莺 啼 - 洛 滨==解 珮 当 时 在 洛 滨	悠 悠 疑 是 梦 中 身	自 从 物 外 无 消 息	花 谢 莺 啼 近 十 春
游 人 - 球 万 - 呼 大 - 婵 娟 - 游 人==游 人 总 戴 孟 家 蝉	争 托 星 球 万 眼 圆	闹 里 传 呼 大 官 过	后 车 多 少 尽 婵 娟
外 浓 - 春 风 - 步 障 - 与 王 - 外 浓==绿 外 浓 黄 白 外 红	一 屏 香 锦 立 春 风	天 真 步 障 豪 难 敌	借 与 王 家 赛 石 崇
渔 舟 - 无 人 - 江 头 - 江 山 - 渔 舟==渔 舟 竟 日 不 知 还	水 碓 无 人 也 不 闲	斫 却 江 头 一 丛 柳	当 愁 无 地 著 江 山
携 手 - 梦 中 - 山 老 - 才 高 - 携 手==携 手 河 梁 送 子 卿	池 塘 青 草 梦 中 生	武 林 今 有 梅 山 老	五 字 才 高 笔 代 耕
渺 渺 - 茸 茸 - 柳 花 - 城 头 - 渺 渺==春 江 渺 渺 抱 墙 流	烟 草 茸 茸 一 片 愁	吹 尽 柳 花 人 不 见	春 旗 催 日 下 城 头
扬 州 - 春 雨 - 繁 华 - 太 平 - 扬 州==扬 州 城 下 是 官 河	春 雨 春 风 自 绿 波	欲 问 繁 华 旧 时 事	太 平 遗 老 已 无 多
束 缚 - 生 抵 - 坐 钓 - 千 古 - 功 名==功 名 束 缚 几 英 豪	无 怪 先 生 抵 死 逃	坐 钓 桐 江 一 派 水	清 风 千 古 与 台 高
白 雪 - 一 束 - 诗 句 - 舞 衣 - 白 雪==爱 尝 佳 人 白 雪 辞	云 绫 一 束 费 春 机	翻 然 度 上 呈 诗 句	羞 杂 歌 喉 与 舞 衣
幽 谷 - 空 山 - 银 河 - 千 岩 - 积 雪==积 雪 悬 崖 照 幽 谷	轰 雷 破 石 响 空 山	直 疑 天 上 银 河 水	倒 泻 千 岩 万 壑 间
雪 花 - 骑 驴 - 扁 舟 - 江 行 - 雪 花==桐 庐 道 上 雪 花 飞	一 客 骑 驴 觅 雪 诗	亦 有 扁 舟 蓑 笠 兴	江 行 却 怕 子 陵 知
毫 端 - 草 木 - 灵 犀 - 辟 尽 - 毫 端==诗 老 毫 端 别 有 春	岩 前 草 木 也 精 神	锦 囊 留 得 灵 犀 在	辟 尽 人 间 俗 子 尘
寒 声 - 鸳 鸯 - 明 珠 - 翡 翠 - 寒 声==寒 声 敲 破 玉 琳 琅	绾 断 鸳 鸯 双 梦 长	几 斛 明 珠 收 不 起	巧 粘 翡 翠 络 红 妆
缥 缈 - 吹 箫 - 不 知 - 霜 花 - 缥 缈==五 云 缥 缈 隔 蓬 莱	仙 子 吹 箫 月 下 回	转 首 不 知 春 几 许	霜 花 如 雪 满 瑶 台
夹 岸 - 遗 迹 - 青 山 - 板 桥 - 夹 岸==夹 岸 人 家 映 柳 条	玄 晖 遗 迹 草 萧 萧	曾 为 一 夜 青 山 客	未 得 无 情 过 板 桥
南 山 - 照 牙 - 百 战 - 鸡 鸣 - 南 山==路 入 南 山 旧 汉 畿	油 油 清 渭 照 牙 旗	古 业 百 战 功 名 地	正 是 鸡 鸣 起 舞 时
一 行 - 云 程 - 时 却 - 梅 花 - 一 行==欲 寿 吾 前 酒 一 行	走 三 百 里 火 云 程	热 时 却 有 寒 时 节	汝 母 梅 花 腊 底 生
曾 学 - 大 江 - 三 千 - 第 几 - 何 曾==对 泣 何 曾 学 楚 囚	扁 舟 时 作 大 江 游	眼 看 西 蜀 三 千 里	身 在 淮 南 第 几 州
东 风 - 一 片 - 杜 鹃 - 夕 阳 - 无 语==晚 来 无 语 立 东 风	一 片 闲 情 在 碧 空	人 老 杜 鹃 浑 不 管	柳 桦 飞 尽 夕 阳 红
一 人 - 饮 闻 - 无 人 - 风 前 - 一 人==一 人 泉 在 此 山 颠	万 人 可 饮 闻 旧 言	顾 我 无 人 试 此 水	盛 夏 独 饮 南 风 前
万 丈 - 岁 华 - 云 边 - 石 桥 - 沧 海==万 丈 只 愁 沧 海 浅	一 身 谁 测 岁 华 遥	自 言 来 此 云 边 住	曾 看 秦 王 树 石 桥
心 清 - 更 长 - 庭 前 - 梅 花 - 妙 香==会 到 心 清 有 妙 香	蒲 团 纸 帐 任 更 长	闭 门 不 受 庭 前 月	分 付 梅 花 自 主 张
四 泽 - 茅 亭 - 戴 星 - 乘 月 - 四 泽==春 融 四 泽 形 如 介	著 我 茅 亭 跨 此 间	纵 使 戴 星 朝 玉 阙	终 输 乘 月 看 金 澜
依 依 - 山 青 - 明 月 - 云 飞 - 依 依==江 城 话 别 思 依 依	天 远 山 青 入 望 微	正 好 楼 头 共 明 月	可 堪 遥 对 白 云 飞
金 炉 - 芊 芊 - 潇 湘 - 不 眠 - 蕙 帐==蕙 帐 金 炉 冷 篆 烟	故 山 春 草 几 芊 芊	只 今 唯 有 潇 湘 月	万 里 相 随 照 不 眠
朱 门 - 酒 樽 - 天 色 - 风 吹 - 朱 门==藤 梢 棘 刺 失 朱 门	空 想 当 年 载 酒 樽	天 色 重 增 行 客 恨	东 风 吹 雨 湿 黄 昏
黄 菊 - 数 如 - 画 楼 - 赵 州 - 黄 菊==老 僧 轩 前 黄 菊 花	不 可 胜 数 如 恒 沙	谁 在 画 楼 沽 酒 处	相 邀 来 吃 赵 州 茶
国 香 - 芬 芳 - 人 世 - 蟾 宫 - 天 香==不 是 天 香 与 国 香	如 何 酿 得 许 芬 芳	黄 花 嚼 蕊 非 人 世	身 在 蟾 宫 寒 欲 霜
浮 筠 - 苍 髯 - 清 标 - 桃 李 - 浮 筠==间 错 浮 筠 冷 更 严	长 松 低 顾 拂 苍 髯	清 标 总 是 君 朋 侣	桃 李 相 望 几 陛 帘
客 路 - 春 光 - 桃 李 - 陇 头 - 山 行==只 将 客 路 当 山 行	自 觉 春 光 步 步 生	几 许 花 开 到 桃 李	东 风 又 趣 陇 头 耕
石 门 - 石 室 - 云 峰 - 春 风 - 石 门==仙 花 笑 尽 石 门 中	石 室 重 重 掩 绿 空	暂 下 云 峰 能 几 日	却 回 烟 驾 驭 春 风
五 湖 - 扁 舟 - 如 烟 - 黄 鹤 - 五 湖==五 湖 深 处 足 逍 遥	错 把 扁 舟 系 柳 条	尘 世 不 如 烟 水 阔	笑 骑 黄 鹤 上 层 霄
雁 来 - 捣 衣 - 独 步 - 绿 苔 - 雁 来==今 夕 秦 天 一 雁 来	梧 桐 坠 叶 捣 衣 催	思 君 独 步 华 亭 月	旧 馆 秋 阴 生 绿 苔
花 落 - 扉 行 - 绿 阴 - 归 去 - 花 落==石 楠 花 落 小 池 清	独 下 平 桥 弄 扉 行	蔽 日 绿 阴 无 觅 处	不 如 归 去 两 三 声
山 中 - 山 中 - 天 机 - 几 行 - 山 中==辜 负 山 中 月 与 风	心 无 城 市 亦 山 中	应 嫌 猿 鹤 天 机 浅	要 与 几 行 不 肯 同
地 炉 - 柴 荆 - 雪 中 - 风 景 - 地 炉==无 因 同 拨 地 炉 灰	想 见 柴 荆 晚 未 开	不 是 雪 中 须 送 炭	聊 装 风 景 要 诗 来
花 明 - 高 楼 - 相 思 - 黄 云 - 暗 花==柳 暗 花 明 池 上 山	高 楼 歌 酒 换 离 颜	他 时 欲 寄 相 思 字	何 处 黄 云 是 陇 间
秋 凉 - 秋 声 - 根 株 - 流 光 - 一 雨==一 雨 秋 凉 爽 气 新	秋 声 栗 栗 转 伤 神	根 株 半 载 培 多 少	倏 忽 流 光 不 待 人
水 平 - 杨 柳 - 山 色 - 春 归 - 残 红==残 红 委 地 水 平 池	杨 柳 阴 阴 莺 乱 飞	山 色 满 楼 新 雨 后	一 帘 风 絮 卷 春 归
废 寺 - 不 生 - 屋 漏 - 梁 上 - 废 寺==废 寺 乱 来 为 县 驿	荒 松 老 柏 不 生 烟	空 廊 屋 漏 画 僧 尽	梁 上 犹 书 天 宝 年
文 章 - 含 毫 - 寂 寂 - 读 书 - 文 章==青 钱 学 士 妙 文 章	便 合 含 毫 侍 帝 傍	寂 寂 闽 山 余 旧 隐	忆 君 时 到 读 书 堂
溪 边 - 漠 漠 - 随 风 - 梅 花 - 新 芽==溪 边 柳 色 露 新 芽	春 透 微 波 漠 漠 斜	一 阵 随 风 香 颇 异	定 知 前 面 有 梅 花
西 风 - 花 草 - 苍 松 - 诗 人 - 西 风==一 夜 西 风 作 晓 晴	纷 然 花 草 斗 欣 荣	苍 松 巧 与 天 桃 并	漫 使 诗 人 意 不 平
曙 色 - 春 风 - 家 家 - 无 人 - 曙 色==曙 色 才 分 鸡 便 唱	春 风 未 动 鸟 先 啼	一 床 胡 蝶 家 家 梦	祖 意 无 人 肯 入 思
黄 花 - 明 月 - 吾 家 - 手 拈 - 黄 花==翠 竹 黄 花 非 外 境	白 云 明 月 露 全 真	头 头 尽 是 吾 家 物	信 手 拈 来 不 是 尘
半 空 - 有 无 - 一 杯 - 时 与 - 半 空==牙 齿 漂 浮 欲 半 空	此 生 已 付 有 无 中	一 杯 藜 粥 枫 林 下	时 与 邻 翁 说 岁 丰
江 乡 - 天 涯 - 早 春 - 白 云 - 江 乡==江 乡 花 事 近 如 何	读 画 天 涯 忍 放 歌	开 遍 早 春 三 百 树	不 堪 回 首 白 云 多
渔 翁 - 童 自 - 数 声 - 星 悬 - 渔 翁==渔 翁 一 叶 舞 波 澜	不 及 牛 童 自 在 眠	短 备 数 声 烟 草 晚	柴 门 疏 柳 小 星 悬
带 雪 - 天 寒 - 瑶 池 - 九 分 - 带 雪==带 雪 匆 匆 别 楚 云	天 寒 依 约 见 湘 君	只 疑 不 合 瑶 池 去	引 得 春 风 八 九 分
金 谷 - 鹧 鸪 - 闻 处 - 月 明 - 第 一==金 谷 歌 传 第 一 流	鹧 鸪 清 怨 碧 烟 愁	夜 来 省 得 曾 闻 处	万 里 月 明 湘 水 秋
漠 漠 - 扁 舟 - 沽 酒 - 风 雨 - 漠 漠==江 烟 漠 漠 暮 天 昏	且 把 扁 舟 系 树 根	欲 问 村 中 沽 酒 处	家 家 风 雨 不 开 门
森 罗 - 神 机 - 游 戏 - 纵 横 - 森 罗==万 象 森 罗 总 是 诗	神 机 一 动 即 天 随	寒 梅 把 酒 真 游 戏	妙 意 纵 横 十 二 时
盘 空 - 石 泉 - 江 上 - 水 云 - 盘 空==盘 空 势 险 露 岩 根	深 洞 声 寒 落 石 泉	好 是 雨 馀 江 上 见	水 云 僧 出 认 西 天
功 业 - 日 月 - 断 碑 - 文 昌 - 功 业==淮 西 功 业 冠 吾 唐	吏 部 文 章 日 月 光	千 载 断 碑 人 脍 炙	不 知 世 有 段 文 昌
班 春 - 十 年 - 路 傍 - 君 何 - 班 春==班 春 无 术 劝 污 莱	五 十 年 间 此 一 回	黄 发 路 傍 应 怪 问	使 君 何 事 入 山 来
春 寒 - 醉 颜 - 春 畦 - 暮 雨 - 春 寒==门 外 春 寒 数 日 风	登 楼 聊 恃 醉 颜 红	水 浮 渺 莽 春 畦 外	山 在 冥 茫 暮 雨 中
银 盘 - 风 落 - 持 杯 - 翔 鸾 - 银 盘==碧 天 涌 出 烂 银 盘	万 里 颠 风 落 树 端	懒 复 持 杯 向 渠 问	径 思 飞 步 蹑 翔 鸾
飘 飘 - 酒 明 - 一 室 - 石 上 - 飘 飘==雨 袖 飘 飘 恍 欲 仙	半 醒 半 醉 酒 明 船	太 虚 一 室 都 无 碍	皎 月 凉 风 石 上 民
西 东 - 解 组 - 腊 尽 - 春 风 - 西 东==年 来 飘 泊 任 西 东	解 组 论 文 意 自 雄	腊 尽 竺 溪 渔 唱 晚	杏 花 溪 上 又 春 风
清 明 - 晴 作 - 千 丝 - 也 解 - 寒 食==今 年 寒 食 与 清 明	各 自 阴 晴 作 麽 生	细 雨 千 丝 不 成 点	如 何 也 解 滴 檐 声
春 光 - 杏 花 - 时 心 - 百 尺 - 日 光==日 日 春 光 斗 日 光	山 城 斜 路 杏 花 香	几 时 心 绪 浑 无 事	得 及 游 丝 百 尺 长
宫 妆 - 夜 凉 - 玉 簪 - 如 霜 - 宫 妆==危 冠 高 袖 楚 宫 妆	独 步 闲 庭 逐 夜 凉	自 把 玉 簪 敲 砌 竹	清 歌 一 曲 月 如 霜
荷 叶 - 岸 头 - 何 处 - 杜 鹃 - 荷 叶==荷 叶 初 浮 水 上 钱	柳 花 飘 尽 岸 头 绵	不 知 春 色 归 何 处	欲 向 空 山 问 杜 鹃
百 尺 - 仙 子 - 游 鱼 - 道 人 - 百 尺==百 尺 台 矶 瞰 碧 流	紫 阳 仙 子 几 经 秋	游 鱼 何 事 偏 深 逝	不 道 人 间 有 直 钩
层 层 - 浓 阴 - 斜 阳 - 氤 氲 - 层 层==层 层 石 磴 绕 青 云	绿 树 浓 阴 路 不 分	半 面 斜 阳 还 返 照	晴 烟 一 缕 碧 氤 氲
寂 寞 - 云 收 - 归 梦 - 空 山 - 客 情==寂 寞 灯 花 慰 客 情	湿 云 收 尽 月 还 明	夜 寒 不 作 东 归 梦	坐 听 空 山 落 叶 声
无 心 - 物 到 - 得 一 - 堂 里 - 无 心==人 间 镜 是 无 心 物	物 到 皆 知 丑 与 妍	欲 得 一 双 如 镜 眼	中 书 堂 里 坐 搜 贤
清 和 - 风 日 - 迎 凉 - 金 盘 - 清 和==南 交 司 令 已 清 和	满 殿 薰 风 日 未 斜	院 院 迎 凉 帘 尽 卷	金 盘 初 赐 御 园 瓜
一 番 - 春 容 - 庭 外 - 飞 扬 - 一 番==一 番 微 雨 一 番 晴	淡 淡 春 容 照 眼 明	庭 外 幽 花 自 开 落	飞 扬 无 处 觅 残 英
画 角 - 霜 花 - 最 怜 - 第 一 - 画 角==画 角 声 中 放 早 牙	弓 开 弦 月 剑 霜 花	最 怜 怒 臂 岑 牟 吏	特 试 渔 阳 第 一 挝
祝 融 - 山 中 - 足 迹 - 天 外 - 祝 融==祝 融 峰 下 烧 红 叶	应 梦 山 中 看 白 云	足 迹 未 教 容 易 见	谁 知 天 外 貌 人 闻
榴 花 - 菊 花 - 风 雨 - 轻 纱 - 辞 家==榴 花 才 放 客 辞 家	客 里 因 循 见 菊 花	独 坐 西 楼 对 风 雨	天 寒 犹 自 着 轻 纱
岸 上 - 溪 边 - 临 风 - 万 点 - 白 马==岸 上 金 羁 白 马 郎	溪 边 红 粉 断 人 肠	临 风 背 摘 双 头 蕊	笑 入 荷 花 万 点 妆
重 重 - 隔 帘 - 东 风 - 杨 花 - 重 重==帘 幕 重 重 下 玉 钩	隔 帘 春 在 柳 梢 头	东 风 著 意 相 料 理	吹 去 杨 花 不 自 由
东 风 - 画 屏 - 眼 界 - 人 心 - 东 风==小 立 东 风 紫 翠 颠	画 屏 展 尽 一 山 川	非 关 眼 界 因 高 别	自 是 人 心 逐 物 迁
一 水 - 多 少 - 羽 翼 - 风 吹 - 一 水==山 通 一 水 迳 皇 者	多 少 英 豪 出 此 途	传 我 飞 来 元 羽 翼	好 风 吹 送 过 天 衢
嫩 绿 - 压 枝 - 细 草 - 两 朵 - 桐 阴==嫩 绿 桐 阴 夹 道 遮	烂 红 野 果 压 枝 斜	日 烘 细 草 香 无 价	况 有 三 枝 两 朵 花
紫 禁 - 长 身 - 三 年 - 山 阴 - 紫 禁==紫 禁 胪 传 第 四 人	锦 肠 贝 齿 凛 长 身	三 年 来 作 诸 侯 客	千 里 江 山 阴 受 春
萧 萧 - 青 灯 - 涧 水 - 饮 酒 - 萧 萧==山 风 飒 飒 木 萧 萧	挑 尽 青 灯 夜 正 遥	但 得 诛 茅 临 涧 水	长 年 饮 酒 咏 离 骚
冲 融 - 一 叶 - 登 临 - 苦 吟 - 冲 融==冲 融 日 脚 未 全 心	一 叶 飞 黄 满 眼 秋	谩 向 登 临 追 宋 玉	苦 吟 谁 广 畔 牢 愁
岩 前 - 分 明 - 趋 庭 - 一 笑 - 读 易==读 易 岩 前 访 德 人	分 明 枯 菌 茁 芽 新	趋 庭 领 会 传 心 法	一 笑 陈 编 万 古 春
别 恨 - 枝 上 - 重 叠 - 何 处 - 别 恨==欲 折 杨 枝 别 恨 生	一 重 枝 上 一 啼 莺	乱 山 重 叠 云 相 掩	君 向 乱 山 何 处 行
梅 花 - 江 风 - 绰 约 - 四 时 - 梅 花==邾 城 山 下 梅 花 树	腊 月 江 风 好 在 无	争 似 姑 山 寻 绰 约	四 时 长 见 雪 肌 肤
春 寒 - 萧 条 - 落 梅 - 晚 风 - 地 炉==春 寒 犹 拨 地 炉 灰	门 巷 萧 条 客 不 来	特 有 落 梅 三 四 点	晚 风 吹 上 石 棋 台
长 候 - 芳 草 - 西 林 - 白 云 - 长 候==注 酒 攀 花 长 候 君	城 边 芳 草 已 斜 曛	登 楼 数 向 西 林 望	只 见 青 山 拥 白 云
有 情 - 客 心 - 隐 隐 - 走 马 - 有 情==柳 映 江 潭 底 有 情	望 中 频 遣 客 心 惊	巴 雷 隐 隐 千 山 外	更 作 章 台 走 马 声
梅 花 - 今 朝 - 东 风 - 林 间 - 梅 花==昨 日 梅 花 犹 可 攀	今 朝 残 萼 便 斓 班	群 仙 已 御 东 风 去	总 脱 绛 袂 留 林 间
辇 路 - 五 更 - 一 番 - 太 乙 - 辇 路==辇 路 香 融 雪 未 乾	鸡 人 初 唱 五 更 寒	琼 幡 第 一 番 花 信	吹 上 东 皇 太 乙 坛
看 山 - 白 云 - 无 穷 - 只 是 - 看 山==日 日 看 山 不 厌 山	白 云 吞 吐 翠 微 间	静 明 光 里 无 穷 乐	只 是 令 人 下 语 难
迢 递 - 草 色 - 眼 空 - 敲 推 - 红 尘==乘 驴 迢 递 走 红 尘	十 二 街 中 草 色 春	不 是 眼 空 京 兆 尹	敲 推 原 已 入 诗 神
天 门 - 萧 条 - 开 阁 - 一 竿 - 天 门==天 门 室 宿 郁 如 虹	海 上 萧 条 牧 豕 翁	会 得 平 津 开 阁 意	一 竿 寒 日 野 田 中
老 干 - 灯 残 - 江 湖 - 风 雨 - 老 干==可 是 诗 边 欠 老 干	藓 床 相 对 话 灯 残	秋 城 一 夜 江 湖 晚	风 雨 重 阳 菊 自 寒
芭 蕉 - 石 榴 - 啼 血 - 行 客 - 芭 蕉==芭 蕉 叶 开 大 如 席	石 榴 花 发 红 满 枝	子 规 何 似 苦 啼 血	正 是 行 客 东 还 时
岩 下 - 白 石 - 屹 作 - 百 年 - 岩 下==岩 下 碧 藤 挂 紫 烟	岩 头 白 石 插 青 天	精 灵 屹 作 乡 邦 镇	一 剑 霜 寒 二 百 年
重 阳 - 携 壶 - 泛 酒 - 此 时 - 重 阳==重 阳 开 燕 侍 清 躬	次 第 携 壶 到 菊 丛	仙 手 撚 花 亲 泛 酒	此 时 荣 遇 少 人 同
刺 绣 - 黄 鹂 - 春 意 - 停 针 - 佳 人==二 八 佳 人 刺 绣 迟	紫 荆 花 下 啭 黄 鹂	可 怜 无 限 伤 春 意	尽 在 停 针 不 语 时
一 曲 - 爱 楼 - 千 山 - 月 满 - 朱 栏==一 曲 朱 栏 百 尺 余	仙 人 自 是 爱 楼 居	松 风 不 动 千 山 静	月 满 天 坛 人 步 虚
黄 金 - 白 玉 - 堪 自 - 欲 谁 - 黄 金==黄 金 取 印 斗 来 大	白 玉 作 壶 冰 样 寒	子 号 甚 清 堪 自 照	吾 诗 愈 淡 欲 谁 看
柔 风 - 娇 红 - 何 处 - 光 分 - 柔 风==柔 风 软 日 斩 新 晴	酽 白 娇 红 鼎 盛 春	借 问 主 人 何 处 去	春 光 分 付 守 园 人
何 处 - 悠 悠 - 千 亩 - 江 上 - 何 处==未 知 何 处 是 吾 庐	南 北 悠 悠 意 所 如	不 爱 渭 川 千 亩 竹	与 君 江 上 卜 新 居
洞 庭 - 洞 庭 - 如 水 - 寒 蝉 - 洞 庭==洞 庭 高 秋 乃 无 事	洞 庭 主 人 独 多 才	满 天 如 水 乌 啼 夜	写 出 寒 蝉 湿 兔 来
金 藏 - 万 里 - 清 凉 - 避 暑 - 金 藏==三 伏 金 藏 暑 正 隆	火 云 万 里 日 轮 红	禁 中 自 有 清 凉 地	不 借 麻 姑 避 暑 宫
高 寒 - 嚣 尘 - 所 七 - 有 神 - 高 寒==风 露 高 寒 醉 梦 清	小 窗 香 雾 远 嚣 尘	不 须 所 七 戏 三 昧	始 信 司 花 女 有 神
酒 壶 - 犹 孤 - 刺 史 - 江 水 - 夜 灯==寒 夜 灯 前 赖 酒 壶	与 君 相 对 兴 犹 孤	忠 州 刺 史 应 闲 卧	江 水 猿 声 睡 得 无
无 穷 - 今 古 - 戊 辰 - 闲 吟 - 无 穷==车 书 混 一 业 无 穷	井 邑 山 川 今 古 同	戊 辰 年 向 金 陵 过	惆 怅 闲 吟 忆 庾 公
万 仞 - 霏 霏 - 白 练 - 六 花 - 万 仞==苍 岷 万 仞 起 岩 峦	潺 瀑 霏 霏 尽 日 寒	倒 泻 银 河 拖 白 练	人 间 应 作 六 花 看
苍 梧 - 水 云 - 清 夜 - 独 坐 - 斑 竹==调 入 苍 梧 斑 竹 枝	潇 湘 渺 渺 水 云 思	听 来 记 得 华 清 夜	疏 雨 梧 桐 独 坐 时
一 粒 - 付 何 - 向 掌 - 江 山 - 一 粒==大 地 犹 如 一 粒 粟	而 今 此 语 付 何 人	时 时 撮 向 掌 中 看	吴 蜀 江 山 一 样 新
新 诗 - 皎 皎 - 逢 开 - 几 多 - 新 诗==怜 君 醉 里 赋 新 诗	皎 皎 风 前 玉 树 枝	在 处 相 逢 开 口 笑	一 生 能 有 几 多 时
远 道 - 新 莺 - 故 人 - 春 草 - 远 道==暂 出 河 边 思 远 道	却 来 窗 下 听 新 莺	故 人 一 别 几 时 见	春 草 还 从 旧 处 生
阴 阴 - 漠 漠 - 长 歌 - 白 头 - 阴 阴==山 木 阴 阴 击 晚 牛	水 田 漠 漠 任 春 鸥	长 歌 大 笑 却 归 去	长 在 农 家 今 白 头
经 年 - 松 楸 - 寒 食 - 门 前 - 春 风==春 风 客 里 动 经 年	寂 寞 松 楸 入 梦 边	斗 酒 谁 为 寒 食 奠	懒 将 杨 柳 插 门 前
精 舍 - 泊 舟 - 青 山 - 画 出 - 精 舍==溪 上 遥 闻 精 舍 钟	泊 舟 微 径 度 深 松	青 山 霁 后 云 犹 在	画 出 东 南 四 五 峰
虹 桥 - 手 文 - 迷 路 - 寻 无 - 虹 桥==虹 桥 一 断 几 午 龄	亲 手 文 公 再 造 成	何 事 游 人 尚 迷 路	乱 寻 无 楫 渡 船 撑
北 风 - 自 由 - 天 时 - 报 道 - 北 风==南 风 作 雨 北 风 休	岂 是 春 云 得 自 由	只 者 天 时 过 湖 得	长 年 报 道 不 须 愁
碧 玉 - 漂 絮 - 幸 自 - 两 缕 - 碧 玉==头 上 高 垂 碧 玉 盆	谁 将 漂 絮 尚 残 痕	青 天 幸 自 秋 江 样	须 若 三 丝 两 缕 云
无 语 - 一 毫 - 功 成 - 云 台 - 有 无==有 无 语 默 谩 徒 劳	居 士 何 曾 动 一 毫	世 祖 功 成 三 十 六	云 台 争 似 钓 台 高
岁 月 - 幽 花 - 旗 亭 - 骑 驴 - 岁 月==晚 境 那 禁 岁 月 催	幽 花 又 见 涧 边 开	莫 辞 剩 买 旗 亭 酒	恐 有 骑 驴 李 白 来
绣 衣 - 一 世 - 千 尺 - 新 诗 - 绣 衣==绣 衣 双 节 从 天 下	文 字 皆 称 一 世 豪	桂 山 发 地 凛 千 尺	新 诗 与 之 相 并 高
荡 漾 - 春 草 - 渔 翁 - 蓑 笠 - 荡 漾==春 波 荡 漾 满 方 塘	春 草 无 名 各 自 长	沙 际 渔 翁 偏 自 在	醉 抛 蓑 笠 卧 斜 阳
琵 琶 - 古 今 - 紫 塞 - 娟 娟 - 琵 琶==红 叶 琵 琶 出 嘉 州	四 弦 弹 尽 古 今 愁	胡 沙 漫 漫 紫 塞 晓	汉 月 娟 娟 青 冢 秋
百 尺 - 白 龙 - 云 雨 - 万 顷 - 百 尺==水 洞 深 无 百 尺 泉	白 龙 奋 蛰 已 多 年	谁 知 此 物 能 云 雨	常 济 山 南 万 顷 田
年 年 - 江 湖 - 一 樽 - 残 花 - 年 年==年 年 俗 雨 愁 春 晚	况 是 江 湖 两 鬓 华	欲 载 一 樽 乘 兴 去	不 知 何 处 有 残 花
巽 二 - 恶 破 - 功 业 - 停 杯 - 巽 二==滕 六 无 端 巽 二 痴	翻 天 作 恶 破 春 迟	邀 梅 勒 柳 何 功 业	谁 与 停 杯 一 问 之
炬 红 - 马 蹄 - 胜 游 - 点 缀 - 万 炬==昭 觉 芙 蕖 万 炬 红	马 蹄 无 处 避 香 风	胜 游 似 梦 难 重 省	最 忆 琼 酥 点 缀 工
一 杯 - 五 行 - 自 穷 - 明 月 - 一 杯==人 间 万 事 一 杯 酒	之 子 五 行 千 两 金	听 我 自 穷 诗 自 老	半 江 明 月 苇 花 深
蟠 桃 - 脂 嫩 - 人 世 - 清 香 - 蟠 桃==蟠 桃 移 种 杏 园 初	红 抹 燕 脂 嫩 脸 苏	闻 道 飘 零 落 人 世	清 香 得 似 旧 时 无
水 石 - 四 围 - 时 桐 - 夕 照 - 天 台==家 住 天 台 水 石 村	四 围 都 是 给 孤 园	有 时 桐 柏 庵 中 去	归 下 层 峦 夕 照 昏
春 来 - 芳 心 - 陌 上 - 烟 雨 - 处 处==春 来 处 处 有 花 看	一 种 芳 心 欲 吐 难	陌 上 鹅 黄 初 染 柳	不 禁 烟 雨 袅 轻 寒
楼 阁 - 柳 丝 - 满 地 - 百 花 - 楼 阁==玲 珑 楼 阁 江 城 晚	杨 柳 丝 丝 凝 碧 烟	飞 燕 不 归 春 满 地	百 花 香 里 听 啼 鹃
虚 空 - 在 问 - 一 片 - 何 处 - 虚 空==虚 空 年 与 寿 山 同	答 处 由 来 在 问 宗	但 见 皇 风 成 一 片	不 知 何 处 是 疆 封
霏 霏 - 花 上 - 横 枝 - 故 应 - 无 声==霏 霏 冻 雨 细 无 声	解 洗 梅 花 花 上 尘	似 与 横 枝 借 颜 色	故 应 添 我 一 分 春
虎 踞 - 强 名 - 千 古 - 潮 声 - 龙 蟠==龙 蟠 虎 踞 秣 陵 城	甬 上 苍 官 亦 强 名	独 占 高 峰 傲 千 古	夜 深 月 照 落 潮 声
清 露 - 柳 条 - 登 高 - 皇 州 - 雨 过==雨 过 风 清 露 气 匀	林 花 变 色 柳 条 新	为 君 作 意 登 高 处	试 望 皇 州 表 里 春
清 和 - 领 客 - 胜 日 - 西 湖 - 清 和==今 日 清 和 和 又 清	王 孙 领 客 出 都 城	好 天 胜 日 能 多 少	三 到 西 湖 始 一 晴
漠 漠 - 彷 佛 - 诗 书 - 细 雨 - 漠 漠==杏 花 漠 漠 柳 阴 阴	彷 佛 前 年 礼 殿 深	赖 有 诗 书 缘 不 心	青 灯 细 雨 短 长 吟
繁 红 - 忘 忧 - 数 朵 - 春 愁 - 凄 凉==繁 红 落 尽 始 凄 凉	直 道 忘 忧 也 未 忘	数 朵 殷 红 似 春 在	春 愁 特 此 系 人 肠
天 马 - 玉 门 - 勒 勋 - 春 色 - 天 马==雅 歌 不 待 来 天 马	谢 质 今 应 闭 玉 门	早 勒 勋 名 上 彝 鼎	放 回 春 色 满 乾 坤
小 窗 - 断 续 - 归 去 - 秋 风 - 小 窗==小 窗 棋 静 一 枰 空	多 事 蝉 声 断 续 中	过 雨 凉 生 醉 归 去	不 知 明 日 又 秋 风
极 浦 - 孤 舟 - 半 夜 - 山 中 - 无 人==平 沙 极 浦 无 人 度	犹 系 孤 舟 寒 草 西	半 夜 起 看 潮 上 月	万 山 中 有 一 猿 啼
满 炉 - 夜 半 - 老 死 - 蠹 鱼 - 窗 暖==北 窗 暖 焰 满 炉 红	夜 半 涛 翻 古 桧 风	老 死 爱 书 心 不 厌	来 生 恐 堕 蠹 鱼 中
植 高 - 红 炉 - 门 前 - 金 玉 - 元 不==芙 蕖 元 不 植 高 原	插 向 红 炉 色 更 鲜	拖 取 门 前 担 粪 汉	满 堂 金 玉 富 熏 天
绝 壁 - 铸 金 - 神 仙 - 声 和 - 绝 壁==绝 壁 初 无 路 可 通	何 人 特 地 铸 金 钟	神 仙 底 处 应 难 诘	弹 落 余 声 和 涧 松
昆 仑 - 何 处 - 字 光 - 花 外 - 昆 仑==沆 瀣 昆 仑 未 晓 霞	霞 边 何 处 着 瑶 花	初 邻 扁 字 光 穿 室	花 外 何 时 我 小 车
轻 明 - 徘 徊 - 江 梅 - 驿 使 - 轻 明==一 点 轻 明 照 雪 开	六 花 惊 妒 亦 徘 徊	清 香 不 在 江 梅 后	底 事 全 无 驿 使 来
第 一 - 谛 不 - 去 来 - 檐 花 - 第 一==空 观 假 观 第 一 观	佛 言 世 谛 不 可 乱	人 生 宛 有 去 来 今	卧 听 檐 花 落 秋 半
玉 京 - 狂 歌 - 横 空 - 醉 月 - 玉 京==曾 赐 琳 腴 白 玉 京	狂 歌 起 舞 蜀 人 惊	却 骑 黄 鹤 横 空 去	今 夕 垂 虹 醉 月 明
鲈 鱼 - 惟 见 - 垂 钓 - 无 人 - 忆 鲈==脍 忆 鲈 鱼 秋 正 肥	当 年 惟 见 季 鹰 归	沧 波 此 处 堪 垂 钓	当 代 无 人 肯 拂 衣
修 洁 - 东 风 - 珠 玉 - 寒 塘 - 修 洁==眼 前 修 洁 独 修 篁	屡 倩 东 风 洗 晓 妆	学 舞 腰 肢 困 珠 玉	可 怜 官 柳 在 寒 塘
孟 冬 - 寒 水 - 朝 天 - 殿 前 - 冬 月==柳 家 汀 洲 孟 冬 月	云 寒 水 清 荻 花 发	一 枝 持 赠 朝 天 人	愿 比 蓬 莱 殿 前 雪
泉 声 - 归 兴 - 十 围 - 束 腰 - 泉 声==泉 声 恰 似 世 情 恶	山 色 不 如 归 兴 浓	自 恨 十 围 无 处 著	何 如 瘦 作 束 腰 蜂
高 楼 - 南 邻 - 夕 阳 - 青 铜 - 江 上==江 上 高 楼 花 欲 然	南 邻 酒 伴 西 邻 眠	夕 阳 未 下 逢 君 好	还 有 一 百 青 铜 钱
送 春 - 一 枝 - 芳 草 - 客 愁 - 酒 醒==酒 醒 闲 写 送 春 诗	细 雨 残 花 尚 一 枝	莫 向 天 涯 望 芳 草	客 愁 多 似 去 年 时
雨 后 - 红 日 - 舆 十 - 云 脚 - 斜 阳==雨 后 斜 阳 未 见 晴	晓 看 红 日 报 空 明	笋 舆 十 里 宣 溪 路	划 地 浓 云 脚 里 行
习 射 - 寒 窗 - 良 辰 - 起 予 - 习 射==华 圃 控 弦 秋 习 射	寒 窗 留 烛 夜 钞 书	良 辰 美 景 饶 心 事	观 日 相 并 乐 起 予
花 外 - 到 处 - 家 家 - 读 书 - 花 外==槛 边 花 外 尽 重 湖	到 处 怀 觞 兴 不 孤	安 得 家 家 寻 画 手	溪 堂 遍 写 读 书 图
两 岸 - 轧 轧 - 人 间 - 清 风 - 青 山==两 岸 青 山 下 建 溪	笋 舆 轧 轧 坐 鸡 栖	人 间 最 是 吴 儿 乐	一 枕 清 风 过 浙 西
鸟 迹 - 管 弦 - 风 流 - 朱 门 - 鸟 迹==鸟 迹 分 明 在 帝 台	管 弦 声 里 轧 书 来	回 头 一 觉 风 流 梦	犹 得 朱 门 傍 水 开
柴 门 - 栏 槛 - 珠 帘 - 羯 鼓 - 柴 门==野 老 柴 门 日 日 开	且 无 栏 槛 碍 飞 回	劝 君 莫 入 珠 帘 去	羯 鼓 如 雷 打 出 来
金 风 - 怀 开 - 突 兀 - 破 藓 - 金 风==作 意 金 风 故 故 催	凉 秋 一 望 客 怀 开	楼 高 突 兀 荷 兰 筑	笑 指 诗 人 破 藓 来
万 里 - 江 南 - 夜 深 - 梅 花 - 万 里==飘 蓬 万 里 隔 风 沙	梦 到 江 南 未 到 家	料 得 夜 深 霜 月 苦	几 人 挥 泪 说 梅 花
雨 晴 - 上 下 - 笙 无 - 西 湖 - 雨 晴==涌 金 门 外 雨 晴 初	多 少 红 船 上 下 趋	龙 管 凤 笙 无 韵 调	却 挝 战 鼓 下 西 湖
浪 平 - 风 轻 - 极 目 - 南 山 - 长 江==八 月 长 江 去 浪 平	片 帆 一 道 带 风 轻	极 目 不 分 天 水 色	南 山 南 是 岳 阳 城
三 月 - 画 船 - 怀 索 - 水 声 - 江 南==三 月 江 南 梅 子 青	春 游 已 过 画 船 横	酒 怀 索 寞 人 初 倦	已 喜 金 杯 弄 水 声
里 当 - 扑 地 - 春 光 - 客 思 - 靖 安==靖 安 宅 里 当 窗 柳	望 驿 台 前 扑 地 花	两 处 春 光 同 日 尽	居 人 思 客 客 思 家
神 仙 - 曳 尾 - 乘 云 - 衣 冠 - 神 仙==猖 狂 战 国 古 神 仙	曳 尾 泥 涂 老 更 安	厌 世 乘 云 人 不 见	空 坟 聊 复 葬 衣 冠
深 红 - 剪 刀 - 桃 花 - 胭 脂 - 深 红==浅 碧 深 红 大 半 残	恶 风 催 雨 剪 刀 寒	桃 花 不 比 杭 州 女	洗 却 胭 脂 不 耐 看
风 骨 - 定 千 - 英 绝 - 俯 仰 - 风 骨==觥 觥 益 阳 风 骨 奇	壮 年 自 定 千 首 诗	勇 于 自 信 故 英 绝	胜 彼 优 孟 俯 仰 为
春 光 - 花 信 - 雨 意 - 愁 亦 - 春 光==九 十 春 光 已 暗 过	雕 阑 花 信 竟 如 何	应 知 雨 意 和 愁 约	雨 到 床 头 愁 亦 多
生 涯 - 芍 药 - 疏 影 - 梅 花 - 生 涯==隐 论 冲 寂 澹 生 涯	芍 药 缨 桃 厌 艳 华	剔 乱 剪 毓 疏 影 瘦	临 溪 只 合 种 梅 花
山 光 - 晓 云 - 几 点 - 杨 花 - 山 光==远 近 山 光 浓 淡 中	晓 云 零 乱 越 湖 风	飞 来 几 点 浴 佛 雨	湿 住 杨 花 粘 落 红
远 近 - 车 马 - 名 利 - 空 阶 - 远 近==喧 静 不 由 居 远 近	大 都 车 马 就 权 门	野 人 住 处 无 名 利	草 满 空 阶 树 满 园
平 堤 - 有 携 - 何 处 - 如 雪 - 平 堤==乌 塘 渺 渺 绿 平 堤	堤 上 行 人 各 有 携	试 问 春 风 何 处 好	辛 夷 如 雪 柘 冈 西
红 锦 - 柳 绿 - 窥 鱼 - 一 点 - 红 锦==出 岸 桃 花 红 锦 英	夹 堤 杨 柳 绿 丝 轻	遥 看 白 鹭 窥 鱼 处	立 破 平 湖 一 点 青
每 到 - 品 题 - 游 山 - 缓 步 - 即 少==每 到 精 庐 即 少 留	品 题 清 境 甲 湘 州	游 山 脚 力 犹 强 健	缓 步 曾 登 最 上 头
一 叶 - 野 鹤 - 梅 花 - 半 叶 - 黄 芦==一 叶 黄 芦 渡 渺 茫	误 随 野 鹤 上 维 扬	角 声 吹 断 梅 花 梦	依 旧 枫 湾 半 叶 霜
雪 花 - 梢 头 - 合 不 - 溪 桥 - 竹 屋==雪 花 竹 屋 未 全 消	寒 雀 梢 头 眼 擘 椒	纸 合 不 烟 梅 自 放	底 能 踏 湿 渡 溪 桥
天 酒 - 别 离 - 归 去 - 肠 断 - 秋 天==摇 落 秋 天 酒 易 醒	凄 凄 长 似 别 离 情	黄 昏 倚 柱 不 归 去	肠 断 绿 荷 风 雨 声
波 间 - 无 尘 - 公 子 - 山 家 - 波 间==呷 呷 波 间 锦 羽 明	地 无 尘 处 可 幽 亭	唤 回 天 上 张 公 子	来 与 山 家 注 水 经
刺 史 - 望 仙 - 黄 鹤 - 碧 桃 - 刺 史==罗 池 刺 史 寡 尘 缘	画 战 墙 头 筑 望 仙	黄 鹤 与 谁 同 一 去	碧 桃 无 主 又 千 年
数 竿 - 深 绿 - 此 时 - 清 流 - 数 竿==坏 砌 颓 檐 竹 数 竿	一 方 深 绿 照 人 寒	此 时 别 有 真 消 息	不 用 清 流 引 激 湍
悲 秋 - 古 渡 - 尘 土 - 悠 悠 - 江 南==江 南 为 客 正 悲 秋	更 送 吾 师 古 渡 头	惆 怅 不 同 尘 土 别	水 云 踪 迹 去 悠 悠
直 下 - 自 从 - 天 寒 - 朝 宗 - 直 下==雪 瀑 翻 崖 直 下 深	自 从 开 辟 到 如 今	天 寒 水 涩 山 风 急	不 断 朝 宗 一 派 心
一 抱 - 面 面 - 洞 天 - 小 蓬 - 一 抱==涧 流 一 一 抱 峰 回	面 面 林 峦 锦 帐 开	我 品 洞 天 居 第 七	只 应 题 作 小 蓬 莱
独 立 - 葛 藤 - 夜 夜 - 孤 灯 - 三 年==三 年 独 立 已 成 僧	欲 与 何 人 说 葛 藤	夜 夜 隔 墙 囚 叫 佛	三 生 因 果 伴 孤 灯
夜 雨 - 庭 院 - 樽 前 - 梅 花 - 夜 雨==浓 淡 春 云 夜 雨 干	寂 寥 庭 院 夹 衣 寒	无 人 为 发 樽 前 笑	但 把 梅 花 似 旧 看
半 老 - 沙 际 - 归 去 - 夜 雨 - 半 老==坡 头 霜 木 秋 半 老	沙 际 水 禽 时 一 双	乞 我 短 篷 归 去 好	醉 听 夜 雨 卧 荒 江
华 胥 - 一 纸 - 江 上 - 萧 疏 - 华 胥==恰 回 午 枕 自 华 胥	忽 得 周 郎 一 纸 书	江 上 春 风 能 几 日	莫 教 门 外 柳 萧 疏
枫 叶 - 冷 淡 - 繁 华 - 秋 来 - 枫 叶==枫 叶 飘 林 竹 隔 墙	偏 于 冷 淡 逞 浓 妆	天 教 不 趁 繁 华 月	要 是 秋 来 独 耐 霜
横 吹 - 山 壁 - 闭 户 - 灯 花 - 横 吹==大 风 横 吹 斗 柄 折	迅 雷 下 击 山 壁 裂	放 翁 闭 户 寂 不 闻	楞 严 卷 尽 灯 花 结
烟 霏 - 白 鸟 - 芳 草 - 风 送 - 漠 漠==晓 山 漠 漠 尽 烟 霏	四 面 楼 台 白 鸟 稀	芳 草 年 年 湖 上 路	柳 花 风 送 钓 船 归
春 意 - 锦 袍 - 妒 妍 - 风 雨 - 春 意==矫 春 意 谓 已 坚 牢	次 第 千 林 散 锦 袍	恐 有 天 魔 妒 妍 好	遽 连 风 雨 作 粗 豪
清 明 - 飞 雪 - 莺 燕 - 杜 鹃 - 艳 冶==过 却 清 明 艳 冶 天	梨 花 飞 雪 柳 森 烟	欲 凭 莺 燕 留 春 住	无 奈 东 风 信 杜 鹃
芍 药 - 枝 上 - 合 欢 - 秋 风 - 曲 栏==芍 药 春 深 映 曲 栏	海 棠 枝 上 雨 初 残	合 欢 扇 在 君 须 记	莫 放 秋 风 一 夜 寒
杉 松 - 江 水 - 凭 阑 - 远 山 - 萧 飒==庙 里 杉 松 萧 飒 风	庙 前 江 水 碧 溶 溶	凭 阑 不 见 当 时 事	落 日 远 山 千 万 重
木 落 - 黄 芦 - 南 涧 - 漠 漠 - 木 落==东 江 木 落 水 分 洪	伐 尽 黄 芦 洲 渚 空	南 涧 夕 阳 烟 自 起	西 山 漠 漠 有 无 中
天 涯 - 凄 凉 - 立 马 - 一 声 - 天 涯==广 陵 人 去 客 天 涯	旧 馆 凄 凉 闭 落 花	立 马 斜 阳 空 洒 泪	一 声 横 笛 起 邻 家
龙 鳞 - 孤 臣 - 方 寸 - 惟 有 - 龙 鳞==屡 批 龙 鳞 眷 未 衰	孤 臣 万 死 负 恩 私	玉 阶 方 寸 从 容 语	惟 有 天 知 与 上 知
眼 界 - 杜 园 - 真 率 - 溪 山 - 眼 界==洲 墅 楼 前 眼 界 新	杜 园 池 馆 更 迥 萦	是 中 一 景 偏 真 率	觉 得 溪 山 却 浑 成
夜 深 - 归 来 - 浩 渺 - 江 湖 - 月 冷==夜 深 霜 月 冷 侵 肤	醉 饮 归 来 得 自 娱	雾 气 水 光 同 浩 渺	误 看 田 野 作 江 湖
黛 色 - 重 重 - 醉 醒 - 昨 夜 - 色 浓==马 首 寒 山 黛 色 浓	一 重 重 尽 一 重 重	醉 醒 已 在 他 人 界	犹 忆 东 阳 昨 夜 钟
岩 前 - 迢 迢 - 湖 上 - 画 桡 - 岩 前==少 室 岩 前 路 不 遥	毫 芒 才 拟 便 迢 迢	西 湖 湖 上 晚 来 看	小 艇 轻 风 落 画 桡
地 轴 - 天 更 - 儿 船 - 起 风 - 地 轴==踏 翻 地 轴 地 不 动	推 倒 天 关 天 更 高	稳 泛 儿 船 归 少 室	至 今 天 下 起 风 涛
度 柳 - 春 水 - 行 人 - 马 蹄 - 度 柳==度 柳 穿 桥 听 午 鸡	一 沟 春 水 国 门 西	行 人 不 用 伤 新 别	看 取 尘 间 万 马 蹄
栽 松 - 山 色 - 归 去 - 画 屏 - 栽 松==岂 是 栽 松 待 茯 苓	且 图 山 色 镇 长 青	他 年 行 脚 不 归 去	留 与 人 间 作 画 屏
日 月 - 烟 霞 - 蟠 桃 - 春 草 - 日 月==九 天 日 月 开 黄 道	十 洞 烟 霞 接 紫 清	为 问 蟠 桃 当 熟 未	人 间 春 草 几 枯 荣
春 水 - 雁 北 - 满 庭 - 小 窗 - 江 湖==江 湖 春 水 欲 生 时	开 尽 梅 花 雁 北 飞	风 雨 满 庭 人 不 寐	小 窗 灯 火 夜 深 微
江 声 - 得 月 - 一 曲 - 故 人 - 山 色==山 色 江 声 相 与 清	卷 帘 待 得 月 华 生	可 怜 一 曲 并 船 笛	说 尽 故 人 离 别 情
成 丛 - 烟 雨 - 一 声 - 清 风 - 成 丛==亭 前 绿 密 玉 成 丛	凤 宿 枝 头 烟 雨 空	箫 管 一 声 人 未 寝	满 林 明 月 浸 清 风
百 花 - 无 人 - 竹 叶 - 花 上 - 百 花==花 满 百 花 潭 北 庄	无 人 同 出 碧 鸡 坊	因 风 竹 叶 浮 巾 翠	落 地 松 花 上 屐 香
春 回 - 横 斜 - 长 愁 - 一 笑 - 春 回==笋 舆 行 处 及 春 回	石 里 横 斜 亦 见 梅	路 细 山 长 愁 欲 绝	可 怜 一 笑 向 人 开
相 惊 - 白 两 - 王 副 - 得 一 - 相 见==亲 朋 相 见 忽 相 惊	绿 发 朝 来 白 两 茎	若 比 商 州 王 副 使	预 先 才 得 一 年 生
巷 口 - 阑 干 - 系 马 - 无 树 - 巷 口==萧 家 巷 口 花 如 雾	红 粉 阑 干 酒 旆 斜	记 得 少 年 曾 系 马	如 今 无 树 可 啼 鸦
一 叶 - 秋 风 - 潇 潇 - 夜 凉 - 一 叶==万 绿 枝 头 一 叶 黄	秋 风 恰 则 到 林 塘	晚 云 更 作 潇 潇 雨	拾 得 人 间 一 夜 凉
翔 鸾 - 寻 墨 - 无 主 - 遗 编 - 翔 鸾==驾 返 翔 鸾 日 驾 寒	难 寻 墨 子 未 央 丸	疏 香 无 主 蕉 窗 冷	欲 读 遗 编 不 忍 看
隐 居 - 泥 污 - 五 更 - 时 有 - 云 林==满 地 云 林 称 隐 居	燕 泥 污 我 读 残 书	五 更 风 急 鸟 声 散	时 有 隔 花 来 卖 鱼
宝 马 - 掌 中 - 富 贵 - 青 楼 - 宝 马==宝 马 平 驰 过 夕 阴	飞 丸 遥 堕 掌 中 金	不 知 富 贵 缘 何 事	偏 动 青 楼 瞥 见 心
稀 星 - 吹 角 - 五 更 - 一 曲 - 稀 星==寒 耿 稀 星 照 碧 霄	月 楼 吹 角 夜 江 遥	五 更 人 起 烟 霜 静	一 曲 残 声 遍 落 潮
夜 深 - 内 颁 - 题 诗 - 玉 门 - 夜 深==夜 深 刀 尺 烛 花 殷	九 月 边 衣 诏 内 颁	不 合 题 诗 落 寒 絮	宫 愁 传 遍 玉 门 关
城 郭 - 千 门 - 来 风 - 渔 父 - 城 郭==昨 日 卖 鱼 到 城 郭	暑 气 千 门 正 炮 烙	买 酒 归 来 风 露 凉	始 信 人 间 渔 父 乐
迢 迢 - 暖 烟 - 美 人 - 月 华 - 风 轻==光 风 轻 泛 绿 迢 迢	气 暖 烟 和 未 尽 销	想 得 美 人 帘 底 坐	月 华 斜 漾 翠 裙 腰
蔷 薇 - 蔷 薇 - 龙 头 - 莺 归 - 蔷 薇==还 家 消 息 约 蔷 薇	眼 看 蔷 薇 日 日 稀	不 踏 龙 头 游 碧 落	君 恩 许 伴 晚 莺 归
夭 桃 - 玉 盘 - 扬 州 - 不 如 - 夭 桃==稼 李 夭 桃 扫 地 无	眼 明 惊 见 玉 盘 盂	扬 州 省 识 春 风 面	看 尽 群 花 总 不 如
羯 鼓 - 春 回 - 蔷 薇 - 千 官 - 春 色==春 色 何 须 羯 鼓 催	君 王 元 日 领 春 回	牡 丹 芍 药 蔷 薇 朵	都 向 千 官 帽 上 开
夜 诵 - 江 月 - 朝 宗 - 风 帆 - 夜 诵==夜 诵 都 忘 浪 枕 喧	尔 家 江 月 旧 楼 存	新 来 转 使 朝 宗 近	目 送 风 帆 到 海 门
金 盘 - 九 节 - 四 海 - 朱 书 - 金 盘==金 盘 碧 粽 裹 雕 菰	九 节 菖 蒲 渍 玉 壶	拓 地 直 临 四 海 岸	朱 书 无 用 辟 兵 符
鼍 梁 - 兹 地 - 三 岛 - 长 生 - 跨 海==鼍 梁 跨 海 溯 秦 营	兹 地 曾 经 望 窈 冥	祇 为 蓬 壶 三 岛 近	至 今 有 果 号 长 生
秋 光 - 安 排 - 未 为 - 长 江 - 独 立==只 须 独 立 领 秋 光	何 用 安 排 石 鼓 双	平 揖 青 原 未 为 差	更 於 竹 外 见 长 江
半 篙 - 芭 蕉 - 行 乐 - 松 竹 - 半 篙==卧 听 争 雨 半 篙 深	晓 展 芭 蕉 数 尺 心	携 手 方 山 行 乐 处	满 林 松 竹 翠 阴 阴
佛 灯 - 层 层 - 得 意 - 归 来 - 佛 灯==谷 朗 岩 开 见 佛 灯	云 遮 雾 掩 碧 层 层	青 山 得 意 看 流 水	白 鹿 归 来 失 旧 僧
夹 路 - 君 从 - 铜 瓶 - 窥 寻 - 夹 路==夹 路 长 松 绿 荫 繁	送 君 从 此 入 幽 关	铜 瓶 锡 仗 无 拘 系	正 好 窥 寻 瀑 水 源
缤 纷 - 佩 玉 - 三 白 - 微 和 - 庆 云==缤 纷 剪 彩 庆 云 低	佩 玉 摇 金 冷 不 知	禁 殿 想 趋 三 白 贺	微 和 先 入 万 年 枝
危 峰 - 瀑 声 - 鸟 啼 - 青 青 - 危 峰==千 朵 危 峰 杳 霭 间	石 房 长 带 瀑 声 寒	鸟 啼 花 发 寻 常 事	松 本 青 青 雪 里 看
青 枝 - 苦 寒 - 娟 娟 - 江 边 - 青 枝==玉 琢 青 枝 蕊 缀 金	仙 肌 不 怕 苦 寒 侵	淮 阳 城 里 娟 娟 月	樊 口 江 边 耿 耿 参
弄 影 - 浪 翻 - 无 人 - 晓 风 - 弄 影==小 白 山 头 花 弄 影	潮 音 洞 口 浪 翻 空	圆 通 门 启 无 人 入	闲 把 轮 珠 立 晓 风
寒 灯 - 明 月 - 要 知 - 烈 焰 - 寒 灯==幽 室 寒 灯 不 假 挑	虚 空 明 月 彻 云 霄	要 知 日 用 常 无 间	烈 焰 光 中 发 异 苗
谁 家 - 哀 怨 - 吟 秋 - 无 人 - 谁 家==楼 下 谁 家 烧 夜 香	玉 笙 哀 怨 弄 初 凉	临 风 有 客 吟 秋 扇	拜 月 无 人 见 晚 妆
蒲 团 - 放 眼 - 白 云 - 出 山 - 竹 几==蒲 团 竹 几 妙 高 台	瞑 坐 何 能 放 眼 开	门 外 白 云 多 事 在	又 将 飞 雨 出 山 来
浩 荡 - 钓 矶 - 岸 帻 - 憔 悴 - 浩 荡==洄 渊 浩 荡 白 鸥 飞	老 懒 时 来 坐 钓 矶	岸 帻 行 人 聊 自 适	不 应 憔 悴 似 湘 缧
疏 篱 - 春 风 - 无 人 - 清 明 - 疏 篱==低 著 疏 篱 宽 著 天	春 风 不 撼 楚 江 船	无 人 为 挂 屋 头 眼	明 日 清 明 花 可 怜
杨 柳 - 酒 旗 - 杨 柳 - 还 是 - 杨 柳==长 淮 渡 头 杨 柳 春	长 淮 市 上 酒 旗 新	系 船 沽 酒 折 杨 柳	还 是 去 年 西 渡 人
有 后 - 出 山 - 白 云 - 殷 勤 - 有 后==闻 说 周 仙 有 后 身	出 山 不 为 两 朱 轮	白 云 丹 灶 俱 无 恙	凭 汝 殷 勤 谢 主 人
山 腰 - 雪 浪 - 风 雨 - 万 里 - 山 腰==兰 城 锁 钥 扼 山 腰	雪 浪 飞 腾 响 怒 潮	日 夕 忽 疑 风 雨 至	方 知 万 里 水 来 朝
万 里 - 百 年 - 骑 马 - 登 山 - 归 来==万 里 归 来 兄 弟 乐	百 年 多 病 井 庐 思	如 何 骑 马 穿 靴 地	只 梦 登 山 着 屐 时
寻 芳 - 年 曾 - 狼 藉 - 绿 叶 - 寻 芳==自 恨 寻 芳 到 已 迟	往 年 曾 见 未 开 时	如 今 风 摆 花 狼 藉	绿 叶 成 阴 子 满 枝
年 年 - 精 神 - 一 枝 - 逋 仙 - 造 化==费 尽 年 年 造 化 功	精 神 全 在 雪 霜 中	一 枝 映 带 窗 前 月	消 得 逋 仙 作 主 翁
黄 鹤 - 江 水 - 杨 柳 - 白 云 - 春 风==黄 鹤 春 风 二 千 里	山 人 佳 期 碧 江 水	携 琴 一 醉 杨 柳 堤	日 暮 龙 沙 白 云 起
惨 淡 - 漫 漫 - 盈 尺 - 闭 户 - 江 天==江 天 惨 淡 物 华 新	四 望 漫 漫 起 玉 尘	但 怪 长 衢 已 盈 尺	岂 知 闭 户 有 高 人
弄 影 - 秋 风 - 红 尘 - 坐 冬 - 婆 娑==黄 花 弄 影 日 婆 娑	一 夜 秋 风 百 感 多	门 外 红 尘 深 几 许	老 夫 今 日 坐 冬 窝
白 华 - 天 涯 - 断 肠 - 日 落 - 白 华==浴 苑 中 间 杨 白 华	随 风 飘 泊 向 天 涯	悲 歌 未 断 肠 先 断	日 落 长 秋 起 暮 鸦
短 艇 - 满 溪 - 远 岸 - 篱 落 - 短 艇==短 艇 冲 寒 泛 浅 沙	满 溪 明 月 浸 芦 花	忽 惊 远 岸 灯 光 发	篱 落 肃 疏 一 两 家
一 点 - 三 更 - 茅 舍 - 乘 风 - 一 点==一 点 射 窗 明 已 足	三 更 当 户 意 慵 看	竹 篱 茅 舍 心 安 处	不 羡 乘 风 到 广 寒
芙 蓉 - 杨 柳 - 庭 前 - 胭 脂 - 芙 蓉==芙 蓉 月 向 怀 中 照	杨 柳 风 来 面 上 吹	夜 半 庭 前 柘 枝 舞	天 明 罗 袖 湿 胭 脂
瘦 骨 - 吹 笙 - 坐 风 - 长 啸 - 瘦 骨==绿 发 方 瞳 瘦 骨 轻	飘 然 乘 鹤 去 吹 笙	郡 斋 独 坐 风 生 竹	疑 是 疑 登 长 啸 声
花 落 - 水 边 - 零 落 - 心 事 - 花 落==乌 啼 花 落 自 年 年	古 寺 依 然 野 水 边	惆 怅 旧 游 零 落 尽	几 多 心 事 不 如 前
野 色 - 篱 边 - 无 人 - 鬓 霜 - 野 色==野 色 芬 敷 洗 露 香	篱 边 不 减 御 衣 黄	繁 英 自 翦 无 人 插	应 笑 铁 潜 两 鬓 霜
江 南 - 风 雨 - 湘 江 - 画 竹 - 江 南==春 尽 江 南 归 已 迟	湘 南 风 雨 度 花 时	无 因 剪 取 湘 江 色	携 看 江 屏 画 竹 枝
幽 岩 - 近 一 - 不 容 - 山 灵 - 幽 岩==说 着 幽 岩 意 已 清	那 堪 地 近 一 牛 鸣	尘 萦 俗 累 不 容 到	若 见 山 灵 烦 寄 声
寺 钟 - 感 慨 - 垂 金 - 檐 花 - 寺 钟==寺 钟 城 鼓 两 相 知	共 醉 烟 关 感 慨 多	堤 柳 垂 金 春 几 许	檐 花 鸣 玉 夜 如 何
客 怀 - 春 归 - 来 往 - 报 国 - 客 怀==久 客 怀 人 百 事 慵	春 归 几 日 是 残 冬	长 安 雪 后 无 来 往	报 国 门 前 独 看 松
四 围 - 春 光 - 微 风 - 烂 熳 - 四 围==行 尽 孤 山 碧 四 围	春 光 和 暖 恰 相 宜	微 风 彼 拂 香 来 去	正 是 群 芳 烂 熳 时
重 阳 - 黄 花 - 乌 纱 - 同 舟 - 重 阳==巴 得 重 阳 未 到 家	短 篷 根 底 忆 黄 花	乌 纱 不 为 西 风 舞	空 与 同 舟 说 孟 嘉
花 萼 - 柳 絮 - 金 钱 - 倚 栏 - 花 萼==花 萼 楼 前 春 正 浓	濛 濛 柳 絮 舞 晴 空	金 钱 掷 罢 娇 无 力	笑 倚 栏 干 屈 曲 中
尘 襟 - 千 古 - 清 风 - 清 风 - 快 哉==吹 尽 尘 襟 亦 快 哉	心 期 千 古 一 时 开	清 风 满 峡 谁 收 拾	即 此 清 风 播 后 来
鸭 头 - 桃 花 - 青 帘 - 春 风 - 鸭 头==一 篙 湖 水 鸭 头 绿	千 树 桃 花 人 面 红	茆 舍 青 帘 起 余 意	聊 将 醉 舞 答 春 风
春 柳 - 闭 户 - 寒 食 - 风 雨 - 春 柳==街 头 春 柳 弄 疏 柔	闭 户 何 曾 一 醉 谋	只 道 将 家 对 寒 食	三 千 风 雨 隔 松 楸
重 裘 - 寒 食 - 花 开 - 栽 花 - 重 裘==叠 帐 重 裘 更 怯 风	绝 怜 寒 食 到 匆 匆	一 春 不 见 花 开 落	但 说 栽 花 费 几 工
送 别 - 天 池 - 龙 尾 - 梢 头 - 车 马==送 别 西 亭 车 马 尘	天 池 回 傍 欲 迷 津	画 船 龙 尾 何 时 发	丹 杏 梢 头 漏 泄 春
多 情 - 渭 阳 - 年 如 - 更 长 - 多 情==多 情 为 我 谢 彭 郎	采 石 江 深 似 渭 阳	相 聚 六 年 如 梦 过	不 如 昨 夜 一 更 长
洛 阳 - 梦 想 - 上 品 - 花 看 - 草 茵==洛 阳 园 里 草 茵 寒	梦 想 尧 夫 一 寸 丹	安 得 根 头 知 上 品	今 人 多 是 就 花 看
分 明 - 指 天 - 成 群 - 脑 门 - 分 明==开 口 分 明 便 垛 根	指 天 指 地 独 称 尊	成 群 作 队 随 他 转	几 个 男 儿 有 脑 门
太 乙 - 春 风 - 绛 节 - 青 鸟 - 太 乙==武 帝 清 斋 太 乙 宫	上 林 无 处 不 春 风	遥 知 绛 节 随 王 母	青 鸟 飞 来 御 苑 中
藏 山 - 朱 栏 - 老 龙 - 云 雨 - 藏 山==不 归 大 海 不 藏 山	碧 瓦 朱 栏 绿 树 闲	应 待 老 龙 才 睡 著	便 偷 云 雨 落 人 间
汗 简 - 觉 尤 - 耆 老 - 大 钱 - 汗 简==祖 烈 班 班 汗 简 编	乡 来 人 物 觉 尤 贤	辕 攀 耆 老 空 遗 恨	不 受 渠 侬 一 大 钱
风 流 - 更 长 - 九 曲 - 必 问 - 风 流==风 流 不 比 贺 家 狂	潇 洒 黄 冠 意 更 长	自 有 武 夷 溪 九 曲	鉴 湖 何 必 问 君 王
禽 语 - 绝 奇 - 独 坐 - 呼 僮 - 禽 语==树 花 禽 语 恰 逢 时	真 意 相 关 两 绝 奇	独 坐 黄 昏 先 得 月	呼 僮 点 笔 和 梅 诗
碧 玉 - 数 声 - 衡 阳 - 潮 来 - 碧 玉==门 对 云 霄 碧 玉 流	数 声 渔 笛 一 江 秋	衡 阳 雁 断 楚 天 阔	几 度 潮 来 问 故 舟
香 烟 - 小 窗 - 书 声 - 停 桡 - 石 屏==留 住 香 烟 鄣 石 屏	小 窗 读 史 与 温 经	书 声 坠 落 空 江 去	舟 子 停 桡 侧 耳 听
山 馆 - 开 门 - 小 车 - 露 湿 - 山 馆==十 年 山 馆 始 围 墙	竹 里 开 门 笋 正 长	但 著 小 车 行 得 过	不 嫌 春 露 湿 衣 裳
时 样 - 宫 殿 - 殷 勤 - 圣 寿 - 风 流==不 作 风 流 时 样 妆	月 明 宫 殿 舞 霓 裳	须 知 并 立 殷 勤 意	为 祝 吾 皇 圣 寿 长
浩 浩 - 乘 风 - 纤 毫 - 万 里 - 长 江==浩 浩 长 江 际 碧 空	片 帆 高 挂 便 乘 风	快 哉 不 费 纤 毫 力	万 里 家 乡 咫 尺 通
团 栾 - 清 秋 - 绝 闻 - 是 南 - 团 栾==团 栾 枣 熟 官 焙 奇	浇 我 清 秋 雁 鹜 池	绝 闻 人 说 宋 城 令	真 是 南 丰 仆 射 儿
黄 鹤 - 大 失 - 长 沙 - 今 古 - 黄 鹤==黄 鹤 楼 前 题 一 篇	无 限 措 大 失 平 仄	长 沙 一 只 眼 长 长	今 古 何 曾 有 踪 迹
谈 天 - 安 排 - 无 语 - 断 崖 - 谈 天==言 中 谈 天 有 振 斋	五 行 曾 不 涉 安 排	小 轩 对 坐 似 无 语	几 度 晴 云 过 断 崖
清 簟 - 咏 诗 - 春 风 - 残 花 - 疏 帘==清 簟 疏 帘 一 醉 身	寂 寥 不 称 咏 诗 人	春 风 亦 有 怜 才 意	故 摆 残 花 作 绣 茵
杨 花 - 闻 道 - 明 月 - 随 风 - 花 落==杨 花 落 尽 子 规 啼	闻 道 龙 标 过 五 溪	我 寄 愁 心 与 明 月	随 风 直 到 夜 郎 西
田 田 - 绿 叶 - 湖 上 - 春 光 - 田 田==几 个 田 田 漾 细 风	乍 看 绿 叶 想 花 红	昆 明 湖 上 浮 轻 舫	六 月 春 光 讶 许 同
石 榴 - 山 花 - 斜 日 - 碧 油 - 石 榴==石 榴 未 拆 梅 犹 小	爱 此 山 花 四 五 株	斜 日 庭 前 风 袅 袅	碧 油 千 片 漏 红 珠
神 灵 - 祥 光 - 归 去 - 九 霄 - 神 灵==夫 人 天 赋 与 神 灵	初 度 祥 光 烛 户 庭	归 去 足 知 躔 次 在	九 霄 还 要 老 人 星
葵 扇 - 竹 床 - 感 须 - 汲 井 - 葵 扇==葵 扇 频 挥 手 已 麻	竹 床 偏 热 冷 无 些	面 凉 却 感 须 根 汗	省 得 开 门 汲 井 花
对 白 - 犹 有 - 来 报 - 巡 檐 - 对 白==蚤 作 抽 书 对 白 间	瓦 炉 犹 有 宿 香 残	诗 来 报 我 群 花 尽	亟 起 巡 檐 忘 帽 寒
连 蜷 - 照 书 - 瑞 应 - 宗 工 - 连 蜷==连 蜷 雌 霓 堕 晴 空	光 照 书 楼 卷 纸 红	天 为 斯 文 开 瑞 应	海 南 海 北 一 宗 工
飞 崖 - 清 风 - 一 日 - 藏 形 - 千 丈==千 丈 飞 崖 倚 半 空	火 云 时 节 此 清 风	身 闲 一 日 俱 仙 思	何 用 藏 形 古 木 中
轻 风 - 倚 杖 - 人 迹 - 绿 阴 - 轻 风==嫩 日 轻 风 夏 未 深	曲 廊 倚 杖 得 闲 吟	地 偏 草 茂 无 人 迹	一 对 茭 鸡 下 绿 阴
暮 云 - 乔 木 - 去 路 - 画 船 - 暮 云==层 峦 稍 稍 暮 云 归	乔 木 森 森 众 鸟 依	再 踏 石 花 寻 去 路	画 船 十 只 带 斜 晖
泉 声 - 如 霜 - 忧 不 - 白 发 - 琴 声==琴 声 意 似 泉 声 淡	剑 气 威 如 霜 气 雄	世 事 关 心 忧 不 寐	萧 萧 白 发 月 明 中
冰 花 - 湘 波 - 一 枝 - 晓 来 - 冰 花==炎 州 分 得 冰 花 脑	来 伴 湘 波 六 月 凉	醉 折 一 枝 簪 鬓 睡	晓 来 印 却 枕 痕 香
碧 树 - 惊 飞 - 蜂 蝶 - 花 房 - 碧 树==才 转 歌 喉 碧 树 枝	惊 飞 还 避 巧 丸 儿	可 怜 蜂 蝶 无 言 语	入 遍 花 房 人 未 知
山 色 - 管 弦 - 春 满 - 好 花 - 图 画==云 昏 山 色 收 图 画	雨 过 泉 声 杂 管 弦	马 上 得 晴 春 满 眼	好 花 迎 客 亦 嫣 然
一 家 - 药 峤 - 只 为 - 纷 纷 - 一 家==庞 公 幸 是 一 家 人	药 峤 何 须 礼 过 勤	只 为 礼 繁 偏 致 乱	那 堪 雪 也 落 纷 纷
烟 冷 - 江 流 - 片 云 - 夜 半 - 烟 冷==烟 冷 隋 宫 草 木 秋	屏 山 分 翠 接 江 流	片 云 不 隔 长 芦 寺	夜 半 钟 声 敲 客 愁
骨 相 - 花 日 - 风 月 - 将 诗 - 骨 相==帽 破 衣 宽 骨 相 寒	为 花 日 日 醉 吟 鞍	时 人 祗 道 题 风 月	后 世 将 诗 作 史 看
井 梧 - 随 风 - 五 声 - 梦 回 - 井 梧==井 梧 和 雨 下 银 床	梁 燕 随 风 别 画 堂	二 十 五 声 秋 漏 永	梦 回 各 自 耐 思 量
诗 思 - 看 经 - 秋 晴 - 浓 时 - 诗 思==上 人 梦 里 营 诗 思	比 似 看 经 僧 更 忙	包 山 寺 里 秋 晴 后	霜 未 浓 时 橘 正 香
一 片 - 春 风 - 北 去 - 江 南 - 一 片==残 梅 一 片 过 晴 檐	忽 感 春 风 三 十 三	旧 雁 自 归 江 北 去	莺 花 只 是 恋 江 南
古 木 - 书 空 - 浅 深 - 无 人 - 江 亭==古 木 江 亭 懒 不 开	书 空 自 笑 兴 悠 哉	苍 台 一 径 浅 深 遍	知 道 无 人 向 此 来
风 摇 - 黄 叶 - 佳 节 - 沾 衣 - 西 风==西 风 摇 落 雁 南 飞	黄 叶 深 深 拥 竹 扉	佳 节 只 消 拚 酩 酊	牛 山 何 事 泪 沾 衣
三 英 - 香 尘 - 江 头 - 门 前 - 三 英==四 照 三 英 蕊 蕊 新	绿 丝 郤 底 动 香 尘	镇 日 江 头 看 不 足	门 前 又 唤 卖 花 人
山 花 - 清 露 - 水 禽 - 沧 洲 - 出 山==出 山 便 与 山 花 别	清 露 丛 边 不 得 留	去 伴 水 禽 船 上 宿	石 溪 斜 月 下 沧 洲
翠 微 - 鱼 矶 - 流 莺 - 梅 花 - 翠 微==日 日 岚 阴 守 翠 微	清 溪 平 没 钓 鱼 矶	流 莺 一 任 无 来 意	直 恐 梅 花 半 树 稀
绿 窗 - 孤 云 - 碧 玉 - 峰 峦 - 窗 棂==小 楼 挂 上 绿 窗 棂	落 日 孤 云 万 态 生	碧 玉 峰 峦 白 银 绿	峰 峦 暗 处 绿 偏 明
餐 霞 - 石 坛 - 汉 家 - 白 云 - 餐 霞==吸 餐 餐 霞 绝 世 氛	石 坛 亲 见 武 夷 君	汉 家 天 子 多 烟 火	却 把 干 鱼 污 白 云
春 风 - 红 红 - 垂 杨 - 袅 袅 - 春 风==春 风 十 九 归 桃 李	白 白 红 红 得 最 多	未 抵 垂 杨 春 最 惜	娇 娇 袅 袅 奈 渠 何
杨 柳 - 细 雨 - 重 九 - 无 穷 - 杨 柳==绕 堤 杨 柳 轻 风 里	隔 水 楼 台 细 雨 中	酒 放 半 醺 重 九 后	此 时 情 味 更 无 穷
山 川 - 龙 蛇 - 太 白 - 生 花 - 一 家==风 月 山 川 共 一 家	谁 来 语 下 定 龙 蛇	太 白 不 曾 登 便 殿	笔 头 昨 夜 自 生 花
把 酒 - 花 枝 - 白 头 - 白 头 - 把 酒==花 前 把 酒 花 前 醉	醉 把 花 枝 仍 自 歌	花 见 白 头 人 莫 笑	白 头 人 见 好 花 多
得 月 - 梅 花 - 萧 疏 - 踏 月 - 梅 花==梅 花 得 月 太 清 生	月 得 梅 花 越 样 明	梅 月 萧 疏 两 奇 绝	有 人 踏 月 绕 花 行
孝 行 - 从 来 - 三 千 - 更 长 - 孝 行==孝 行 阴 功 未 易 量	从 来 家 住 玉 田 坊	人 间 柳 复 三 千 岁	海 上 他 时 日 更 长
桑 柘 - 寂 静 - 柴 门 - 低 声 - 桑 柘==村 巷 深 深 桑 柘 烟	园 林 寂 静 落 花 天	柴 门 有 客 忙 相 揖	摇 手 低 声 蚕 大 眠
碧 水 - 苍 苍 - 秋 色 - 白 云 - 碧 水==山 浮 寒 碧 水 浮 花	石 壁 苍 苍 竹 树 斜	爱 尔 玉 京 秋 色 好	白 云 头 上 看 人 家
世 味 - 到 头 - 和 羹 - 鼎 鼐 - 世 味==世 味 明 知 可 口 难	到 头 终 不 换 寒 酸	直 须 袖 却 和 羹 手	何 必 贪 居 鼎 鼐 间
维 摩 - 昼 眠 - 时 忙 - 烹 茶 - 维 摩==维 摩 病 士 意 超 然	边 腹 便 便 但 昼 眠	共 说 平 时 忙 底 事	烹 茶 煮 药 过 残 年
水 国 - 山 色 - 今 夕 - 关 塞 - 水 国==水 国 蒹 葭 夜 有 霜	月 寒 山 色 共 苍 苍	谁 言 千 里 自 今 夕	离 梦 杳 如 关 塞 长
崔 嵬 - 一 笑 - 谪 仙 - 归 来 - 崔 嵬==偶 寻 流 水 上 崔 嵬	五 老 苍 颜 一 笑 开	若 见 谪 仙 烦 寄 语	匡 山 头 白 早 归 来
修 文 - 旗 亭 - 有 短 - 泪 痕 - 修 文==修 文 巷 裹 莫 春 前	欲 上 旗 亭 问 客 船	忽 有 短 笺 无 寄 处	渔 梁 却 在 泪 痕 边
羊 裘 - 一 枝 - 春 耕 - 别 墅 - 羊 裘==便 著 羊 裘 也 也 难	山 林 未 有 一 枝 安	富 春 耕 种 桐 江 钓	却 羡 先 生 别 墅 宽
萧 萧 - 岁 月 - 别 时 - 暮 烟 - 萧 萧==长 洲 苑 外 草 萧 萧	却 算 游 城 岁 月 遥	唯 有 别 时 今 不 忘	暮 烟 疏 雨 过 枫 桥
冷 蕊 - 山 林 - 画 角 - 花 片 - 疏 枝==疏 枝 冷 蕊 本 清 幽	不 傍 山 林 傍 碧 流	莫 遣 城 头 吹 画 角	恐 惊 花 片 动 情 愁
夜 雨 - 伤 离 - 杜 鹃 - 啼 猿 - 夜 雨==零 零 夜 雨 渍 愁 根	触 物 伤 离 好 断 魂	莫 怪 杜 鹃 飞 去 尽	紫 微 花 里 有 啼 猿
竹 风 - 轻 明 - 骚 人 - 红 尘 - 倚 竹==倚 竹 风 神 不 胜 情	裁 云 刻 月 斗 轻 明	澄 鲜 只 合 骚 人 惜	懒 对 红 尘 肉 眼 横
山 居 - 柴 门 - 春 昼 - 落 花 - 山 居==山 居 无 事 到 襟 怀	日 午 柴 门 尚 未 开	啼 鸟 一 声 春 昼 寂	隔 墙 风 送 落 花 来
归 来 - 一 封 - 洞 府 - 是 宾 - 归 来==天 上 归 来 睡 九 春	一 封 黄 牒 拜 除 新	赤 城 洞 府 今 为 主	抚 掌 群 仙 总 是 宾
昆 阳 - 饮 酒 - 相 思 - 风 吹 - 美 人==昆 阳 市 上 美 人 家	饮 酒 曾 停 过 客 车	万 里 相 思 不 相 见	东 风 吹 尽 蜜 檀 花
天 马 - 四 方 - 回 翔 - 六 甲 - 天 马==天 马 斜 飞 度 三 止	上 将 横 行 击 四 方	辎 车 直 入 无 回 翔	六 甲 次 第 不 乖 行
经 春 - 长 条 - 绿 阴 - 一 枝 - 经 春==双 杨 初 种 几 经 春	始 见 长 条 已 拂 尘	万 缕 绿 阴 堪 作 帐	一 枝 不 许 赠 行 人
今 古 - 无 心 - 归 山 - 春 风 - 今 古==今 古 无 门 闭 是 非	无 心 出 岫 已 知 机	于 今 收 拾 归 山 谷	不 逐 春 风 上 下 飞
池 边 - 苔 花 - 人 事 - 白 鱼 - 池 边==池 边 石 是 南 朝 石	绿 梁 苔 花 亦 可 怜	今 日 波 平 人 事 变	白 鱼 犹 自 跃 天 泉
奸 谋 - 盛 衰 - 万 古 - 临 死 - 袭 父==奸 谋 远 袭 父 兄 基	一 醉 荒 淫 自 盛 衰	万 古 网 常 俱 扫 地	独 于 临 死 未 忘 儿
烟 波 - 酒 醒 - 生 会 - 芦 花 - 烟 波==烟 波 深 处 卧 孤 篷	宿 酒 醒 时 闻 断 鸿	最 是 平 生 会 心 事	芦 花 千 顷 月 明 中
水 晶 - 来 夜 - 独 立 - 无 云 - 水 晶==素 娥 懒 驾 水 晶 轮	此 夕 飞 来 夜 欲 分	送 客 出 门 还 独 立	一 天 清 露 湛 无 云
黄 菊 - 晴 日 - 闲 倚 - 新 诗 - 黄 菊==旋 移 黄 菊 不 嫌 迟	晴 日 霜 庭 晚 更 宜	闲 倚 石 阑 衫 袖 薄	偶 然 愁 思 入 新 诗
柳 外 - 惠 风 - 终 朝 - 得 邻 - 柳 外==柳 外 飞 飞 峡 蝶 儿	惠 风 心 性 彩 云 姿	终 朝 守 定 墙 头 舞	不 得 邻 家 一 句 诗
山 青 - 冲 烟 - 一 幅 - 归 鸟 - 山 青==紫 山 青 嶂 尽 如 家	负 日 冲 烟 复 带 霞	今 古 乾 坤 秋 一 幅	几 番 归 鸟 与 栖 鸦
悠 悠 - 残 红 - 挥 泪 - 沧 洲 - 悠 悠==楚 天 如 梦 水 悠 悠	花 底 残 红 漫 不 收	独 绕 去 年 挥 泪 处	还 将 牢 落 对 沧 洲
高 明 - 事 轻 - 公 子 - 只 图 - 高 明==也 知 无 鬼 瞰 高 明	纸 阁 中 间 万 事 轻	不 愿 人 呼 贵 公 子	只 图 身 作 富 书 生
不 让 - 断 弦 - 好 手 - 剪 花 - 樊 川==舒 王 不 让 杜 樊 川	二 十 八 字 今 断 弦	可 怪 苏 郎 呈 好 手	剪 花 排 锦 蒋 山 前
别 离 - 芝 田 - 东 湖 - 庐 山 - 别 离==欲 作 别 离 西 入 秦	芝 田 枣 径 往 来 频	东 湖 此 夕 更 留 醉	逢 著 庐 山 学 道 人
湖 海 - 载 吟 - 来 往 - 一 雁 - 湖 海==湖 海 归 来 世 念 轻	短 篷 终 日 载 吟 声	天 风 约 住 云 来 往	万 里 长 空 一 雁 横
日 寒 - 一 年 - 柴 门 - 花 上 - 日 寒==今 日 还 留 昨 日 寒	一 年 春 又 客 中 拚	太 湖 石 畔 柴 门 影	鱼 咂 飞 花 上 钓 滩
寂 寂 - 带 雨 - 白 头 - 白 头 - 寂 寂==闲 门 寂 寂 掩 芳 春	坐 看 梨 花 带 雨 新	鸟 自 白 头 浑 不 觉	可 堪 啼 向 白 头 人
如 水 - 酒 杯 - 西 风 - 清 商 - 如 水==甲 光 如 水 戟 如 霜	御 酒 杯 浮 菊 半 黄	东 日 西 风 满 天 仗	箫 韶 一 部 奏 清 商
乔 木 - 门 前 - 白 头 - 年 年 - 乔 木==马 家 宅 畔 无 乔 木	徐 氏 门 前 芳 草 多	留 得 白 头 渔 父 在	年 年 长 笛 送 沧 波
江 乡 - 连 天 - 万 里 - 登 楼 - 江 乡==沧 波 极 目 江 乡 恨	衰 草 连 天 塞 路 愁	三 十 年 间 行 万 里	不 论 南 北 怯 登 楼
叠 叠 - 流 水 - 避 人 - 机 心 - 叠 叠==青 山 叠 叠 绕 珠 林	磬 响 时 兼 流 水 音	虎 不 避 人 人 避 虎	虎 能 先 我 息 机 心
南 来 - 猿 鹤 - 佳 景 - 壶 中 - 两 年==失 脚 南 来 又 两 年	故 山 猿 鹤 只 凄 然	潇 湘 不 是 无 佳 景	终 觉 壶 中 别 有 天
秋 风 - 洞 庭 - 茂 陵 - 新 诗 - 秋 风==西 北 秋 风 凋 蕙 兰	洞 庭 波 上 碧 云 寒	茂 陵 才 子 江 陵 住	乞 取 新 诗 合 掌 看
三 千 - 碧 天 - 得 旧 - 神 仙 - 三 千==葛 玄 功 行 满 三 千	白 日 骖 鸾 上 碧 天	留 得 旧 时 坛 宇 在	后 人 方 信 有 神 仙
绿 萼 - 新 枝 - 赏 心 - 栩 栩 - 红 萼==绿 萼 全 胜 红 萼 好	新 枝 争 亚 旧 枝 长	赏 心 未 减 春 风 蝶	傍 蕊 穿 花 栩 栩 狂
麦 上 - 声 韵 - 安 闲 - 两 忘 - 陆 轴==陆 轴 呕 哑 麦 上 场	讴 歌 声 韵 满 村 坊	茅 斋 病 叟 安 闲 久	帝 力 民 欢 殆 两 忘
四 围 - 相 依 - 鸥 卧 - 孤 鸿 - 四 围==杨 柳 汀 洲 绿 四 围	沙 中 禽 鸟 杂 相 依	烟 留 群 鹭 和 鸥 卧	霞 带 孤 鸿 与 鹜 飞
云 低 - 照 眼 - 冷 落 - 千 里 - 冷 云==东 城 十 时 冷 云 低	照 眼 传 香 总 是 梅	冷 落 京 尘 谁 晤 语	关 河 千 里 独 裴 回
亭 亭 - 映 雪 - 伴 侣 - 见 影 - 亭 亭==亭 亭 背 暖 临 沟 处	脉 脉 含 芳 映 雪 时	莫 恨 夜 来 无 伴 侣	月 明 还 见 影 参 差
叠 叠 - 霏 霏 - 必 便 - 诗 人 - 叠 叠==川 云 叠 叠 密 如 鳞	山 雨 霏 霏 细 似 尘	未 必 便 为 耕 陇 喜	天 公 分 付 与 诗 人
可 爱 - 无 穷 - 拥 衾 - 三 复 - 可 爱==雨 声 可 爱 秋 方 见	睡 味 无 穷 老 始 知	半 醉 拥 衾 支 倦 枕	谁 能 三 复 放 翁 诗
零 落 - 魂 断 - 东 风 - 书 窗 - 榆 钱==榆 钱 零 落 麦 开 芒	魂 断 南 轩 蝶 影 双	多 谢 东 风 相 管 顾	解 将 花 片 入 书 窗
火 云 - 大 泽 - 葵 扇 - 泉 石 - 苍 梧==火 云 如 烧 接 苍 梧	原 野 烟 连 大 泽 枯	谩 费 葛 衫 葵 扇 力	争 禁 泉 石 润 肌 肤
波 澄 - 水 云 - 轻 轻 - 寂 寥 - 波 澄==碧 沼 波 澄 拂 柳 条	坐 来 未 觉 水 云 遥	轻 轻 风 絮 迷 新 涨	一 啭 新 声 破 寂 寥
高 深 - 何 处 - 白 云 - 清 明 - 高 深==上 天 下 地 极 高 深	纪 化 无 踪 何 处 寻	山 静 白 云 归 洞 口	水 清 明 月 落 波 心
宫 柳 - 几 番 - 结 子 - 何 处 - 柳 绿==来 时 宫 柳 绿 初 匀	坐 见 红 芳 几 番 新	蜂 蜜 满 房 花 结 子	还 家 何 处 觅 残 春
山 城 - 秋 思 - 雷 鼓 - 峥 嵘 - 山 城==秋 风 入 角 蹙 山 城	更 觉 淮 南 秋 思 清	惯 听 边 威 雷 鼓 里	梅 花 争 发 斗 峥 嵘
七 年 - 三 尺 - 阅 刺 - 崔 嵬 - 材 成==豫 章 材 成 七 年 后	潢 潦 眼 看 三 尺 缰	山 翁 坐 阅 刺 天 翼	抱 书 亦 耻 崔 嵬 藏
穿 只 - 城 门 - 无 消 - 黄 昏 - 候 卖==眼 穿 只 候 卖 柴 回	今 日 堡 城 门 不 开	籴 米 已 无 消 息 至	黄 昏 惆 怅 下 山 来
栖 迟 - 秋 风 - 苍 生 - 识 男 - 栖 迟==韩 信 栖 迟 项 羽 穷	手 提 长 剑 喝 秋 风	吁 嗟 天 下 苍 生 眼	不 识 男 儿 未 济 中
悠 悠 - 梦 中 - 鸡 後 - 一 点 - 悠 悠==白 日 悠 悠 喜 意 平	梦 中 历 历 觉 魂 清	觉 时 不 落 晨 鸡 後	静 待 天 窗 一 点 明
翠 叶 - 胭 脂 - 花 梢 - 可 惜 - 翠 叶==翠 叶 轻 笼 豆 颗 均	胭 脂 浓 抹 蜡 痕 新	殷 勤 留 著 花 梢 露	滴 下 生 红 可 惜 春
峥 嵘 - 寒 窗 - 出 山 - 尘 埃 - 峥 嵘==风 饕 雪 虐 岁 峥 嵘	寸 草 寒 窗 独 宁 馨	长 恐 出 山 泉 水 浊	尘 埃 到 汝 失 青 青
景 致 - 经 书 - 居 处 - 一 家 - 花 木==花 木 四 时 分 景 致	经 书 千 卷 好 生 涯	有 人 若 问 闲 居 处	道 德 坊 中 第 一 家
古 今 - 松 下 - 蟠 桃 - 结 子 - 古 今==古 今 冠 佩 立 朝 人	多 作 北 山 松 下 尘	我 爱 蟠 桃 种 来 久	开 花 结 子 不 由 春
回 雪 - 珠 帘 - 内 殿 - 玉 京 - 风 回==流 风 回 雪 满 蓬 莱	绣 幕 珠 帘 万 户 开	内 殿 平 明 催 设 宴	玉 京 深 处 翠 华 来
幽 花 - 带 露 - 春 色 - 此 学 - 芬 芳==幽 花 竹 下 自 芬 芳	旋 摘 琼 葩 带 露 香	收 拾 风 光 妒 春 色	六 宫 从 此 学 新 妆
清 明 - 楼 台 - 秋 千 - 斗 草 - 清 明==门 巷 清 明 燕 子 来	绿 杨 如 雾 掩 楼 台	同 随 女 伴 秋 千 下	更 向 花 间 斗 草 回
乡 梦 - 异 乡 - 青 青 - 长 条 - 乡 梦==远 别 悠 悠 乡 梦 频	逢 君 况 是 异 乡 春	可 怜 河 畔 青 青 柳	又 折 长 条 别 故 人
云 影 - 杨 柳 - 林 人 - 莺 啼 - 云 影==流 云 影 乱 欲 凝 空	杨 柳 丝 柔 不 曳 风	调 入 春 林 人 不 见	乳 莺 啼 出 万 花 中
山 川 - 夜 吟 - 客 路 - 西 风 - 山 川==山 川 马 上 度 边 禽	一 宿 都 门 永 夜 吟	客 路 不 归 秋 又 晚	西 风 吹 动 洛 阳 砧
江 南 - 杜 鹃 - 洞 庭 - 双 珠 - 白 苹==欲 向 江 南 采 白 苹	杜 鹃 啼 后 已 无 春	洞 庭 龙 女 云 中 降	手 把 双 珠 笑 赠 人
寒 梅 - 桃 李 - 阳 和 - 百 花 - 寒 梅==寒 梅 冲 雪 领 春 回	桃 李 纷 纷 趁 脚 来	一 点 阳 和 无 尽 处	从 头 分 与 百 花 开
月 华 - 夜 阑 - 扬 州 - 人 庙 - 一 树==一 树 婆 娑 种 月 华	夜 阑 依 旧 护 风 沙	今 年 不 往 扬 州 过	曾 看 夫 人 庙 里 花
三 杯 - 梅 花 - 白 云 - 处 飞 - 三 杯==别 酒 三 杯 醉 不 知	梅 花 岭 外 故 人 稀	片 心 暗 逐 白 云 去	日 日 向 君 行 处 飞
脉 脉 - 萧 萧 - 摇 落 - 东 西 - 脉 脉==斜 规 脉 脉 霞 底 去	早 凉 萧 萧 林 际 归	年 华 摇 落 适 谁 怨	伯 劳 燕 子 东 西 飞
故 人 - 十 年 - 风 雨 - 刚 道 - 故 人==我 与 兹 山 是 故 人	十 年 相 别 意 弥 真	如 何 咫 尺 迷 风 雨	刚 道 情 亲 却 不 亲
虚 空 - 混 沌 - 辛 勤 - 团 圆 - 虚 空==大 虚 空 重 片 光 悬	何 异 初 开 混 沌 天	能 办 辛 勤 磨 玉 斧	不 愁 缺 月 不 团 圆
千 林 - 风 骨 - 教 群 - 一 幅 - 千 林==独 立 千 林 压 众 葩	正 由 风 骨 傲 烟 霞	谁 教 群 玉 峰 头 客	也 染 红 裙 一 幅 纱
盛 时 - 题 诗 - 好 景 - 荷 枯 - 六 月==六 月 芙 蕖 正 盛 时	画 船 长 记 醉 题 诗	世 间 好 景 元 无 尽	霜 落 荷 枯 又 一 奇
习 习 - 冰 开 - 三 阳 - 柏 叶 - 习 习==青 辂 迎 春 习 习 来	天 泉 池 上 晓 冰 开	珠 幡 已 报 三 阳 候	柏 叶 将 陈 万 寿 杯
清 明 - 春 城 - 楼 台 - 江 南 - 清 明==寒 食 清 明 人 意 闲	春 城 士 女 出 班 班	柳 黄 花 白 楼 台 外	紫 翠 江 南 数 叠 山
故 人 - 水 国 - 传 书 - 天 山 - 沉 沉==故 人 别 后 杳 沉 沉	独 上 高 楼 水 国 阴	鸿 雁 不 传 书 底 恨	天 山 流 落 到 如 今
闲 游 - 往 事 - 时 思 - 阑 干 - 闲 游==饱 饭 闲 游 绕 小 溪	却 将 往 事 细 寻 思	有 时 思 到 难 思 处	拍 碎 阑 干 人 不 知
薄 命 - 蛾 眉 - 万 里 - 凄 其 - 薄 命==正 成 薄 命 久 寻 思	宛 转 蛾 眉 能 几 时	汉 水 楚 云 千 万 里	留 君 不 住 益 凄 其
水 禽 - 衔 花 - 长 沙 - 斜 阳 - 水 禽==水 禽 踏 浪 飞 还 走	涧 草 衔 花 腊 已 春	潮 近 长 沙 卑 湿 地	斜 阳 万 里 起 层 阴
令 节 - 老 病 - 榆 火 - 新 烟 - 令 节==少 年 令 节 醉 花 前	老 病 花 前 服 药 眠	自 检 铜 人 试 榆 火	午 窗 烧 艾 起 新 烟
劲 气 - 年 年 - 冰 霜 - 含 章 - 劲 气==劲 气 由 来 不 可 摧	年 年 偏 向 腊 前 开	清 芬 肯 为 冰 霜 减	好 在 含 章 檐 下 栽
江 上 - 今 春 - 伤 心 - 凤 去 - 万 岁==江 上 巍 巍 万 岁 楼	今 春 花 鸟 作 边 愁	伤 心 欲 问 南 朝 事	凤 去 台 空 江 自 流
天 凉 - 饭 前 - 暗 香 - 西 风 - 天 凉==晚 天 凉 意 逗 帘 波	行 饭 前 除 绿 绽 莎	忽 觉 暗 香 侵 袂 下	西 风 吹 散 贝 多 罗
金 波 - 亏 盈 - 清 波 - 枝 上 - 金 波==金 波 涌 出 烂 争 盆	黑 白 亏 盈 湛 不 痕	莫 谓 清 波 无 透 路	珊 瑚 枝 上 影 团 团
杨 柳 - 江 上 - 早 起 - 路 旁 - 杨 柳==江 头 杨 柳 暗 藏 鸦	江 上 鹅 儿 浴 浅 沙	早 起 一 风 如 此 恶	路 旁 落 尽 刺 桐 花
江 山 - 徘 徊 - 尘 埃 - 江 楼 - 面 面==表 里 江 山 面 面 来	秋 风 此 日 偶 徘 徊	尘 埃 阅 心 心 如 鉴	一 到 江 楼 眼 为 开
林 间 - 晚 风 - 灯 焰 - 光 芒 - 苍 苍==林 间 塔 影 郁 苍 苍	向 晚 风 传 供 佛 香	灯 焰 万 龛 时 炯 炯	恍 然 文 笔 吐 光 芒
彭 泽 - 渊 明 - 三 径 - 千 尺 - 彭 泽==此 郡 境 有 彭 泽 县	渊 明 曾 遗 晋 时 踪	三 径 莫 知 在 何 处	且 抚 官 圃 千 尺 松
月 华 - 含 章 - 花 光 - 梅 亦 - 月 华==楼 高 夜 静 月 华 陈	冷 浸 含 章 一 段 春	人 影 花 光 相 上 下	定 知 梅 亦 解 分 身
落 月 - 起 风 - 无 人 - 方 丈 - 落 月==三 四 声 猿 叫 落 月	六 七 竿 竹 呼 起 风	夜 静 无 人 知 此 味	还 他 方 丈 拙 庵 翁
照 人 - 临 轩 - 东 风 - 东 风 - 日 照==菱 花 初 日 照 人 空	妆 罢 临 轩 数 落 红	不 得 东 风 花 不 发	花 飞 犹 自 怨 东 风
归 来 - 孤 云 - 岩 下 - 风 流 - 归 来==淮 甸 归 来 涉 学 深	孤 云 又 出 亦 何 心	公 余 岩 下 读 书 去	远 继 风 流 石 橘 林
烟 云 - 夜 深 - 谪 仙 - 烟 云 - 一 望==隔 岸 烟 云 一 望 间	夜 深 笙 鹤 与 俱 还	不 缘 曾 识 谪 仙 面	未 必 烟 云 住 此 山
烟 梢 - 寂 寥 - 回 暖 - 溪 桥 - 立 马==行 人 立 马 闯 烟 梢	为 底 寒 香 尚 寂 寥	是 则 孤 根 未 回 暖	已 应 春 意 到 溪 桥
昼 长 - 晚 风 - 鱼 戏 - 过 雨 - 昼 长==歌 阕 一 尊 清 昼 长	曲 池 小 景 晚 风 凉	波 微 动 处 见 鱼 戏	荷 半 开 时 过 雨 香
低 低 - 桑 下 - 复 青 - 知 君 - 低 低==低 低 门 前 两 桑 树	忆 君 别 时 桑 下 去	桑 树 生 叶 青 复 青	知 君 颜 色 还 如 故
冥 冥 - 欲 动 - 归 舟 - 鸳 鸯 - 冥 冥==云 海 冥 冥 日 向 西	春 风 欲 动 意 犹 微	无 端 一 棹 归 舟 疾	惊 起 鸳 鸯 相 背 飞
征 尘 - 消 魂 - 诗 人 - 细 雨 - 征 尘==衣 上 征 尘 杂 酒 痕	远 游 无 处 不 消 魂	此 身 合 是 诗 人 未	细 雨 骑 驴 入 剑 门
草 根 - 灯 火 - 夜 半 - 池 冰 - 草 根==草 根 何 处 不 虫 声	灯 火 昏 昏 独 掩 屏	有 约 不 来 过 夜 半	煮 茶 敲 碎 一 池 冰
西 湖 - 龙 蛇 - 断 肠 - 枝 斜 - 西 湖==西 湖 处 士 骨 应 槁	不 复 龙 蛇 看 挥 扫	是 谁 招 此 断 肠 魂	竹 外 一 枝 斜 更 好
清 夜 - 少 时 - 丝 竹 - 曹 解 - 清 夜==清 夜 欢 游 忽 作 阴	少 时 斜 月 复 开 林	倩 教 丝 竹 陶 余 兴	莫 惜 儿 曹 解 此 心
波 翻 - 雉 何 - 步 障 - 半 山 - 长 鲸==长 鲸 须 响 海 波 翻	泽 雉 何 由 肯 畜 樊	步 障 连 空 鞋 一 屋	不 如 萧 散 半 山 园
长 夜 - 宿 鸟 - 野 外 - 肃 肃 - 一 灯==一 灯 长 夜 佛 前 明	庭 树 枝 多 宿 鸟 争	野 外 霜 寒 人 未 起	林 僧 肃 肃 又 经 行
凿 井 - 何 曾 - 斫 轮 - 一 人 - 凿 井==耕 田 凿 井 自 艰 辛	缓 急 何 曾 叩 比 邻	构 屋 斫 轮 还 结 网	百 工 俱 备 一 人 身
无 言 - 虚 空 - 着 处 - 患 青 - 无 言==老 胡 无 圣 亦 无 言	蓦 指 虚 空 唤 作 禅	掌 血 条 痕 无 着 处	教 谁 白 地 患 青 颠
横 行 - 不 觉 - 深 衣 - 看 东 - 横 行==少 年 意 气 慕 横 行	不 觉 蹉 跎 过 一 生	便 脱 深 衣 笼 窄 袖	去 参 留 守 看 东 京
丛 林 - 未 了 - 有 路 - 无 生 - 丛 林==师 走 丛 林 不 计 年	若 为 犹 未 了 因 缘	万 年 有 路 何 妨 去	透 取 无 生 不 二 禅
斜 阳 - 曲 径 - 落 花 - 芳 草 - 斜 阳==乍 晴 幽 步 踏 斜 阳	残 潦 青 苔 曲 径 荒	风 掷 落 花 填 小 堑	雨 催 芳 草 上 空 墙
如 流 - 江 头 - 平 沙 - 吹 箫 - 流 水==忆 君 心 事 如 流 水	流 向 江 头 作 暮 潮	想 得 潮 平 沙 有 雪	白 铿 铁 版 和 吹 箫
些 几 - 一 声 - 两 行 - 太 白 - 回 无==短 些 几 回 无 寄 处	一 声 归 鹤 落 江 东	两 行 老 泪 千 年 恨	问 讯 骑 鲸 太 白 翁
连 云 - 山 河 - 枕 簟 - 去 国 - 连 云==锦 树 连 云 烂 不 收	山 河 风 景 一 番 秋	老 夫 枕 簟 便 凉 夜	不 比 新 亭 去 国 愁
诸 峰 - 插 瑶 - 神 仙 - 可 寻 - 诸 峰==碧 落 诸 峰 是 碧 簪	忽 於 平 地 插 瑶 岑	洞 中 定 有 神 仙 宅	玉 室 金 堂 不 可 寻
叶 疏 - 夕 阳 - 凌 空 - 意 秋 - 疏 林==黄 叶 疏 林 江 上 洲	西 风 角 怨 夕 阳 楼	晚 天 紫 翠 凌 空 阔	只 有 樊 山 取 意 秋
道 装 - 野 鹤 - 丹 砂 - 貂 侍 - 道 装==久 脱 朝 衣 学 道 装	溪 云 野 鹤 作 身 章	何 时 九 转 丹 砂 熟	却 插 金 貂 侍 紫 皇
怒 号 - 寂 寂 - 春 色 - 玄 都 - 东 风==日 惨 东 风 正 怒 号	小 园 寂 寂 闭 蓬 蒿	可 能 春 色 如 人 事	独 发 玄 都 观 里 桃
湖 上 - 一 轩 - 闭 门 - 有 几 - 湖 上==贺 家 湖 上 天 华 寺	一 一 轩 窗 面 水 开	不 是 闭 门 防 俗 客	爱 闲 能 有 几 人 来
沧 浪 - 寒 烟 - 珍 重 - 斜 阳 - 沧 浪==沧 浪 渡 口 莫 愁 乡	万 顷 寒 烟 木 落 霜	珍 重 使 君 留 客 意	一 尊 芳 酒 醉 斜 阳
斑 斑 - 秋 日 - 鸟 语 - 此 时 - 落 叶==秋 林 落 叶 已 斑 斑	秋 日 当 庭 尚 掩 关	扫 榻 昼 眠 听 鸟 语	可 怜 身 世 此 时 闲
钓 舟 - 半 生 - 无 人 - 万 里 - 西 风==好 趁 西 风 理 钓 舟	半 生 书 剑 两 悠 悠	凭 高 有 恨 无 人 识	空 负 关 河 万 里 秋
芳 草 - 春 柳 - 生 事 - 相 怜 - 芳 草==暖 云 芳 草 媚 晴 川	花 正 娇 春 柳 欲 眠	老 景 侵 寻 生 事 拙	旧 巢 归 燕 自 相 怜
销 魂 - 眼 昏 - 声 那 - 一 声 - 销 魂==老 人 不 哭 自 销 魂	况 复 长 号 病 眼 昏	终 日 哭 声 那 可 听	一 声 声 有 一 般 言
落 木 - 酒 帘 - 千 尺 - 霜 叶 - 落 木==送 客 西 楼 落 木 风	鬓 丝 吹 断 酒 帘 空	危 廊 千 尺 云 居 寺	霜 叶 仍 欺 二 月 红
风 光 - 蒙 茸 - 憔 悴 - 万 卉 - 风 光==二 月 风 光 惭 恼 人	蒙 茸 细 雨 湿 花 唇	可 怜 病 目 长 憔 悴	坐 看 纷 纷 万 卉 春
依 依 - 满 树 - 何 处 - 东 风 - 苍 苔==依 依 杨 柳 映 苍 苔	满 树 桃 花 映 日 开	不 知 燕 子 栖 何 处	此 际 东 风 依 旧 回
春 信 - 诗 人 - 探 梅 - 横 枝 - 年 年==年 年 春 信 遣 人 疑	赚 出 诗 人 枉 觅 诗	著 意 探 梅 偏 不 发	月 斜 偶 见 一 横 枝
罗 裙 - 摇 落 - 憔 悴 - 花 边 - 罗 裙==罗 裙 溅 湿 鬓 云 偏	摇 落 香 风 满 画 船	忽 忆 夜 来 憔 悴 梦	怨 央 正 在 藕 花 边
春 水 - 数 声 - 风 雨 - 神 仙 - 春 水==洞 前 春 水 漾 桃 溪	洞 后 数 声 青 鸟 啼	二 十 四 岩 风 雨 夜	神 仙 过 此 话 刀 圭
白 头 - 一 鞭 - 清 兴 - 江 天 - 白 头==底 事 安 仁 易 白 头	一 鞭 行 色 伴 清 鸥	抽 身 簿 领 穷 清 兴	唯 有 江 天 倒 射 眸
白 苹 - 立 鹭 - 明 窗 - 醉 枕 - 苹 洲==白 苹 洲 暖 漾 晴 波	雪 点 沙 汀 立 鹭 多	几 度 月 明 窗 下 见	打 渔 入 醉 枕 轻 蓑
截 断 - 随 流 - 青 山 - 知 来 - 截 断==截 断 从 教 来 衮 衮	随 流 未 必 去 滔 滔	青 山 长 锁 欲 飞 势	沧 海 合 知 来 处 高
马 迹 - 千 花 - 扬 州 - 玉 箫 - 马 迹==马 迹 山 前 大 树 梅	千 花 万 花 如 雪 开	满 载 扬 州 秋 露 白	玉 箫 吹 过 太 湖 来
杨 柳 - 绿 阴 - 柔 条 - 春 深 - 柳 色==湖 边 杨 柳 色 如 金	几 日 不 来 成 绿 阴	折 得 柔 条 入 城 去	教 人 知 道 已 春 深
琼 瑶 - 两 岸 - 踏 青 - 灯 火 - 琼 瑶==溶 溶 春 水 漾 琼 瑶	两 岸 菰 蒲 长 绿 苗	几 度 踏 青 归 去 晚	却 从 灯 火 认 红 桥
石 门 - 乞 真 - 三 许 - 留 诗 - 石 门==上 得 山 来 过 石 门	谒 灵 特 地 乞 真 言	再 三 许 我 前 程 事	敢 不 留 诗 荷 圣 恩
寒 沙 - 舟 子 - 千 丈 - 对 面 - 晚 潮==船 阁 寒 沙 待 晚 潮	行 人 舟 子 各 相 招	银 山 一 朵 三 千 丈	隔 海 飞 来 对 面 销
美 人 - 暮 霞 - 鹦 鹉 - 榴 花 - 美 人==美 人 应 自 惜 年 华	庭 院 沈 沈 锁 暮 霞	只 有 旧 时 鹦 鹉 见	春 衫 曾 似 石 榴 花
剪 彩 - 入 酒 - 醉 魂 - 无 香 - 剪 彩==姮 娥 剪 彩 压 群 芳	一 夜 秋 风 入 酒 囊	薰 彻 醉 魂 清 入 骨	敢 言 天 下 更 无 香
雄 飞 - 星 流 - 南 北 - 千 里 - 雄 飞==侧 翼 雄 飞 天 势 阔	电 闪 星 流 太 轻 脱	南 北 东 西 相 对 看	千 里 万 里 阿 喇 喇
参 天 - 灵 龟 - 到 处 - 井 有 - 参 天==两 地 参 天 命 曰 人	灵 龟 端 合 取 诸 身	笑 渠 到 处 间 寻 觉	直 信 人 言 井 有 仁
清 光 - 急 拍 - 柳 条 - 恨 付 - 清 光==江 梅 冷 艳 酒 清 光	急 拍 繁 弦 醉 画 堂	无 限 柳 条 多 少 雪	一 将 春 恨 付 刘 郎
重 台 - 百 叶 - 山 家 - 东 篱 - 重 台==重 台 谖 草 初 离 土	百 叶 缃 梅 已 满 枝	莫 道 山 家 杀 风 景	也 能 醉 倒 向 东 篱
莺 啼 - 鱼 鳞 - 相 思 - 花 开 - 细 草==陌 上 莺 啼 细 草 薰	鱼 鳞 风 皱 水 成 纹	江 南 红 豆 相 思 苦	岁 岁 花 开 一 忆 君
翠 裙 - 一 曲 - 春 水 - 兰 桡 - 红 烛==翠 裙 红 烛 坐 调 笙	一 曲 娇 歌 万 种 情	二 十 四 桥 春 水 绿	兰 桡 随 处 傍 花 行
秋 月 - 春 水 - 门 前 - 马 嘶 - 别 时==郎 子 别 时 秋 月 明	说 道 归 时 春 水 生	晓 起 门 前 听 过 马	马 嘶 都 是 别 人 行
重 门 - 彤 庭 - 连 宵 - 驾 鹤 - 重 门==交 戟 重 门 间 九 阍	彤 庭 紫 殿 切 星 辰	能 来 此 地 连 宵 直	即 是 骖 鸾 驾 鹤 人
游 鱼 - 任 携 - 总 爱 - 渔 翁 - 游 鱼==游 鱼 惊 饵 总 沉 渊	一 任 携 竿 晚 立 船	今 世 有 钱 人 总 爱	渔 翁 岂 独 不 贪 钱
出 海 - 一 朵 - 云 动 - 蒙 蒙 - 出 海==三 足 鸦 儿 出 海 东	飞 光 一 朵 染 天 红	只 销 半 点 皈 云 动	立 地 蒙 蒙 暗 太 空
阳 索 - 红 衣 - 金 门 - 三 千 - 阳 索==宴 起 昭 阳 索 辇 时	炉 香 偏 上 赭 红 衣	金 门 玉 砌 明 如 书	宫 女 三 千 把 烛 归
十 年 - 鸣 弦 - 今 朝 - 闭 户 - 十 年==生 世 投 闲 四 十 年	瘴 江 班 顶 试 鸣 弦	今 朝 也 是 为 官 日	白 日 青 天 闭 户 眠
爱 日 - 逢 觞 - 春 老 - 搜 诗 - 花 残==花 残 爱 日 惟 愁 尽	病 渴 逢 觞 却 厌 多	不 分 闲 中 觉 春 老	强 搜 诗 句 逐 阴 何
岩 花 - 万 丈 - 云 锦 - 云 锦 - 春 水==岩 花 乱 落 随 春 水	万 丈 轻 红 绕 驿 楼	不 是 江 流 似 云 锦	政 应 云 锦 似 江 流
沧 溟 - 鱼 龙 - 一 笑 - 东 湖 - 沧 溟==倒 拈 折 箸 搅 沧 溟	无 限 鱼 龙 暗 里 惊	一 笑 机 关 轻 捩 转	东 湖 午 夜 月 华 明
把 钓 - 青 条 - 不 定 - 飞 自 - 稚 子==岸 边 稚 子 戏 把 钓	蚯 蚓 作 饵 青 条 长	上 去 下 来 船 不 定	自 飞 自 语 燕 争 忙
台 畔 - 风 雨 - 闲 吟 - 何 处 - 台 畔==姑 苏 台 畔 树 含 秋	蝉 噪 西 风 雨 乍 收	闲 笑 闲 吟 忽 归 去	月 明 何 处 宿 孤 舟
倾 盖 - 寄 书 - 江 上 - 游 鱼 - 倾 盖==与 君 倾 盖 二 毛 初	别 后 无 由 数 寄 书	江 上 逢 人 问 消 息	红 妆 随 马 射 游 鱼
南 涧 - 南 溪 - 殷 勤 - 僧 乞 - 南 涧==南 涧 先 生 归 几 时	南 溪 如 泛 未 传 诗	君 行 为 我 殷 勤 录	并 问 茶 山 僧 乞 碑
空 城 - 百 年 - 公 子 - 底 忙 - 寂 寞==潮 打 空 城 寂 寞 回	百 年 多 病 独 登 台	谁 人 得 似 张 公 子	有 底 忙 时 不 肯 来
白 玉 - 溪 桥 - 近 水 - 未 消 - 寒 梅==一 种 寒 梅 白 玉 条	回 临 村 路 傍 溪 桥	应 缘 近 水 花 先 发	疑 是 经 春 雪 未 消
庭 院 - 美 人 - 白 日 - 金 炉 - 庭 院==庭 院 深 深 深 几 许	美 人 绵 渺 在 云 堂	落 花 游 丝 白 日 静	锦 荐 金 炉 梦 正 长
蝶 飞 - 归 时 - 花 落 - 归 来 - 杏 花==杏 花 枝 头 蛱 蝶 飞	似 郎 游 冶 忘 归 时	杏 花 落 尽 蛱 蝶 去	郎 不 归 来 向 底 嬉
莺 声 - 吟 苦 - 秋 千 - 一 片 - 柳 外==柳 外 莺 声 错 唤 人	小 楼 吟 苦 不 知 春	落 花 飞 过 秋 千 去	一 片 闲 情 客 里 身
一 枝 - 溪 桥 - 春 风 - 毫 端 - 照 人==一 枝 炯 炯 照 人 寒	绝 似 溪 桥 立 马 看	只 恐 春 风 解 相 怨	漏 他 消 息 入 毫 端
龙 山 - 新 诗 - 英 雄 - 千 年 - 戏 马==龙 山 戏 马 赏 秋 光	多 少 新 诗 入 锦 囊	磨 灭 英 雄 岂 胜 数	千 年 依 旧 一 花 香
江 上 - 早 梅 - 幽 香 - 一 樽 - 江 上==新 春 江 上 使 星 回	不 为 离 人 寄 早 梅	爱 惜 幽 香 意 如 此	一 樽 岂 是 等 闲 来
新 凉 - 江 水 - 春 归 - 中 流 - 新 凉==横 塘 风 起 送 新 凉	蒲 叶 拍 波 江 水 长	莫 道 春 归 花 落 尽	中 流 还 有 杜 蘅 香
分 明 - 讲 习 - 寄 书 - 千 里 - 分 明==此 理 分 明 见 中 偏	何 时 讲 习 到 同 然	寄 书 好 与 随 庵 道	千 里 元 来 共 一 天
十 年 - 眼 昏 - 生 旧 - 能 知 - 十 年==六 十 年 来 又 七 年	眼 昏 头 白 意 茫 然	逢 人 欲 说 平 生 旧	少 有 能 知 两 世 前
幽 居 - 花 开 - 高 卧 - 微 香 - 幽 居==长 夏 幽 居 景 不 穷	花 开 芳 砌 翠 成 丛	窗 南 高 卧 追 凉 际	时 有 微 香 逗 晚 风
云 堆 - 红 尘 - 野 人 - 窗 前 - 里 结==乱 云 堆 里 结 茅 庐	已 共 红 尘 迹 渐 疏	莫 问 野 人 生 计 事	窗 前 流 水 枕 前 书
燕 燕 - 莺 歌 - 萱 草 - 春 风 - 燕 燕==燕 燕 于 飞 引 蝶 狂	娇 莺 歌 懒 笑 蜂 忙	庭 前 萱 草 台 前 竹	也 学 春 风 舞 绿 杨
残 花 - 到 处 - 欲 成 - 鹧 鸪 - 残 花==残 花 委 地 笋 掀 泥	香 碗 诗 囊 到 处 携	幽 梦 欲 成 谁 唤 觉	半 窗 斜 日 鹧 鸪 啼
独 坐 - 游 鱼 - 何 处 - 无 弦 - 秋 风==秋 风 独 坐 野 塘 前	水 上 游 鱼 自 有 天	真 意 更 须 何 处 觅	知 音 从 古 在 无 弦
光 寒 - 重 重 - 秋 耿 - 彩 笔 - 光 寒==云 奁 初 展 晓 光 寒	幽 思 重 重 独 舞 莺	自 是 伤 秋 耿 瘦 影	不 惭 彩 笔 实 春 山
丹 灶 - 向 此 - 云 双 - 仙 风 - 石 床==药 盆 丹 灶 石 床 间	龙 虎 当 年 向 此 盘	云 双 久 登 天 穴 路	仙 风 依 旧 拂 衣 寒
花 明 - 秋 水 - 凉 月 - 断 肠 - 西 风==西 风 洲 上 荻 花 明	秋 水 船 头 落 雁 鸣	谁 抱 琵 琶 凉 月 里	为 君 弹 作 断 肠 声
千 里 - 泛 水 - 封 侯 - 郊 原 - 千 里==吾 子 才 如 千 里 驹	肯 同 泛 泛 水 中 凫	乘 时 早 取 封 侯 印	莫 惮 郊 原 骨 已 枯
仙 游 - 孝 子 - 归 来 - 劫 灰 - 仙 游==一 自 仙 游 去 不 回	徒 令 孝 子 有 余 哀	他 年 华 表 归 来 后	知 是 人 间 几 劫 灰
野 水 - 森 森 - 一 番 - 金 色 - 雪 消==雪 消 野 水 半 融 泥	冻 柳 森 森 态 未 齐	昨 夜 一 番 春 雨 好	淡 黄 金 色 满 湖 堤
看 铜 - 双 星 - 世 未 - 一 年 - 铜 仪==问 天 气 巧 看 铜 仪	再 拜 双 星 恨 不 随	尘 世 未 知 天 上 事	隔 河 相 望 一 年 期
池 塘 - 庭 院 - 草 梦 - 煮 茶 - 池 塘==池 塘 渴 雨 蛙 声 少	庭 院 无 人 燕 语 长	午 枕 不 成 春 草 梦	落 花 风 静 煮 茶 香
寒 灯 - 征 雁 - 言 事 - 解 语 - 客 梦==独 对 寒 灯 客 梦 孤	数 声 征 雁 下 平 芜	古 今 多 少 难 言 事	笑 指 梅 花 解 语 无
石 头 - 人 愁 - 风 前 - 西 淮 - 石 头==挝 鼓 民 旗 向 石 头	列 山 山 下 使 人 愁	风 前 独 倚 危 樯 立	遥 认 西 淮 四 五 州
闲 游 - 到 处 - 樵 夫 - 牧 竖 - 闲 游==出 门 信 步 作 闲 游	野 庙 村 坊 到 处 留	每 伴 樵 夫 尝 半 舍	更 随 牧 竖 采 沿 沟
广 寒 - 金 粟 - 分 惠 - 一 枝 - 广 寒==广 寒 世 界 仙 家 种	金 粟 如 来 佛 国 花	多 谢 高 人 分 惠 我	一 枝 和 月 到 山 家
茅 亭 - 花 木 - 西 山 - 云 涛 - 茅 亭==茅 亭 水 溜 四 周 遭	花 木 经 春 一 一 高	却 望 西 山 隔 江 水	经 思 一 叶 泛 云 涛
毒 蛇 - 三 台 - 多 子 - 眼 铜 - 横 古==倒 握 毒 蛇 横 古 路	背 骑 猛 虎 舞 三 台	收 来 放 去 无 多 子	铁 眼 铜 眼 被 活 埋
天 台 - 夜 深 - 游 难 - 泉 声 - 天 台==偶 宿 天 台 白 石 房	夜 深 清 话 月 移 光	宦 游 难 作 重 来 约	一 枕 泉 声 老 不 忘
一 家 - 烟 霞 - 儒 家 - 青 山 - 一 家==仙 佛 人 言 是 一 家	好 分 半 席 共 烟 霞	廓 清 摧 陷 儒 家 事	不 谓 青 山 识 正 邪
怒 涛 - 辇 路 - 秋 风 - 南 楼 - 怒 涛==怒 涛 千 里 破 空 飞	洗 尽 青 衫 辇 路 泥	更 惜 秋 风 一 帆 足	南 楼 只 在 远 山 西
北 踏 - 琴 调 - 夜 饮 - 寂 寥 - 霜 汉==北 踏 胡 霜 汉 马 骄	千 秋 琴 调 思 娇 娆	华 堂 夜 饮 灯 如 书	共 听 新 声 不 寂 寥
长 歌 - 高 车 - 衣 锦 - 只 将 - 长 歌==长 歌 负 担 久 栖 栖	一 旦 高 车 守 会 稽	衣 锦 还 乡 成 底 事	只 将 富 遗 耀 前 妻
黄 金 - 欹 枕 - 九 曲 - 一 曲 - 黄 金==销 尽 黄 金 是 此 窝	高 人 欹 枕 看 晴 波	钱 塘 门 里 九 曲 寺	得 似 先 生 一 曲 多
万 重 - 相 逢 - 一 杯 - 山 色 - 万 重==山 水 千 重 复 万 重	少 年 相 别 老 相 逢	春 风 亭 下 一 杯 酒	山 色 不 如 人 意 浓
木 绿 - 掩 扉 - 繁 霜 - 清 梦 - 成 围==先 生 墓 木 绿 成 围	弟 子 摧 颓 昼 掩 扉	大 雪 繁 霜 心 已 死	有 时 清 梦 尚 抠 衣
樱 桃 - 断 肠 - 尚 远 - 梦 回 - 樱 桃==樱 桃 湖 里 月 如 霜	偏 照 征 人 寸 断 肠	醉 里 不 知 家 尚 远	梦 回 忽 觉 路 初 长
修 竹 - 圆 荷 - 造 门 - 暖 晖 - 修 竹==修 竹 青 冥 山 翠 事	圆 荷 枯 到 水 禽 飞	造 门 休 问 林 塘 主	暂 借 闲 窗 负 暖 晖
老 松 - 云 影 - 物 外 - 残 月 - 石 洞==老 松 压 石 洞 门 耸	青 萝 曳 树 牵 云 影	天 然 物 外 清 修 地	岩 头 残 月 沈 丹 井
第 一 - 离 愁 - 今 朝 - 诗 思 - 第 一==夫 子 人 间 第 一 流	清 言 暂 隔 已 离 愁	今 朝 偶 负 寻 春 约	诗 思 勾 牵 未 肯 休
荔 枝 - 猩 血 - 流 涎 - 半 月 - 荔 枝==不 羡 南 州 锦 荔 枝	鹤 头 猩 血 正 红 滋	老 饕 隔 岁 流 涎 甚	为 趣 容 山 半 月 期
邻 鸡 - 树 头 - 人 归 - 客 愁 - 邻 鸡==邻 鸡 三 唱 趣 行 舟	霜 结 银 花 满 树 头	好 景 留 人 归 未 得	客 愁 一 半 是 吟 愁
亭 亭 - 寂 寂 - 何 处 - 云 山 - 亭 亭==亭 亭 孤 月 照 行 舟	寂 寂 长 江 万 里 流	乡 国 不 知 何 处 是	云 山 漫 漫 使 人 愁
长 江 - 江 头 - 酿 酒 - 英 雄 - 长 江==天 堑 长 江 似 海 深	江 头 山 鬼 笑 埋 金	东 家 酿 酒 西 家 醉	世 上 英 雄 各 有 心
古 庙 - 苍 龙 - 有 稽 - 梅 花 - 峨 峨==古 庙 峨 峨 拥 衮 裳	苍 龙 千 载 锁 飞 梁	向 来 更 有 稽 山 穴	谁 把 梅 花 荐 一 觞
波 光 - 云 端 - 林 花 - 青 青 - 入 座==潋 滟 波 光 入 座 寒	翠 翎 雪 羽 下 云 端	林 花 四 绕 馀 何 称	好 种 青 青 竹 万 竿
年 年 - 寒 生 - 昨 夜 - 移 时 - 年 年==年 年 心 与 雪 霜 期	一 点 寒 生 古 树 枝	昨 夜 故 休 相 问 信	隔 窗 无 月 坐 移 时
翠 微 - 雪 映 - 人 知 - 青 山 - 翠 微==独 上 云 梯 入 翠 微	蒙 蒙 烟 雪 映 岩 扉	世 人 知 在 中 峰 里	遥 礼 青 山 恨 不 归
仙 源 - 佳 句 - 红 叶 - 一 片 - 仙 源==天 上 仙 源 水 暗 流	漫 题 佳 句 落 金 沟	凭 谁 拾 取 新 红 叶	万 种 闺 情 一 片 秋
水 晶 - 不 夜 - 图 书 - 三 更 - 水 晶==水 晶 帘 映 宝 灯 明	海 上 移 来 不 夜 城	何 似 图 书 群 玉 府	青 藜 青 对 月 三 更
挥 麈 - 简 编 - 车 马 - 壶 天 - 挥 麈==客 来 挥 麈 对 觥 船	客 去 焚 香 阅 简 编	车 马 软 红 尘 里 走	不 知 委 巷 有 壶 天
白 云 - 悠 悠 - 扁 舟 - 红 尘 - 青 山==且 看 青 山 覆 白 云	悠 悠 世 事 谩 知 闻	扁 舟 却 绝 长 江 去	回 首 红 尘 路 欲 分
为 瑞 - 太 液 - 画 鹤 - 帝 宫 - 为 瑞==汉 家 为 瑞 双 黄 鹄	只 道 飞 翻 太 液 池	不 似 云 屏 六 画 鹤	帝 宫 深 处 有 人 知
波 光 - 日 暖 - 繁 华 - 芳 菲 - 波 光==冰 消 水 面 波 光 动	日 暖 树 梢 花 意 归	世 上 繁 华 随 日 好	却 应 春 浅 胜 芳 菲
山 中 - 骊 珠 - 相 映 - 清 虚 - 山 中==山 中 户 户 作 梅 忙	火 齐 骊 珠 入 帝 乡	细 织 筠 笼 相 映 发	华 清 虚 说 荔 枝 筐
木 落 - 登 楼 - 得 句 - 荞 麦 - 木 落==木 落 山 空 秋 最 多	登 楼 无 奈 月 明 何	老 僧 得 句 诗 偏 好	夜 雪 涨 溪 荞 麦 花
红 旆 - 丹 书 - 功 名 - 了 珠 - 红 旆==红 旆 欲 随 岩 桂 发	丹 书 应 与 菊 花 期	功 名 信 是 前 庭 事	浴 了 珠 娘 也 未 迟
爱 山 - 山 中 - 归 来 - 柴 门 - 嗜 好==平 生 嗜 好 唯 爱 山	前 身 疑 是 山 中 相	归 来 深 处 得 幽 栖	柴 门 正 与 山 相 向
鸣 蜩 - 摇 落 - 疑 月 - 人 间 - 鸣 蜩==何 处 鸣 蜩 不 可 怜	霜 闺 摇 落 夜 无 眠	题 残 纨 扇 光 疑 月	多 少 人 间 不 共 圆
月 光 - 玻 璃 - 骊 珠 - 卧 龙 - 连 天==月 光 如 水 水 连 天	万 顷 玻 璃 浸 碧 渊	一 颗 骊 珠 收 不 去	几 回 惊 起 卧 龙 眠
草 树 - 无 人 - 是 当 - 笙 歌 - 草 树==故 址 耕 残 草 树 秋	无 人 曾 见 鹿 来 游	甬 东 亦 是 当 时 月	不 照 笙 歌 只 照 愁
百 转 - 啄 木 - 极 目 - 去 时 - 百 转==百 转 千 萦 住 复 移	浑 如 啄 木 在 高 枝	春 效 极 目 快 晴 后	峭 绝 一 声 飞 去 时
下 肥 - 此 时 - 丹 青 - 开 元 - 下 肥==引 鉴 能 知 天 下 肥	此 时 未 纳 寿 王 妃	龙 眠 解 向 丹 青 里	写 出 开 元 治 乱 机
清 凉 - 更 长 - 千 岁 - 午 夜 - 火 云==清 凉 境 界 火 云 藏	但 觉 仙 家 日 更 长	千 岁 寿 松 谁 宴 坐	星 君 午 夜 吐 光 芒
坐 钓 - 朝 衣 - 绿 阴 - 一 片 - 清 江==只 合 清 江 坐 钓 矶	等 闲 谁 遣 着 朝 衣	绿 阴 门 巷 青 绳 路	心 逐 南 云 一 片 飞
当 时 - 谪 仙 - 余 庆 - 至 今 - 气 拥==当 时 骑 气 拥 函 关	奕 代 清 才 擅 谪 仙	鼻 祖 婵 嫣 有 余 庆	至 今 名 世 更 生 贤
新 绿 - 天 机 - 莺 戏 - 春 风 - 新 绿==新 绿 回 环 暗 竹 扉	静 中 物 物 总 天 机	啼 莺 戏 蝶 浑 如 旧	莫 是 春 风 尚 未 归
年 年 - 柳 花 - 梁 上 - 营 巢 - 春 暮==年 年 春 暮 客 天 涯	愁 见 东 风 飏 柳 花	自 叹 身 如 梁 上 燕	营 巢 长 傍 别 人 家
一 点 - 风 吹 - 倚 杖 - 溪 边 - 千 丈==千 丈 岩 头 一 点 红	春 风 吹 落 浅 莎 中	山 僧 倚 杖 移 时 去	说 似 溪 边 采 药 翁
去 时 - 残 花 - 情 深 - 莫 相 - 芍 药==去 时 芍 药 才 堪 赠	看 却 残 花 已 度 春	只 为 情 深 偏 怆 别	等 闲 相 见 莫 相 亲
酿 寒 - 林 下 - 题 诗 - 清 辉 - 寒 威==山 风 猎 猎 酿 寒 威	林 下 山 僧 见 亦 稀	怪 得 题 诗 无 俗 语	十 年 肝 鬲 湛 清 辉
云 山 - 绿 波 - 怅 望 - 夕 阳 - 云 山==云 山 蒙 董 石 陂 陀	闲 坐 船 头 看 绿 波	怅 望 佳 人 渺 何 许	竹 枝 声 断 夕 阳 多
中 央 - 丹 心 - 意 在 - 宫 黄 - 中 央==中 央 正 色 殊 堪 重	况 复 丹 心 向 太 阳	可 信 化 工 深 意 在	只 教 此 本 染 宫 黄
龙 归 - 随 月 - 一 杯 - 寂 寞 - 龙 归==宝 剑 化 龙 归 碧 落	嫦 娥 随 月 下 黄 泉	一 杯 酒 向 青 春 晚	寂 寞 书 窗 恨 独 眠
快 剑 - 一 片 - 荷 花 - 烟 柳 - 快 剑==杀 胡 快 剑 是 清 讴	牛 渚 依 然 一 片 秋	却 恨 荷 花 留 玉 辇	竟 忘 烟 柳 汴 宫 愁
青 帘 - 云 红 - 何 处 - 梅 花 - 青 帘==白 舫 青 帘 几 夜 同	洞 箫 声 里 海 云 红	百 年 身 世 知 何 处	笑 倚 梅 花 月 正 东
云 雨 - 风 烟 - 泉 流 - 草 庵 - 蛟 龙==满 山 云 雨 蛟 龙 走	万 壑 风 烟 虎 豹 通	岩 窦 石 泉 流 出 冷	草 庵 禅 影 坐 来 空
故 园 - 江 畔 - 渔 猎 - 数 行 - 故 园==故 园 今 在 灞 陵 西	江 畔 逢 君 醉 不 迷	小 弟 邻 庄 尚 渔 猎	一 封 书 寄 数 行 啼
连 城 - 乘 风 - 峥 嵘 - 彩 笔 - 连 城==从 来 美 玉 价 连 城	结 佩 乘 风 十 二 京	携 上 峥 嵘 今 有 约	好 留 彩 笔 调 清 平
鸡 声 - 烟 中 - 道 人 - 乘 兴 - 鸡 声==午 鸡 声 不 到 禅 林	柏 子 烟 中 静 拥 衾	忽 忆 西 岩 道 人 语	杖 藜 乘 兴 得 幽 寻
暖 风 - 夜 雨 - 黄 昏 - 未 栏 - 馥 郁==深 谢 暖 风 传 馥 郁	长 忧 夜 雨 暗 摧 残	黄 昏 欲 放 笙 歌 散	更 绕 未 栏 子 细 看
长 江 - 水 流 - 登 高 - 山 川 - 长 江==衮 衮 长 江 浸 落 晖	水 流 不 尽 觉 云 移	登 高 忽 动 离 骚 恨	无 奈 山 川 苦 要 诗
二 百 - 杰 阁 - 徙 倚 - 秋 风 - 二 百==张 公 一 去 二 百 载	杰 阁 依 然 横 霭 中	徙 倚 看 碑 仍 看 画	时 闻 柏 子 落 秋 风
春 风 - 梦 魂 - 花 开 - 无 言 - 长 门==春 风 日 日 闭 长 门	摇 荡 春 心 自 梦 魂	若 遣 花 开 只 笑 妾	不 如 桃 李 正 无 言
薄 晚 - 斜 阳 - 潭 潭 - 山 林 - 归 来==薄 晚 归 来 烟 已 苍	蛮 蕉 一 叶 障 斜 阳	不 须 久 住 潭 潭 府	始 觉 山 林 兴 味 长
传 宣 - 令 草 - 泥 金 - 莲 烛 - 传 宣==中 使 传 宣 学 士 家	君 王 令 草 侍 中 麻	紫 泥 金 印 才 封 了	莲 烛 然 残 一 寸 花
云 峰 - 泓 澄 - 芳 饵 - 高 名 - 苍 翠==苍 翠 云 峰 开 俗 眼	泓 澄 烟 水 浸 尘 心	唯 将 道 业 为 芳 饵	钓 得 高 名 直 至 今
烘 晴 - 云 气 - 来 雨 - 净 明 - 日 脚==日 脚 烘 晴 已 破 烟	山 头 云 气 尚 披 绵	却 须 多 谢 朝 来 雨	洗 净 明 湖 镜 裹 天
春 色 - 芳 草 - 门 前 - 君 止 - 春 色==春 色 三 分 有 尚 多	且 饶 芳 草 占 高 坡	门 前 柳 色 如 彭 泽	争 奈 陶 君 止 酒 何
山 环 - 短 艇 - 野 外 - 参 著 - 环 山==山 环 湖 水 水 环 山	短 艇 白 鸥 窗 几 间	野 外 更 将 供 给 到	饱 参 著 得 十 僧 闲
故 人 - 万 壑 - 苍 烟 - 作 人 - 故 人==故 人 折 松 寄 千 里	想 听 万 壑 风 泉 音	谁 言 五 鬣 苍 烟 面	犹 作 人 间 儿 女 心
紫 芝 - 鹤 来 - 清 江 - 春 愁 - 紫 芝==云 暖 幽 亭 长 紫 芝	昔 年 曾 许 鹤 来 期	短 筇 空 倚 清 江 上	满 目 春 愁 两 鬓 丝
清 歌 - 瑶 台 - 遍 响 - 应 多 - 清 歌==金 枝 羽 部 彻 清 歌	瑶 台 肃 穆 笙 磬 罗	谐 音 遍 响 合 明 意	万 类 昭 融 灵 应 多
漫 漫 - 春 风 - 纷 纷 - 殷 勤 - 漫 漫==漫 漫 红 紫 是 谁 栽	八 月 春 风 暗 里 来	过 眼 纷 纷 难 尽 忆	殷 勤 却 看 稻 花 开
篱 下 - 酌 酒 - 山 色 - 夕 阳 - 寻 花==寻 花 篱 下 蝶 牵 引	酌 酒 林 间 鸟 劝 酬	山 色 不 随 春 态 老	笛 声 自 起 夕 阳 愁
花 上 - 别 离 - 声 声 - 月 明 - 诗 人==诗 人 魂 在 梅 花 上	不 比 垂 杨 管 别 离	野 鹤 声 声 声 渐 远	定 应 飞 报 月 明 知
流 水 - 黄 昏 - 衣 襟 - 江 湖 - 流 水==饮 马 桑 乾 流 水 浑	燕 山 未 晚 已 黄 昏	衣 襟 犹 带 长 安 酒	不 分 江 湖 浣 旧 痕
江 山 - 沙 平 - 断 云 - 一 叶 - 万 里==万 里 江 山 万 里 天	沙 平 雁 落 远 相 连	西 风 吹 断 云 衣 细	一 叶 飞 不 是 钓 船
一 笑 - 白 酒 - 归 去 - 昨 夜 - 一 笑==野 老 相 过 一 笑 迎	黄 难 白 酒 愧 深 情	山 空 日 落 早 归 去	昨 夜 隔 篱 闻 虎 声
仙 子 - 孤 高 - 风 波 - 云 根 - 仙 子==仙 子 浑 无 涉 世 劳	屐 痕 一 尺 寄 孤 高	几 人 失 脚 风 波 裹	可 是 云 根 立 得 牢
春 晴 - 芒 鞋 - 蒲 团 - 诗 端 - 春 晴==密 云 阁 雨 靳 春 晴	不 放 芒 鞋 取 次 行	却 坐 蒲 团 政 无 赖	好 诗 端 为 破 愁 城
知 名 - 孤 鹤 - 人 世 - 祥 云 - 知 名==年 才 二 十 众 知 名	孤 鹤 仪 容 彻 骨 清	口 传 天 语 来 人 世	却 逐 祥 云 上 玉 京
古 松 - 谒 庙 - 昆 仑 - 作 人 - 古 松==白 崖 山 下 古 松 青	暂 卷 牙 旗 谒 庙 灵	见 说 昆 仑 关 北 畔	曾 将 草 木 作 人 形
归 船 - 山 家 - 牡 丹 - 柳 花 - 未 许==未 许 归 船 转 柁 牙	爱 山 犹 峦 自 山 家	牡 丹 开 尽 春 无 几	狼 籍 东 风 杨 柳 花
绝 代 - 倾 国 - 冰 雪 - 朱 粉 - 绝 代==西 北 佳 人 绝 代 姿	倾 城 倾 国 未 为 奇	自 然 冰 雪 生 颜 色	不 用 人 间 朱 粉 施
紫 陌 - 冷 落 - 朱 门 - 杨 柳 - 紫 陌==绿 雨 微 消 紫 陌 尘	湖 光 冷 落 似 无 春	朱 门 记 得 曾 游 处	杨 柳 青 青 不 见 人
露 蕊 - 霜 枝 - 人 稀 - 余 香 - 露 蕊==塞 郊 露 蕊 疏 仍 小	瘦 地 霜 枝 细 且 长	境 僻 人 稀 谁 与 采	马 蹄 赢 得 践 余 香
谈 笑 - 阿 那 - 相 笑 - 垂 泪 - 谈 笑==留 君 谈 笑 且 从 容	白 发 红 尘 阿 那 中	踉 跄 行 藏 莫 相 笑	枯 鱼 垂 泪 恨 无 从
荒 凉 - 夜 吟 - 门 相 - 得 句 - 荒 凉==骚 雅 荒 凉 我 未 安	月 和 馀 雪 夜 吟 寒	相 门 相 客 应 相 笑	得 句 胜 于 得 好 官
仙 禽 - 归 来 - 江 乡 - 渔 翁 - 半 天==仙 禽 洒 羽 半 天 飞	疑 是 归 来 老 令 威	妆 点 江 乡 堪 入 画	渔 翁 披 得 满 衰 衣
和 羹 - 春 色 - 卉 从 - 锦 绣 - 和 羹==调 鼎 和 羹 异 日 才	边 城 春 色 喜 先 开	会 看 百 卉 从 今 盛	锦 绣 层 层 遍 九 垓
月 筛 - 日 照 - 炎 空 - 团 团 - 月 筛==月 筛 松 影 高 低 树	日 照 池 心 上 下 天	赫 赫 炎 空 非 卓 午	团 团 秋 夜 不 知 圆
拂 拂 - 出 群 - 分 京 - 天 香 - 拂 拂==拂 拂 轻 黄 染 御 衣	出 群 标 韵 异 繁 枝	此 身 已 分 京 华 隔	不 谓 天 香 尚 许 披
别 驾 - 垂 老 - 也 知 - 细 书 - 蠹 鱼==别 驾 生 涯 似 蠹 鱼	简 编 垂 老 未 相 疏	也 知 赋 得 寒 儒 分	五 十 灯 前 见 细 书
富 贵 - 千 古 - 含 毫 - 风 吹 - 空 梦==一 生 富 贵 皆 空 梦	千 古 英 雄 只 断 碑	几 欲 含 毫 作 天 问	西 风 吹 恨 入 江 篱
胸 次 - 崔 巍 - 高 手 - 酒 杯 - 胸 次==胸 次 玲 珑 著 九 垓	政 须 时 复 兴 崔 巍	楼 高 手 可 扪 星 斗	移 掇 天 河 入 酒 杯
扬 州 - 月 下 - 清 光 - 红 袖 - 扬 州==扬 州 西 望 隔 沧 波	花 下 楼 台 月 下 歌	好 借 清 光 骑 鹤 去	买 将 红 袖 斗 嫦 娥
云 开 - 凄 凉 - 梦 回 - 闭 门 - 云 开==南 岭 过 云 开 紫 翠	北 江 飞 雨 送 凄 凉	酒 醒 梦 回 春 尽 日	闭 门 隐 几 坐 烧 香
转 庭 - 重 门 - 穿 云 - 落 花 - 日 转==日 转 庭 槐 影 渐 移	重 门 复 屋 传 呼 迟	不 如 拂 袖 穿 云 去	说 与 落 花 流 水 知
细 雨 - 竹 阴 - 麦 光 - 第 一 - 香 细==银 叶 煎 香 细 雨 声	竹 阴 行 处 药 花 明	麦 光 小 楷 临 唐 帖	更 有 人 间 第 一 清
春 水 - 合 岸 - 余 寒 - 一 片 - 水 生==昨 夜 秦 淮 春 水 生	朝 来 合 岸 有 波 声	春 阴 不 散 余 寒 在	雪 积 钟 山 一 片 明
黄 金 - 清 芬 - 一 笑 - 月 中 - 黄 金==黄 金 匀 揉 万 英 开	步 绕 清 芬 过 砌 台	一 笑 欣 然 超 鼻 观	知 公 曾 到 月 中 来
重 帘 - 断 肠 - 几 度 - 衡 阳 - 重 帘==重 帘 空 见 月 昏 黄	络 纬 啼 来 也 断 肠	几 度 系 书 君 不 答	雁 飞 应 不 到 衡 阳
必 催 - 烟 霏 - 夜 坛 - 归 云 - 催 租==未 必 催 租 能 办 诗	不 妨 扶 老 上 烟 霏	彭 仙 一 去 夜 坛 冷	老 鹤 不 归 云 自 飞
平 津 - 万 重 - 七 星 - 神 剑 - 平 津==延 平 津 路 水 溶 溶	峭 壁 巍 岑 一 万 重	昨 夜 七 星 潭 底 见	分 明 神 剑 化 为 龙
翩 翩 - 中 秋 - 十 日 - 千 官 - 翩 翩==红 骑 翩 翩 小 绣 旗	苑 中 秋 雁 恰 来 时	何 妨 十 日 方 归 内	料 得 千 官 总 不 知
蕉 心 - 柳 叶 - 觅 句 - 空 庭 - 蕉 心==蕉 心 待 雨 慵 能 展	柳 叶 非 秋 间 自 零	觅 句 政 资 闲 草 木	荒 凉 于 此 只 空 庭
小 楼 - 长 春 - 杨 花 - 竹 窗 - 小 楼==小 小 楼 临 短 短 墙	长 春 半 架 动 红 香	杨 花 知 得 人 孤 寂	故 故 飞 来 入 竹 窗
父 子 - 一 门 - 丹 青 - 衣 冠 - 父 子==父 子 同 时 践 禁 涂	一 门 荣 耀 世 间 无	愿 凭 曹 霸 丹 青 笔	绘 入 衣 冠 盛 事 图
花 重 - 欲 仙 - 百 年 - 无 人 - 花 重==梅 花 重 压 帽 檐 偏	曳 杖 行 歌 意 欲 仙	後 五 百 年 君 记 取	断 无 人 似 放 翁 颠
三 岛 - 风 烟 - 金 乌 - 流 水 - 岁 月==因 将 岁 月 离 三 岛	闲 贮 风 烟 在 一 壶	为 问 金 乌 头 白 后	人 间 流 水 却 回 无
山 居 - 闭 门 - 苍 玉 - 一 而 - 山 居==指 点 山 居 向 那 边	闭 门 花 木 养 风 烟	邻 人 不 馔 苍 玉 束	一 一 而 今 欲 造 天
画 屏 - 聪 慧 - 竹 韵 - 熏 风 - 画 屏==秀 色 罗 山 列 画 屏	男 生 聪 慧 女 娉 婷	三 苞 竹 韵 琴 堂 化	管 领 熏 风 动 舜 廷
鲜 明 - 黄 叶 - 离 别 - 多 愁 - 色 鲜==颜 色 鲜 明 能 几 时	未 辞 黄 叶 已 辞 枝	都 缘 爱 管 闲 离 别	多 恨 多 愁 故 早 衰
紫 阳 - 阶 前 - 山 色 - 金 鱼 - 阳 山==紫 阳 山 下 闻 皇 牒	地 藏 阶 前 拜 诏 书	乍 脱 绿 袍 山 色 翠	新 披 紫 绶 佩 金 鱼
龙 种 - 成 花 - 瑶 池 - 丹 青 - 龙 种==龙 种 天 驹 产 渥 洼	五 云 毛 色 散 成 花	瑶 池 一 去 无 消 息	只 许 丹 青 纸 上 夸
岁 寒 - 花 魁 - 清 香 - 牡 丹 - 岁 寒==上 外 无 花 耐 岁 寒	花 魁 今 古 品 题 难	清 香 合 让 梅 为 最	阳 艳 丛 中 许 牡 丹
太 白 - 仙 游 - 皇 恩 - 君 为 - 秋 思==秋 思 太 白 峰 头 雪	晴 忆 仙 游 洞 口 云	未 报 皇 恩 归 未 得	惭 君 为 寄 北 山 文
凭 栏 - 茫 茫 - 流 水 - 丹 青 - 凭 栏==紫 芝 峰 上 一 凭 栏	烟 草 茫 茫 天 地 宽	眼 界 已 随 流 水 去	丹 青 无 复 旧 时 看
修 竹 - 雨 重 - 诗 句 - 间 那 - 山 居==山 居 面 面 皆 修 竹	雨 重 时 惊 入 屋 梢	坐 诵 方 斋 旧 诗 句	人 间 那 有 续 弦 胶
碎 玉 - 梨 花 - 寂 寞 - 深 宫 - 碎 玉==檐 声 滴 碎 玉 阑 干	开 尽 梨 花 亦 懒 看	燕 子 不 归 人 寂 寞	深 深 宫 殿 锁 春 寒
乘 龙 - 留 得 - 孤 枕 - 冰 肌 - 乘 龙==智 琼 久 已 乘 龙 去	留 得 人 间 十 二 枝	插 向 瓦 瓶 伴 孤 枕	别 无 玉 骨 与 冰 肌
如 电 - 画 楼 - 知 来 - 陌 上 - 浮 生==浮 生 一 刹 逝 如 电	画 楼 辜 负 美 人 缘	未 知 来 生 相 见 否	陌 上 逢 却 再 少 年
铁 板 - 穿 沙 - 浪 花 - 渔 舟 - 铁 板==铁 板 交 横 鹿 耳 排	路 穿 沙 线 几 纡 回	浪 花 堆 里 双 缨 在	更 遣 渔 舟 向 导 来
笑 浓 - 夕 阳 - 寒 梅 - 扑 人 - 素 粉==中 开 素 粉 笑 浓 霜	外 带 凝 脂 妒 夕 阳	纵 有 寒 梅 只 一 色	暗 香 不 似 扑 人 香
露 叶 - 潇 湘 - 斜 阳 - 一 曲 - 露 叶==露 叶 风 梢 接 水 乡	几 回 相 对 忆 潇 湘	寒 云 流 水 斜 阳 暮	一 曲 清 歌 断 客 肠
昼 掩 - 南 山 - 忘 言 - 天 际 - 昼 掩==老 去 柴 桑 昼 掩 关	悠 然 得 意 在 南 山	忘 言 妙 处 无 人 解	目 送 孤 鸿 天 际 还
把 酒 - 荔 枝 - 玉 树 - 花 香 - 把 酒==忆 曾 把 酒 泛 湘 漓	茉 莉 球 边 擘 荔 枝	一 笑 相 逢 双 玉 树	花 香 如 梦 鬓 如 丝
寒 灯 - 三 更 - 何 处 - 梅 花 - 寒 灯==剔 尽 寒 灯 梦 不 成	拥 衾 危 坐 到 三 更	不 知 何 处 吹 羌 笛	落 尽 梅 花 月 满 城
悠 悠 - 南 向 - 极 目 - 金 堤 - 淮 水==高 天 淮 水 澹 悠 悠	南 向 春 江 日 夜 流	极 目 烟 花 伤 客 思	金 堤 明 月 是 扬 州
古 径 - 夜 窗 - 传 芳 - 孙 枝 - 古 径==鲜 碧 缘 坡 古 径 深	夜 窗 风 雨 作 龙 吟	自 从 八 叶 传 芳 后	数 到 孙 枝 玉 满 林
西 风 - 无 人 - 突 前 - 敲 推 - 黄 叶==西 风 黄 叶 北 门 街	有 句 无 人 为 翦 裁	冲 突 前 驱 公 会 否	要 求 一 语 定 敲 推
忘 忧 - 鹤 发 - 忘 忧 - 万 斛 - 忘 忧==萱 草 忘 忧 底 解 忘	慈 亲 鹤 发 坐 高 堂	羡 君 有 此 忘 忧 得	如 我 添 忧 万 斛 强
础 经 - 蜗 涎 - 春 阴 - 黄 梅 - 汗 础==汗 础 经 旬 未 肯 乾	破 窗 随 处 有 蜗 涎	祗 今 不 耐 春 阴 得	想 见 黄 梅 细 雨 天
城 头 - 羌 笛 - 枫 叶 - 戍 楼 - 一 雁==西 风 一 雁 海 城 头	羌 笛 声 中 水 乱 流	枫 叶 萧 萧 山 月 下	戍 楼 残 火 几 家 秋
晓 来 - 分 明 - 星 河 - 神 仙 - 华 表==鹤 使 晓 来 华 表 上	分 明 说 得 帝 都 春	门 开 阊 阖 星 河 在	榜 注 神 仙 姓 字 瓣
昨 夜 - 味 今 - 防 秋 - 幽 人 - 西 风==西 风 昨 夜 入 庭 梧	况 味 今 年 似 旧 事	想 见 防 秋 有 长 策	幽 人 真 欲 反 吾 庐
龙 尾 - 杨 柳 - 翠 华 - 无 人 - 斜 日==斜 日 倒 穿 龙 尾 道	杨 柳 半 枯 秋 色 老	翠 华 西 幸 华 清 宫	长 门 落 叶 无 人 扫
莺 啼 - 到 处 - 轻 薄 - 东 风 - 莺 啼==山 静 莺 啼 春 事 深	意 行 到 处 若 为 情	休 言 柳 絮 全 轻 薄	半 是 东 风 不 老 成
黄 卷 - 白 头 - 春 晴 - 东 邻 - 辛 勤==半 世 辛 勤 守 黄 卷	白 头 容 易 过 青 春	枕 前 亦 觉 春 晴 否	试 问 东 邻 晚 起 人
江 村 - 向 暖 - 何 处 - 寻 香 - 江 村==行 遍 江 村 未 有 梅	一 花 忽 向 暖 枝 开	黄 蜂 何 处 知 消 息	便 解 寻 香 隔 舍 来
秋 声 - 楼 百 - 天 欲 - 日 下 - 桐 叶==凉 桐 叶 叶 按 秋 声	搔 首 危 楼 百 感 生	天 欲 尽 头 烟 水 阔	雁 拖 残 日 下 芜 城
茫 茫 - 闲 把 - 堪 笑 - 长 廊 - 茫 茫==是 非 得 失 两 茫 茫	闲 把 遗 书 细 较 量	掩 卷 古 人 堪 笑 处	起 来 摩 腹 步 长 廊
楼 台 - 侯 门 - 尘 埃 - 流 水 - 楼 台==几 宵 烟 月 锁 楼 台	欲 寄 侯 门 荐 祢 才	满 面 尘 埃 人 不 识	谩 随 流 水 出 山 来
香 醪 - 桃 李 - 所 有 - 盈 车 - 香 醪==君 家 香 醪 蜜 不 如	试 投 桃 李 望 瑶 琚	敢 夸 所 无 易 所 有	潘 郎 一 出 果 盈 车
山 阁 - 曲 槛 - 秋 望 - 山 青 - 山 阁==鸡 笼 山 阁 旧 居 停	曲 槛 回 廊 几 度 经	最 是 城 阴 秋 望 好	覆 舟 遥 接 蒋 山 青
三 江 - 眼 此 - 如 画 - 丹 青 - 三 江==休 说 三 江 兴 五 湖	平 生 心 眼 此 中 舒	人 人 总 道 浑 如 画	祗 恐 丹 青 画 不 如
十 年 - 风 雷 - 老 树 - 有 仙 - 十 年==龙 虎 十 年 气 壮 哉	抵 排 霜 雪 傲 风 雷	湖 边 老 树 勤 封 植	会 有 仙 真 邂 逅 来
才 高 - 有 情 - 无 生 - 尘 生 - 才 高==才 高 文 赡 富 时 名	感 物 伤 时 动 有 情	不 识 无 生 真 目 体	一 尘 才 遣 一 尘 生
日 色 - 颠 狂 - 江 南 - 破 窗 - 霜 重==霜 重 天 高 日 色 微	颠 狂 红 叶 上 阶 飞	北 风 不 惜 江 南 客	更 入 破 窗 吹 客 衣
西 湖 - 白 玉 - 今 夜 - 千 里 - 西 湖==西 湖 一 曲 舞 霓 裳	劝 客 花 前 白 玉 觞	谁 对 七 桥 今 夜 月	有 情 千 里 不 相 忘
白 水 - 池 边 - 荷 花 - 清 香 - 白 水==西 来 白 水 满 南 池	走 马 池 边 日 暮 时	桥 底 荷 花 无 限 思	清 香 乞 与 路 人 知
白 汗 - 雨 余 - 鹅 黄 - 碧 天 - 白 汗==白 汗 翻 浆 午 景 前	雨 余 风 物 便 萧 然	应 倾 半 熟 鹅 黄 酒	照 见 新 晴 水 碧 天
万 斛 - 夜 深 - 万 里 - 一 片 - 万 斛==万 斛 秋 愁 强 自 宽	夜 深 风 露 伴 孤 寒	可 怜 万 里 长 空 月	只 得 窗 前 一 片 看
卷 帘 - 经 卷 - 瑶 琴 - 和 风 - 卷 帘==卷 帘 康 寿 丽 朝 曦	经 卷 龙 香 昼 漏 迟	闲 暇 瑶 琴 成 雅 奏	和 风 吹 入 万 年 枝
摸 索 - 轮 囷 - 八 骏 - 群 飞 - 难 佑==暗 中 摸 索 不 难 佑	眼 里 轮 囷 郤 见 稀	行 地 径 须 先 八 骏	刺 天 终 不 羡 群 飞
秋 天 - 去 思 - 归 来 - 江 头 - 秋 天==老 年 怀 抱 晚 秋 天	欲 去 思 君 重 黯 然	闻 道 归 来 有 消 息	江 头 错 认 几 人 船
屋 老 - 日 新 - 下 榻 - 愧 前 - 屋 老==三 间 官 屋 老 湖 滨	孺 子 名 声 日 日 新	下 榻 本 非 天 上 事	后 人 空 自 愧 前 人
梅 花 - 见 影 - 新 诗 - 梅 花 - 梅 花==竹 与 梅 花 相 并 枝	月 明 还 见 影 参 差	捻 梅 细 比 新 诗 看	酷 似 梅 花 太 瘦 时
芙 蓉 - 安 排 - 天 趣 - 游 人 - 芙 蓉==杨 柳 芙 蓉 旧 日 栽	近 来 堂 宇 更 安 排	湖 光 接 得 全 天 趣	莫 遣 游 人 鼓 吹 来
风 猎 - 睡 美 - 黄 鹂 - 绿 阴 - 风 猎==窗 风 猎 猎 举 绡 衣	睡 美 叭 应 枕 簟 知	忽 有 黄 鹂 深 树 语	宛 如 春 尽 绿 阴 时
松 柏 - 地 阔 - 十 年 - 伤 心 - 松 柏==陶 山 松 柏 已 成 阴	地 阔 天 高 不 可 寻	二 十 年 中 儿 又 女	人 间 独 自 有 伤 心
作 花 - 邯 郸 - 麈 尾 - 灯 光 - 作 花==槐 催 举 子 作 花 黄	来 食 邯 郸 道 上 粱	便 欲 扫 床 悬 麈 尾	正 愁 喘 月 似 灯 光
衣 襟 - 竹 间 - 邮 亭 - 白 头 - 衣 襟==翠 湿 衣 襟 山 满 楼	竹 间 溪 水 绕 床 流	行 人 莫 羡 邮 亭 吏	生 向 此 中 今 白 头
翻 盆 - 风 声 - 鸡 鸣 - 开 门 - 沧 江==沧 江 初 夜 雨 翻 盆	将 晓 风 声 战 乱 云	篱 下 寒 鸡 鸣 晓 苦	老 人 先 起 自 开 门
狂 风 - 云 腾 - 岩 前 - 青 山 - 狂 风==怪 雨 狂 风 势 欲 倾	阴 垂 六 合 见 云 腾	一 条 瀑 布 岩 前 落	界 破 青 山 千 万 层
玉 簪 - 雪 月 - 一 醉 - 多 情 - 玉 簪==鲛 绡 剪 碎 玉 簪 轻	檀 晕 妆 成 雪 月 明	肯 伴 老 人 春 一 醉	悬 知 欲 落 更 多 情
在 天 - 归 时 - 秋 风 - 琵 琶 - 在 天==身 在 天 涯 梦 在 秦	归 时 未 卜 见 时 频	浔 阳 江 上 秋 风 过	传 得 琵 琶 与 别 人
溪 山 - 计 功 - 胸 次 - 忘 言 - 溪 山==溪 山 有 分 皆 为 福	草 木 无 成 半 计 功	小 小 梅 园 胸 次 阔	到 忘 言 处 只 春 风
卧 龙 - 身 同 - 三 顾 - 千 载 - 卧 龙==褒 斜 谷 口 卧 龙 翁	遍 圆 身 世 戒 身 同	不 应 三 顾 逢 先 主	至 今 千 载 慕 冥 鸿
千 门 - 一 望 - 鸳 瓦 - 玉 绳 - 万 户==千 门 万 户 鞠 蒿 藜	断 烬 遗 垣 一 望 迷	惆 怅 建 章 鸳 瓦 尽	夜 来 空 见 玉 绳 低
风 来 - 离 离 - 洲 边 - 开 门 - 风 来==吹 面 风 来 杜 若 香	离 离 烟 柳 拂 鸥 长	人 家 鹦 鹉 洲 边 住	一 向 开 门 对 汉 阳
合 浦 - 读 书 - 义 人 - 衡 门 - 明 月==明 月 青 灯 合 浦 村	北 人 惟 此 读 书 园	窦 家 风 义 人 牢 落	多 少 衡 门 欲 断 魂
白 发 - 年 光 - 著 书 - 悠 悠 - 白 发==闲 将 白 发 照 清 沟	太 息 年 光 逝 不 留	勋 业 无 期 著 书 晚	此 生 与 世 判 悠 悠
三 杯 - 醉 眼 - 藤 床 - 蝴 蝶 - 三 杯==三 杯 未 醒 复 三 杯	醉 眼 朦 胧 劈 不 开	急 办 藤 床 并 竹 枕	要 随 蝴 蝶 到 蓬 莱
江 上 - 江 枫 - 云 不 - 水 边 - 江 上==郎 从 江 上 买 行 舟	妾 对 江 枫 生 晚 愁	雁 云 不 断 楚 天 碧	望 郎 怕 上 水 边 楼
一 线 - 头 十 - 数 点 - 沧 浪 - 一 线==海 门 乍 见 一 线 白	江 下 涛 头 十 丈 黄	数 点 红 旗 争 出 没	千 艘 飞 橹 下 沧 浪
清 秋 - 先 春 - 握 兰 - 庞 眉 - 清 秋==可 待 清 秋 菊 共 芳	春 苗 夏 叶 已 先 春	握 兰 故 事 人 谁 识	夙 世 庞 眉 汉 署 郎
元 巳 - 贵 家 - 风 光 - 纷 纷 - 元 巳==帝 京 元 巳 足 繁 华	细 管 清 弦 七 贵 家	此 日 风 光 谁 不 共	纷 纷 皆 是 掖 垣 花
衣 冠 - 天 涯 - 诗 人 - 重 阳 - 衣 冠==衣 冠 南 渡 紫 微 郎	流 落 天 涯 事 可 伤	鄙 视 诗 人 终 不 会	乱 山 深 处 过 重 阳
拍 岸 - 霜 鬓 - 杨 柳 - 扁 舟 - 清 波==拍 岸 清 波 扑 岸 埃	黑 头 霜 鬓 几 徘 徊	禾 兴 门 外 官 杨 柳	又 见 扁 舟 上 堰 来
十 年 - 登 仙 - 横 枝 - 断 弦 - 十 年==诗 社 飘 零 二 十 年	春 官 老 子 复 登 仙	豫 章 幸 有 横 枝 在	好 觅 鸾 胶 续 断 弦
云 山 - 参 差 - 道 新 - 潺 湲 - 云 山==处 处 云 山 无 尽 时	桐 庐 南 望 转 参 差	舟 人 莫 道 新 安 近	欲 上 潺 湲 行 自 迟
博 山 - 蒲 团 - 柴 门 - 白 云 - 博 山==博 山 一 炷 小 蛇 寒	无 人 独 自 从 蒲 团	柴 门 却 倩 冷 风 关	檐 外 白 云 时 往 还
萧 然 - 能 草 - 杨 梅 - 绿 李 - 白 发==白 发 萧 然 海 上 村	犹 能 草 草 置 清 樽	今 年 项 里 杨 梅 熟	绿 李 来 禽 不 足 言
风 吹 - 浥 露 - 踊 跃 - 吏 部 - 檀 心==朔 风 吹 冷 破 檀 心	浥 露 匀 铺 琐 碎 金	喜 见 鲜 鲜 长 踊 跃	只 应 吏 部 独 知 音
沧 海 - 泰 山 - 憔 悴 - 黄 卷 - 夜 光==沧 海 枯 来 失 夜 光	泰 山 走 去 误 朝 阳	可 怜 憔 悴 苍 颜 客	曾 是 呻 吟 黄 卷 郎
细 细 - 断 肠 - 卷 帘 - 斜 阳 - 细 细==香 风 细 细 出 重 墙	不 见 繁 枝 已 断 肠	知 有 何 人 卷 帘 箔	卧 看 零 落 满 斜 阳
竹 边 - 皎 月 - 风 味 - 月 中 - 竹 边==池 边 梅 映 竹 边 池	皎 月 勾 添 光 陆 离	堪 笑 胡 雏 亦 风 味	从 教 横 笛 月 中 吹
绿 苔 - 幽 花 - 剑 南 - 明 日 - 朱 门==半 阖 朱 门 见 绿 苔	幽 花 仍 傍 小 山 开	剑 南 七 月 暑 未 退	明 日 更 携 棋 簟 来
螳 螂 - 明 月 - 织 女 - 牵 牛 - 螳 螂==谁 见 螳 螂 能 拒 辙	萤 虫 七 夕 吞 明 月	织 女 心 宽 不 作 声	牵 牛 一 棒 和 空 折
佐 理 - 正 君 - 宰 相 - 孜 孜 - 佐 理==竭 诚 佐 理 奖 言 司	先 正 君 心 帝 者 师	举 荐 不 为 肓 宰 相	尽 供 乃 职 日 孜 孜
泠 泠 - 杜 鹃 - 春 老 - 衣 拾 - 泠 泠==书 幌 泠 泠 子 夜 风	杜 鹃 啼 月 小 墙 东	江 南 词 客 惜 春 老	清 晓 披 衣 拾 堕 红
西 湖 - 探 梅 - 登 山 - 访 戴 - 西 湖==不 到 西 湖 又 五 年	况 当 风 雪 探 梅 天	出 门 有 愧 登 山 屦	寻 友 空 回 访 戴 船
生 涯 - 萧 条 - 寒 梅 - 寂 寥 - 生 涯==都 无 一 物 作 生 涯	坊 巷 萧 条 有 几 家	料 得 寒 梅 应 怅 恨	满 城 开 作 寂 寥 花
鱼 虾 - 残 编 - 岩 桂 - 得 一 - 鱼 虾==湖 光 不 动 见 鱼 虾	败 纸 残 编 数 十 家	岩 桂 丛 中 三 四 客	醉 归 人 得 一 瓶 花
虚 空 - 野 人 - 无 根 - 星 作 - 虚 空==聚 散 虚 空 去 复 还	野 人 闲 处 倚 筇 看	不 知 身 是 无 根 物	蔽 月 遮 星 作 万 端
三 日 - 长 沙 - 登 高 - 属 庾 - 三 日==三 日 欢 游 辞 曲 水	二 年 愁 卧 在 长 沙	每 登 高 处 长 相 忆	何 况 兹 楼 属 庾 家
一 亩 - 晚 风 - 催 归 - 月 上 - 一 亩==小 筑 初 开 一 亩 基	晚 风 散 策 已 相 宜	山 童 何 急 催 归 去	正 是 凉 生 月 上 时
归 去 - 故 园 - 深 山 - 寄 远 - 归 去==共 醉 流 芳 独 归 去	故 园 高 士 日 相 亲	深 山 古 路 无 杨 柳	折 取 桐 花 寄 远 人
何 处 - 一 杯 - 不 语 - 零 落 - 春 光==春 光 冉 冉 归 何 处	更 向 花 前 把 一 杯	尽 日 问 花 花 不 语	为 谁 零 落 为 谁 开
陌 上 - 吴 蚕 - 兰 亭 - 花 坞 - 陌 上==陌 上 行 歌 日 正 长	吴 蚕 捉 绩 麦 登 场	兰 亭 酒 美 逢 人 醉	花 坞 茶 新 满 市 香
游 春 - 风 光 - 歌 舞 - 白 头 - 游 春==欲 随 年 少 强 游 春	自 觉 风 光 不 属 身	歌 舞 屏 风 花 障 上	几 时 曾 画 白 头 人
霞 明 - 晓 春 - 农 夫 - 青 青 - 彩 霞==锦 衣 红 夺 彩 霞 明	侵 晓 春 游 向 野 庭	不 识 农 夫 辛 苦 力	骄 骢 踏 烂 麦 青 青
看 花 - 酌 酒 - 人 已 - 故 处 - 湖 上==去 年 湖 上 看 花 时	拍 槛 呼 鱼 酌 酒 卮	鱼 计 主 人 已 非 昔	犹 惊 故 处 上 钩 迟
清 流 - 微 风 - 何 处 - 煮 茶 - 清 流==幅 圆 千 里 浸 清 流	苹 叶 微 风 为 客 收	画 作 一 图 何 处 设	煮 茶 间 看 建 溪 头
物 华 - 随 风 - 芳 草 - 春 去 - 物 华==归 涂 检 点 物 华 非	黛 色 随 风 上 柳 枝	扑 扑 晴 香 恋 芳 草	却 疑 春 去 未 多 时
客 路 - 秋 色 - 一 封 - 独 坐 - 别 离==客 路 寻 常 怨 别 离	况 逢 秋 色 倍 堪 悲	一 封 书 到 千 山 暮	正 是 思 君 独 坐 时
江 上 - 十 年 - 殷 勤 - 繁 枝 - 江 上==江 上 悠 悠 人 不 问	十 年 云 外 醉 中 身	殷 勤 解 却 丁 香 结	纵 放 繁 枝 散 诞 春
樱 桃 - 风 雨 - 伤 春 - 飞 花 - 樱 桃==见 说 樱 桃 已 烂 开	坐 愁 风 雨 苦 相 催	自 怜 华 发 伤 春 客	两 见 飞 花 未 放 回
丹 霞 - 琼 台 - 一 声 - 露 滴 - 三 峰==丹 霞 飘 渺 海 三 峰	归 去 琼 台 第 几 重	仙 骥 一 声 风 驭 远	月 明 清 露 滴 金 松
寂 寂 - 凌 波 - 空 有 - 芭 蕉 - 寂 寂==寂 寂 无 言 敛 翠 蛾	花 阴 试 步 学 凌 波	玉 颜 空 有 嫦 娥 貌	不 及 芭 蕉 雨 露 多
登 台 - 胡 床 - 清 凉 - 手 倦 - 登 台==登 台 长 早 下 台 迟	移 遍 胡 床 无 处 移	不 是 清 凉 罢 挥 扇	自 缘 手 倦 歇 些 时
四 时 - 花 开 - 为 贵 - 再 来 - 四 时==用 尽 四 时 周 一 岁	唯 春 能 见 好 花 开	十 千 买 酒 未 为 贵	既 去 红 芳 岂 再 来
玉 蕊 - 江 南 - 发 天 - 年 年 - 玉 蕊==莫 欺 玉 蕊 瘦 栾 栾	中 有 江 南 长 恨 端	白 发 天 涯 归 未 得	年 年 老 眼 泪 中 看
夜 静 - 鹤 唳 - 筑 台 - 百 年 - 月 朗==夜 静 烽 清 月 朗 天	时 时 霜 鹤 唳 芝 田	筑 台 正 与 仙 人 约	少 驻 人 间 五 百 年
春 来 - 长 条 - 送 别 - 是 去 - 春 来==春 来 折 尽 更 逢 春	旧 折 长 条 又 复 新	谁 有 行 人 相 送 别	今 年 不 是 去 年 人
出 家 - 乞 食 - 长 沙 - 绛 老 - 出 家==童 子 出 家 无 第 行	随 师 乞 食 遣 称 名	长 沙 岂 敢 论 年 几	绛 老 惟 知 甲 子 生
山 林 - 升 沉 - 水 禽 - 幽 人 - 山 林==投 迹 山 林 不 厌 深	老 来 宁 复 计 升 沉	水 禽 得 得 来 相 伴	应 识 幽 人 一 片 主
钧 天 - 鱼 龙 - 临 风 - 碧 玉 - 钧 天==黄 帝 钧 天 曲 未 终	至 今 烟 粮 舞 鱼 龙	临 风 更 欲 吹 长 笛	摇 荡 波 心 碧 玉 峰
老 赵 - 风 流 - 今 朝 - 明 月 - 老 赵==安 贴 帮 乡 老 赵 州	时 辰 使 得 最 风 流	今 朝 有 酒 今 朝 醉	明 月 愁 来 明 日 愁
温 泉 - 尘 生 - 凝 脂 - 儿 在 - 温 泉==当 日 温 泉 浴 太 真	岂 知 绣 袜 解 尘 生	更 于 洗 滑 凝 脂 处	尚 忆 胡 儿 在 锦 绷
画 舫 - 华 筵 - 别 离 - 垂 杨 - 画 舫==相 尚 津 涯 临 画 舫	栽 从 亭 馆 近 华 筵	别 离 自 是 无 聊 赖	于 甚 垂 杨 有 纠 牵
岁 月 - 喔 喔 - 九 苞 - 上 林 - 岁 月==栖 桀 栖 埘 岁 月 深	咿 咿 喔 喔 放 豪 音	九 苞 彩 色 丹 山 凤	春 暖 还 须 报 上 林
年 老 - 金 屋 - 东 风 - 羲 和 - 年 老==白 发 催 年 老 病 身	可 堪 金 屋 备 词 臣	东 风 是 处 花 开 落	谁 识 羲 和 酿 得 春
竹 影 - 桂 子 - 是 客 - 他 乡 - 斜 阳==满 阶 竹 影 扫 斜 阳	一 枕 秋 风 桂 子 香	梦 裹 不 知 身 是 客	觉 来 依 旧 在 他 乡
入 宫 - 深 闺 - 十 年 - 紫 泥 - 入 宫==昔 入 宫 中 发 未 齐	尚 衣 今 许 入 深 闺	十 年 一 得 君 王 顾	重 为 班 头 捧 紫 泥
清 泉 - 犹 从 - 须 扶 - 细 书 - 清 泉==清 泉 白 米 山 家 有	盐 酪 犹 从 小 市 求	寸 步 须 扶 本 常 事	细 书 妨 读 却 闲 愁
无 力 - 花 开 - 东 君 - 关 情 - 无 力==病 来 无 力 与 春 争	看 尽 花 开 草 又 生	莫 道 东 君 不 识 面	旧 红 新 绿 也 关 情
寒 泉 - 纹 簟 - 来 桐 - 无 人 - 寒 泉==寒 泉 断 藕 素 丝 长	纹 簟 开 瓜 碧 玉 香	午 睡 觉 来 桐 影 转	无 人 可 共 北 窗 凉
苔 痕 - 水 边 - 丁 宁 - 枝 头 - 苔 痕==满 树 苔 痕 带 老 芬	水 边 篱 落 月 昏 黄	丁 宁 僮 子 休 教 折	只 听 枝 头 独 自 香
烟 消 - 兰 舟 - 故 园 - 杨 柳 - 烟 消==烟 消 日 出 江 水 流	江 风 摇 荡 木 兰 舟	故 园 望 断 不 得 去	杨 柳 蒹 葭 又 早 秋
云 边 - 风 流 - 诸 贤 - 寺 钟 - 云 边==回 首 云 边 更 看 松	风 流 王 谢 旧 行 踪	不 知 谁 继 诸 贤 后	夜 半 来 听 六 寺 钟
曲 岸 - 凄 凉 - 聚 散 - 佳 节 - 曲 岸==孙 陵 西 曲 岸 乌 纱	知 汝 凄 凉 正 忆 家	人 世 岂 能 无 聚 散	亦 逢 佳 节 且 吹 花
尘 土 - 南 山 - 无 事 - 访 僧 - 尘 土==莫 厌 九 衢 尘 土 间	秋 晴 满 眼 是 南 山	僧 家 未 必 全 无 事	道 著 访 僧 心 且 闲
锦 城 - 解 百 - 红 树 - 妒 歌 - 锦 城==早 晚 飞 来 入 锦 城	谁 人 教 解 百 般 鸣	春 风 红 树 惊 眠 处	似 妒 歌 童 作 艳 声
斜 阳 - 狼 藉 - 溪 桥 - 松 声 - 斜 阳==背 负 斜 阳 出 西 堰	春 云 狼 藉 藏 春 阪	过 一 溪 桥 见 一 村	人 声 渐 近 松 声 远
寒 窗 - 纸 帐 - 风 味 - 梅 花 - 寒 窗==寒 窗 一 穗 篆 烟 斜	纸 帐 孤 眠 对 月 华	信 是 道 人 风 味 别	枕 边 只 欠 着 梅 花
清 香 - 彷 佛 - 丹 青 - 细 雨 - 清 香==吹 落 清 香 缥 缈 风	楼 台 彷 佛 水 边 红	人 间 谁 是 丹 青 手	画 取 春 湖 细 雨 中
香 满 - 鸳 鸯 - 盈 门 - 微 芒 - 满 庭==夜 合 花 开 香 满 庭	鸳 鸯 待 阙 社 犹 停	怪 来 百 两 盈 门 日	三 五 微 芒 见 小 星
花 木 - 远 山 - 云 生 - 五 湖 - 花 木==新 亭 花 木 低 几 杖	叶 幄 已 成 藏 远 山	小 渚 云 生 夜 深 月	十 分 秋 思 五 湖 间
香 尘 - 流 水 - 啼 鸟 - 落 花 - 香 尘==繁 华 事 散 逐 香 尘	流 水 无 情 草 自 春	日 暮 东 风 怨 啼 鸟	落 花 犹 似 堕 楼 人
柳 枝 - 物 华 - 云 迷 - 片 帆 - 柳 枝==柳 枝 不 折 折 梅 花	带 去 吴 中 旧 物 华	白 雪 黄 云 迷 雁 影	片 帆 明 日 是 长 沙
寒 食 - 花 钿 - 如 今 - 半 在 - 禁 烟==寒 食 家 家 尽 禁 烟	野 棠 风 坠 小 花 钿	如 今 空 有 孤 魂 梦	半 在 嘉 陵 半 锦 川
枝 上 - 梅 子 - 几 阵 - 珠 帘 - 垂 杨==垂 杨 枝 上 喜 迁 莺	梅 子 黄 时 雨 乍 晴	几 阵 薰 风 穿 玉 殿	直 珠 帘 内 有 欢 声
泪 眼 - 残 阳 - 故 人 - 江 南 - 泪 眼==泪 眼 才 乾 更 哭 君	残 阳 破 寺 起 愁 云	故 人 海 上 能 多 少	已 见 江 南 有 两 坟
凉 风 - 残 月 - 吴 江 - 万 里 - 满 树==索 索 凉 风 满 树 头	破 窗 残 月 五 更 秋	病 身 归 处 吴 江 上	一 寸 心 中 万 里 愁
春 归 - 春 色 - 洛 阳 - 小 车 - 春 归==去 岁 春 归 留 不 住	今 年 春 色 来 何 处	洛 阳 处 处 是 桃 源	小 车 渐 转 东 街 去
家 家 - 一 邑 - 秋 水 - 风 生 - 家 家==家 家 户 户 擎 拳 拜	一 邑 三 乡 无 枉 情	百 里 襟 怀 秋 水 净	风 生 波 浪 月 生 明
半 天 - 似 镜 - 一 叶 - 遥 看 - 半 天==晓 峰 高 出 半 天 横	环 抱 沧 波 似 镜 明	一 叶 孤 帆 山 下 过	遥 看 红 日 碧 涛 生
桥 着 - 有 路 - 陈 迹 - 神 仙 - 翠 烟==几 段 飞 桥 着 翠 烟	云 间 有 路 想 通 天	古 来 何 事 非 陈 迹	道 是 神 仙 不 见 仙
虚 堂 - 香 冷 - 秋 色 - 寒 泉 - 无 言==虚 堂 燕 坐 悄 无 言	欲 断 残 香 冷 自 烟	秋 色 满 山 林 桂 静	一 轮 霜 月 泻 寒 泉
倒 影 - 沙 鸥 - 江 南 - 归 来 - 倒 影==松 树 倒 影 半 溪 寒	数 个 沙 鸥 似 水 安	曾 买 江 南 千 本 画	归 来 一 笔 不 中 看
坐 石 - 漱 泉 - 有 味 - 身 老 - 坐 石==坐 石 已 知 毛 骨 冷	漱 泉 长 觉 齿 牙 清	个 中 有 味 忘 归 念	身 老 无 馀 合 此 情
野 人 - 曙 色 - 从 山 - 白 云 - 戴 星==戴 星 欲 赴 野 人 家	曙 色 纷 纷 路 愈 赊	仓 卒 只 从 山 半 住	颓 垣 上 有 白 云 遮
银 花 - 春 城 - 月 华 - 香 车 - 火 树==火 树 银 花 巧 斗 明	笙 歌 声 沸 满 春 城	月 华 西 转 星 河 澹	犹 有 香 车 取 次 行
战 马 - 江 亭 - 三 尺 - 读 书 - 马 知==快 战 马 知 霸 术 疏	乌 江 亭 上 独 欷 嘘	万 人 三 尺 俱 无 用	可 惜 当 年 不 读 书
眈 眈 - 长 松 - 云 寒 - 桥 边 - 眈 眈==眈 眈 卧 石 熊 当 道	矫 矫 长 松 龙 上 天	不 怕 雪 云 寒 到 骨	唤 僧 扶 杖 立 桥 边
阴 浓 - 避 暑 - 野 云 - 水 边 - 树 阴==蝉 鸣 日 正 树 阴 浓	避 暑 行 吟 独 杖 筇	却 爱 野 云 无 定 处	水 边 容 易 耸 奇 峰
梢 头 - 无 心 - 随 风 - 苔 痕 - 梢 头==可 惜 梢 头 烂 漫 芳	无 心 要 趁 寿 阳 妆	宁 教 片 片 随 风 去	点 在 苔 痕 骨 也 香
江 上 - 有 无 - 细 雨 - 叠 叠 - 一 棹==江 上 春 阴 一 棹 闲	湿 云 遮 袖 有 无 间	轻 莎 细 雨 未 归 得	且 看 重 重 叠 叠 山
南 北 - 高 鸟 - 一 曲 - 无 心 - 南 北==南 北 东 西 似 客 身	远 峰 高 鸟 自 为 邻	清 歌 一 曲 犹 能 住	莫 道 无 心 胜 得 人
万 重 - 繁 华 - 归 去 - 他 人 - 万 重==岷 峨 路 远 万 重 云	锦 水 繁 华 一 聚 尘	帝 子 但 知 归 去 好	故 家 城 阙 已 他 人
门 前 - 息 授 - 玲 珑 - 走 盘 - 门 前==影 略 门 前 倒 刹 竿	个 中 消 息 授 传 难	玲 珑 侍 者 能 相 委	盘 走 明 珠 珠 走 盘
照 人 - 立 马 - 东 风 - 毫 端 - 照 人==一 枝 的 的 照 人 寒	绝 胜 溪 桥 立 马 看	只 恐 东 风 解 相 怨	漏 他 消 息 入 毫 端
千 丈 - 壁 立 - 东 西 - 步 步 - 千 丈==英 标 拔 俗 一 千 丈	壁 立 孤 危 不 可 攀	南 北 东 西 徒 斫 额	谁 知 步 步 在 其 间
佳 人 - 春 风 - 金 玉 - 龙 吟 - 佳 人==更 有 佳 人 在 空 谷	能 唱 春 风 天 上 曲	何 时 得 上 金 玉 堂	一 声 飞 度 龙 吟 竹
水 平 - 画 图 - 楼 台 - 西 湖 - 水 平==梅 霖 初 歇 水 平 湖	湖 上 青 山 展 画 图	更 著 楼 台 相 掩 映	风 流 端 不 减 西 湖
溪 山 - 青 山 - 太 平 - 闻 乐 - 溪 山==数 曲 清 溪 山 抱 回	青 山 高 处 醉 筵 开	忽 然 鼓 笛 太 平 调	便 是 洞 庭 闻 乐 来
三 千 - 朱 帘 - 春 光 - 花 间 - 三 千==禁 宫 宫 女 三 千 室	多 下 朱 帘 昼 掩 窗	为 避 春 光 羞 独 见	花 间 恨 杀 蝶 飞 双
秋 风 - 时 平 - 生 涯 - 衣 学 - 秋 风==四 野 秋 风 交 敝 庐	时 平 不 用 蔺 相 如	有 人 来 问 生 涯 事	指 点 蓑 衣 学 钓 鱼
嫩 叶 - 绿 映 - 玉 人 - 画 眉 - 嫩 叶==嫩 叶 吹 风 不 自 持	浅 黄 微 绿 映 清 池	玉 人 未 识 分 离 恨	折 向 堂 前 学 画 眉
扁 舟 - 雨 晴 - 出 处 - 经 纶 - 扁 舟==三 月 扁 舟 渡 鉴 湖	楝 花 风 急 雨 晴 初	共 知 出 处 心 无 愧	自 信 经 纶 志 未 疏
十 年 - 炊 烟 - 茫 茫 - 春 深 - 十 年==狡 窟 空 来 四 十 年	沼 江 犹 自 少 炊 烟	茫 茫 旷 土 无 人 问	芦 荻 春 深 绿 满 川
拍 肩 - 山 巅 - 千 古 - 高 深 - 拍 肩==隐 士 洪 崖 可 拍 肩	尚 留 陈 迹 此 山 巅	祗 应 千 古 人 如 在	陵 谷 高 深 却 变 迁
带 雨 - 飞 扬 - 小 楼 - 风 吹 - 带 雨==缭 绕 州 城 带 雨 长	雨 馀 云 气 亦 飞 扬	小 楼 别 有 幽 欣 处	时 复 风 吹 荷 叶 香
路 长 - 春 风 - 残 云 - 明 入 - 客 路==积 雨 成 湖 客 路 长	春 风 掀 搅 意 何 狂	残 云 吹 尽 真 天 力	乞 我 晴 明 入 帝 乡
奔 湍 - 喷 云 - 通 天 - 乘 槎 - 奔 湍==一 派 奔 湍 响 迅 雷	喷 云 翻 雪 绕 琼 台	应 通 天 上 银 潢 路	准 拟 乘 槎 八 月 来
十 年 - 江 南 - 此 有 - 清 梦 - 十 年==十 年 一 别 双 溪 路	君 自 江 南 我 浙 东	彼 此 有 书 无 雁 寄	只 应 清 梦 与 君 同
功 名 - 貂 蝉 - 出 处 - 心 然 - 功 名==未 赴 功 名 且 钓 船	忽 勤 王 事 即 貂 蝉	丈 夫 出 处 随 时 变	须 卜 此 心 然 不 然
泪 雨 - 晴 窗 - 月 华 - 和 风 - 泪 雨==常 时 泪 雨 久 涟 洳	准 拟 晴 窗 叫 勃 姑	报 答 月 华 思 善 画	便 和 风 露 入 新 图
生 四 - 愁 多 - 水 边 - 垂 丝 - 四 十==人 生 四 十 未 全 衰	我 为 愁 多 白 发 垂	何 故 水 边 双 白 鹭	无 愁 头 上 亦 垂 丝
生 烟 - 六 朝 - 家 缘 - 两 枝 - 生 烟==野 草 生 烟 日 暮 时	六 朝 陵 墓 转 凄 其	家 缘 解 道 鸠 偏 巧	但 取 枯 柴 一 两 枝
衰 柳 - 雨 天 - 钱 难 - 竹 窗 - 衰 柳==离 披 衰 柳 已 无 蝉	黄 叶 闭 门 风 雨 天	陶 令 无 钱 难 得 醉	竹 窗 过 午 枕 书 眠
秋 光 - 岩 桂 - 嘉 瑞 - 枝 枝 - 点 点==秋 光 点 点 明 人 眼	不 比 寻 常 岩 桂 花	天 与 刘 郎 作 嘉 瑞	枝 枝 金 粟 间 丹 砂
案 上 - 添 花 - 东 风 - 新 诗 - 两 年==案 上 瓶 梅 阅 两 年	添 花 未 有 买 花 钱	东 风 恰 似 怜 穷 客	吹 到 新 诗 四 五 篇
杨 柳 - 草 茸 - 水 边 - 夕 阳 - 杨 柳==淡 黄 杨 柳 著 烟 轻	细 草 茸 茸 亲 屐 行	行 到 水 边 心 会 处	夕 阳 一 树 否 花 明
天 孙 - 太 古 - 百 年 - 无 人 - 蚕 茧==天 孙 锦 段 冰 蚕 茧	太 古 盘 铭 苍 颉 文	三 百 年 来 消 息 绝	无 人 为 酬 杜 陵 坟
上 林 - 风 吹 - 春 色 - 黄 鹂 - 上 林==柳 已 如 眉 拂 上 林	细 风 吹 动 绿 烟 深	东 君 巧 欲 装 春 色	更 引 黄 鹂 啭 好 音
重 门 - 空 阶 - 微 之 - 何 处 - 寂 寂==重 门 寂 寂 锁 香 云	雨 滴 空 阶 坐 夜 分	老 去 微 之 风 调 在	折 来 何 处 与 双 文
春 雨 - 洞 天 - 尘 踪 - 云 间 - 翠 微==春 雨 新 晴 上 翠 微	三 年 两 过 洞 天 扉	尘 踪 不 得 多 时 住	又 向 云 间 一 宿 归
玛 瑙 - 廊 斜 - 大 家 - 小 车 - 玛 瑙==玛 瑙 阶 边 蛱 蝶 花	玉 阑 低 转 画 廊 斜	大 家 近 日 新 经 史	不 向 宫 门 候 小 车
绿 水 - 浩 浩 - 山 际 - 樵 牧 - 盈 盈==陂 沼 盈 盈 闲 绿 水	郊 原 浩 浩 涌 青 禾	烟 连 山 际 无 人 语	只 有 晚 归 樵 牧 歌
凭 阑 - 淡 烟 - 年 光 - 春 寒 - 楼 上==楼 上 凭 阑 小 立 时	淡 烟 漠 漠 雨 丝 丝	年 光 日 日 有 佳 处	不 解 春 寒 偏 入 诗
何 处 - 方 寸 - 看 来 - 雨 霁 - 何 处==有 生 何 处 得 安 稳	方 寸 是 为 风 火 本	看 来 出 尔 方 雨 间	雨 霁 风 休 海 天 远
东 风 - 雪 色 - 夜 半 - 明 月 - 雪 消==东 风 池 馆 雪 消 迟	雪 色 灯 光 映 酒 时	夜 半 醉 归 河 上 路	马 头 明 月 正 相 宜
秋 风 - 夕 阳 - 鹭 归 - 一 片 - 秋 风==十 里 秋 风 画 角 哀	夕 阳 光 景 亦 佳 哉	正 疑 白 鹭 归 何 晚	一 片 雪 从 天 际 来
细 溜 - 一 杯 - 离 恨 - 酩 酊 - 细 溜==腊 脚 春 槽 细 溜 香	一 杯 何 幸 得 君 尝	十 年 离 恨 无 销 处	且 付 山 公 酩 酊 乡
焚 香 - 如 水 - 含 情 - 牵 牛 - 桂 殿==桂 殿 焚 香 酒 半 醒	露 华 如 水 点 银 屏	含 情 欲 诉 心 中 事	羞 见 牵 牛 织 女 星
雪 融 - 竹 间 - 君 为 - 赠 当 - 梅 花==是 处 梅 花 与 雪 融	竹 间 开 晚 正 玲 珑	陈 君 为 我 言 如 此	折 赠 当 期 慰 眼 中
一 樽 - 落 日 - 怕 堤 - 老 红 - 一 樽==一 樽 无 计 遣 春 留	落 日 伤 情 独 倚 楼	柔 绿 怕 堤 如 可 染	老 红 满 径 为 谁 愁
偃 蹇 - 月 中 - 无 人 - 萧 瑟 - 老 松==老 松 偃 蹇 印 晴 空	倒 影 参 差 澹 月 中	夜 久 无 人 共 清 赏	一 庭 萧 瑟 走 虬 龙
景 色 - 初 日 - 山 腰 - 野 径 - 景 色==天 竺 横 分 景 色 宽	园 林 初 日 破 朝 寒	兴 阑 欲 下 山 腰 去	野 径 萦 乃 路 百 盘
归 期 - 短 篱 - 不 歌 - 清 香 - 归 期==欲 荒 三 迳 负 归 期	魂 梦 何 曾 到 短 篱	九 辩 不 歌 陶 令 老	清 香 还 许 入 谁 诗
枝 碧 - 黄 梅 - 红 日 - 绿 阴 - 枝 碧==低 枝 碧 李 压 人 头	过 雨 黄 梅 满 道 周	红 日 漏 云 初 试 暑	绿 阴 酣 露 已 偷 秋
穷 途 - 行 装 - 甘 棠 - 骑 马 - 穷 途==上 官 多 是 叹 穷 途	得 替 行 装 尽 有 余	唯 有 甘 棠 刘 法 掾	来 时 骑 马 去 骑 驴
柔 软 - 霜 青 - 一 笑 - 黄 梅 - 萦 纡==南 衙 柔 软 北 萦 纡	霜 碧 霜 青 各 立 株	但 得 东 皇 均 一 笑	黄 梅 吹 蜡 白 软 酥
春 色 - 笑 语 - 行 客 - 芳 草 - 春 色==一 鞭 春 色 去 迢 迢	溪 上 红 妆 笑 语 娇	酒 醉 不 知 行 客 避	竞 眠 芳 草 斗 裙 腰
月 色 - 广 寒 - 寒 窗 - 添 愁 - 月 色==玉 兔 瓯 中 霜 月 色	照 公 问 路 广 寒 宫	绝 胜 自 酌 寒 窗 下	睡 减 悲 添 愁 事 丛
风 云 - 第 一 - 一 声 - 西 河 - 风 云==风 云 会 合 又 相 期	觌 面 难 明 第 一 机	霹 雳 一 声 天 地 迥	西 河 师 子 却 生 儿
芬 芳 - 江 梅 - 太 白 - 枝 上 - 芬 芳==园 林 摇 落 独 芬 芳	未 让 江 梅 雪 里 香	还 恐 人 嫌 梅 太 白	故 来 枝 上 尽 涂 黄
田 园 - 把 锄 - 即 今 - 归 去 - 无 力==田 园 无 力 办 难 俱	有 益 犹 堪 学 把 锄	二 者 即 今 皆 未 具	教 吾 归 去 却 如 何
日 边 - 神 光 - 为 瑞 - 花 开 - 日 边==天 书 亲 自 日 边 平	一 道 神 光 遍 九 垓	为 瑞 为 祥 恩 力 大	直 教 枯 木 解 花 开
近 水 - 毛 竹 - 虚 野 - 候 客 - 近 水==近 水 刺 桐 知 驿 舍	倚 山 毛 竹 即 人 家	趁 虚 野 妇 沽 甜 酒	候 客 溪 童 进 辣 茶
强 扶 - 出 林 - 奇 字 - 异 书 - 崦 晴==西 崦 晴 天 得 强 扶	出 林 知 有 故 人 居	数 能 过 我 论 奇 字	当 复 令 公 见 异 书
四 海 - 飞 龙 - 遥 瞻 - 瑞 气 - 九 重==四 海 衣 冠 拜 九 重	圣 君 在 位 像 飞 龙	遥 瞻 雉 扇 双 开 处	万 岁 齐 呼 瑞 气 浓
渡 沙 - 风 前 - 滩 声 - 檐 声 - 渡 沙==大 渡 沙 头 一 扣 舷	久 晴 人 怕 立 风 前	临 流 正 爱 滩 声 美	又 得 檐 声 到 枕 边
帘 疏 - 新 凉 - 团 团 - 秋 情 - 帘 疏==翡 翠 帘 疏 不 蔽 风	新 凉 初 透 碧 纱 栊	涓 涓 玉 露 团 团 月	说 尽 秋 情 草 下 虫
鸣 钟 - 欹 枕 - 寂 寞 - 春 风 - 鸣 钟==中 禁 鸣 钟 日 欲 高	北 窗 欹 枕 望 频 搔	相 思 寂 寞 青 苔 合	唯 有 春 风 啼 伯 劳
宛 转 - 红 红 - 夜 飞 - 寂 寂 - 宛 转==宛 宛 转 转 胜 上 纱	红 红 绿 绿 苑 中 花	纷 纷 泊 泊 夜 飞 鸦	寂 寂 寞 寞 离 人 家
风 清 - 无 奈 - 潺 湲 - 莲 池 - 风 清==风 清 月 白 树 红 时	无 奈 重 城 隔 闰 师	却 羡 潺 湲 阶 下 水	夜 深 流 入 白 莲 池
溪 山 - 今 古 - 金 丹 - 长 生 - 溪 山==莫 道 溪 山 阅 世 长	溪 山 今 古 几 兴 亡	金 丹 大 药 皆 虚 妄	别 有 长 生 不 死 方
绿 云 - 秋 风 - 江 南 - 琼 树 - 白 云==绿 云 影 覆 白 云 英	馥 郁 秋 风 不 易 陈	休 遣 江 南 夸 艳 曲	朝 朝 琼 树 眼 中 新
风 前 - 直 下 - 林 家 - 水 晶 - 风 前==风 前 敲 落 珊 瑚 枝	白 玉 鞭 头 直 下 垂	要 识 香 林 家 住 处	水 晶 宫 殿 草 离 离
带 雪 - 芳 菲 - 掌 握 - 桃 李 - 带 雪==清 寒 带 雪 未 成 春	可 得 芳 菲 早 向 人	须 遣 艳 阳 归 掌 握	故 教 桃 李 及 芳 辰
一 身 - 白 云 - 百 年 - 华 山 - 一 身==一 生 活 计 一 身 闲	日 与 白 云 相 往 还	五 百 年 间 知 此 味	华 山 去 后 到 梅 山
青 苔 - 晓 角 - 断 肠 - 徘 徊 - 故 园==故 园 黄 叶 满 青 苔	梦 后 城 头 晓 角 哀	此 夜 断 肠 人 不 见	起 行 残 日 影 徘 徊
弦 歌 - 鲁 难 - 对 薇 - 春 草 - 流 化==弦 歌 流 化 记 琴 堂	樵 鲁 难 言 愧 互 乡	正 对 薇 花 挥 翰 墨	犹 能 春 草 梦 池 塘
南 山 - 水 曹 - 出 山 - 风 骚 - 南 山==南 山 最 数 月 台 高	曾 著 能 诗 何 水 曹	略 计 出 山 今 几 载	生 令 梅 赋 阙 风 骚
苍 龙 - 白 云 - 流 光 - 纷 纷 - 苍 龙==苍 龙 阙 下 陪 骢 马	紫 阁 峰 头 见 白 云	满 眼 流 光 随 日 度	今 朝 花 落 更 纷 纷
一 行 - 牵 愁 - 千 官 - 夕 阳 - 衰 草==衰 草 寒 云 雁 一 行	牵 愁 水 似 九 回 肠	游 人 欲 问 千 官 事	翁 仲 无 言 卧 夕 阳
玄 都 - 湘 裙 - 夜 雨 - 分 深 - 玄 都==玄 都 境 界 玉 堂 身	轻 袅 湘 裙 步 晓 阻	昨 夜 雨 肥 添 酒 晕	红 情 染 得 十 分 深
一 簇 - 高 低 - 骑 马 - 风 月 - 一 簇==春 山 一 簇 带 春 云	楼 阁 高 低 日 欲 曛	骑 马 棹 船 游 冶 客	一 天 风 月 自 平 分
耕 渔 - 大 家 - 画 眉 - 在 妈 - 渔 力==妇 女 耕 渔 力 作 同	荆 钗 裙 布 大 家 风	画 眉 亦 有 描 新 样	多 半 人 家 在 妈 宫
千 古 - 穿 云 - 落 日 - 落 雁 - 千 古==千 古 南 谯 炳 地 灵	穿 云 雁 塔 自 层 层	残 烟 落 日 荒 墟 上	父 老 相 传 落 雁 亭
醉 月 - 银 烛 - 今 宵 - 可 得 - 醉 月==回 首 评 花 醉 月 时	频 将 银 烛 剪 催 诗	今 宵 吟 尽 思 君 句	可 得 魂 归 可 得 知
乖 龙 - 骄 阳 - 虚 堂 - 水 声 - 底 乖==潭 底 乖 龙 唤 不 应	骄 阳 似 欲 败 西 成	虚 堂 永 夜 耿 无 睡	起 听 四 郊 车 水 声
啾 啾 - 苦 寒 - 惊 飞 - 画 图 - 啾 啾==啾 啾 黄 雀 在 枝 间	岁 晚 荒 郊 怨 苦 寒	容 易 惊 飞 无 处 所	人 家 曾 借 画 图 看
东 山 - 风 卷 - 新 月 - 凭 栏 - 百 尺==危 楼 百 尺 对 东 山	帘 幕 秋 风 卷 暮 寒	每 向 残 阳 新 月 看	几 人 曾 此 凭 栏 干
千 尺 - 滔 滔 - 无 人 - 断 桥 - 千 尺==平 地 忽 翻 千 尺 浪	吞 空 沃 日 势 滔 滔	截 流 机 峻 无 人 荐	谩 说 茶 陵 踏 断 桥
